GEOID,COUNTY_FIPS_CODE,STATE_CODE,YEAR,POPESTIMATE,DOMESTICMIG,INTERNATIONALMIG,NETMIG,BIRTHS,DEATHS
01001,001,01,2010,54761,147,28,175,151,157
01001,001,01,2011,55229,327,16,343,639,514
01001,001,01,2012,54970,-329,0,-329,615,560
01001,001,01,2013,54747,-226,19,-207,570,584
01001,001,01,2014,54922,102,19,121,637,572
01001,001,01,2015,54903,-107,23,-84,652,585
01001,001,01,2016,55302,266,7,273,675,547
01001,001,01,2017,55448,58,-3,55,667,574
01001,001,01,2018,55533,-3,2,-1,651,563
01001,001,01,2019,55769,208,-14,194,592,552
01001,001,01,2020,56145,360,-8,352,606,582
01003,003,01,2010,183121,780,51,831,514,534
01003,003,01,2011,186579,2896,192,3088,2186,1829
01003,003,01,2012,190203,3056,273,3329,2092,1883
01003,003,01,2013,194978,4175,240,4415,2162,1902
01003,003,01,2014,199306,3861,141,4002,2215,1988
01003,003,01,2015,203101,3437,165,3602,2261,2099
01003,003,01,2016,207787,4193,211,4404,2286,2021
01003,003,01,2017,212737,4622,104,4726,2313,2103
01003,003,01,2018,218071,5234,118,5352,2297,2325
01003,003,01,2019,223565,5511,63,5574,2322,2386
01003,003,01,2020,229287,5918,60,5978,2317,2543
01005,005,01,2010,27325,-69,0,-69,70,131
01005,005,01,2011,27344,14,-5,9,335,324
01005,005,01,2012,27172,-176,-11,-187,301,286
01005,005,01,2013,26946,-211,-8,-219,284,293
01005,005,01,2014,26768,-141,5,-136,265,308
01005,005,01,2015,26300,-429,13,-416,274,332
01005,005,01,2016,25828,-492,13,-479,284,279
01005,005,01,2017,25169,-650,9,-641,276,297
01005,005,01,2018,24887,-228,8,-220,273,335
01005,005,01,2019,24657,-161,6,-155,248,322
01005,005,01,2020,24589,10,6,16,250,334
01007,007,01,2010,22858,-59,0,-59,44,32
01007,007,01,2011,22736,-124,12,-112,265,277
01007,007,01,2012,22657,-105,19,-86,245,236
01007,007,01,2013,22510,-151,20,-131,258,276
01007,007,01,2014,22541,18,14,32,253,250
01007,007,01,2015,22553,15,14,29,252,266
01007,007,01,2016,22590,-30,11,-19,299,243
01007,007,01,2017,22532,-80,7,-73,267,251
01007,007,01,2018,22300,-171,8,-163,243,314
01007,007,01,2019,22313,-1,7,6,238,232
01007,007,01,2020,22136,-166,6,-160,249,266
01009,009,01,2010,57372,9,-2,7,181,132
01009,009,01,2011,57561,28,-8,20,741,569
01009,009,01,2012,57585,-100,8,-92,714,587
01009,009,01,2013,57630,-65,49,-16,647,582
01009,009,01,2014,57536,-158,43,-115,620,591
01009,009,01,2015,57535,-90,15,-75,715,634
01009,009,01,2016,57487,-102,32,-70,675,651
01009,009,01,2017,57801,357,0,357,681,721
01009,009,01,2018,57770,10,4,14,675,718
01009,009,01,2019,57840,58,-4,54,673,658
01009,009,01,2020,57879,68,1,69,665,697
01011,011,01,2010,10876,-24,1,-23,37,53
01011,011,01,2011,10680,-255,19,-236,172,133
01011,011,01,2012,10610,-81,8,-73,121,117
01011,011,01,2013,10557,-83,18,-65,131,119
01011,011,01,2014,10668,94,6,100,123,116
01011,011,01,2015,10404,-260,1,-259,124,133
01011,011,01,2016,10397,-31,8,-23,147,131
01011,011,01,2017,10181,-213,10,-203,129,143
01011,011,01,2018,10165,-23,14,-9,112,120
01011,011,01,2019,10144,-37,1,-36,110,95
01011,011,01,2020,9976,-170,5,-165,114,116
01013,013,01,2010,20933,-4,0,-4,66,66
01013,013,01,2011,20867,-77,2,-75,273,264
01013,013,01,2012,20672,-170,6,-164,242,274
01013,013,01,2013,20359,-304,8,-296,240,262
01013,013,01,2014,20332,-11,22,11,252,287
01013,013,01,2015,20168,-153,28,-125,238,276
01013,013,01,2016,20040,-154,44,-110,236,253
01013,013,01,2017,19911,-121,23,-98,239,269
01013,013,01,2018,19675,-205,21,-184,220,272
01013,013,01,2019,19501,-124,19,-105,205,272
01013,013,01,2020,19504,52,16,68,200,266
01015,015,01,2010,118420,-113,3,-110,316,311
01015,015,01,2011,117767,-752,39,-713,1384,1325
01015,015,01,2012,117227,-607,81,-526,1356,1359
01015,015,01,2013,116528,-660,68,-592,1307,1411
01015,015,01,2014,115991,-533,84,-449,1316,1395
01015,015,01,2015,115550,-441,77,-364,1386,1455
01015,015,01,2016,115036,-500,98,-402,1365,1475
01015,015,01,2017,114746,-260,31,-229,1338,1393
01015,015,01,2018,114298,-136,50,-86,1287,1645
01015,015,01,2019,114070,-15,-1,-16,1271,1486
01015,015,01,2020,113469,-289,10,-279,1230,1553
01017,017,01,2010,34105,-54,6,-48,81,80
01017,017,01,2011,34016,-74,28,-46,400,442
01017,017,01,2012,34088,122,34,156,392,476
01017,017,01,2013,34125,57,29,86,407,454
01017,017,01,2014,33964,-158,32,-126,425,455
01017,017,01,2015,33991,31,21,52,422,445
01017,017,01,2016,33742,-209,18,-191,387,444
01017,017,01,2017,33716,65,18,83,380,485
01017,017,01,2018,33570,-93,19,-74,344,415
01017,017,01,2019,33244,-255,16,-239,362,449
01017,017,01,2020,32865,-208,13,-195,334,519
01019,019,01,2010,25968,41,1,42,54,110
01019,019,01,2011,25993,116,0,116,219,308
01019,019,01,2012,25961,53,8,61,244,333
01019,019,01,2013,26022,161,10,171,232,341
01019,019,01,2014,25900,-20,0,-20,250,346
01019,019,01,2015,25739,-52,0,-52,231,337
01019,019,01,2016,25769,141,3,144,234,345
01019,019,01,2017,25822,178,2,180,237,364
01019,019,01,2018,26035,341,2,343,215,346
01019,019,01,2019,26254,350,2,352,234,366
01019,019,01,2020,26294,208,2,210,236,406
01021,021,01,2010,43645,47,-2,45,123,144
01021,021,01,2011,43682,-82,27,-55,566,474
01021,021,01,2012,43572,-170,-6,-176,564,495
01021,021,01,2013,43617,3,11,14,534,499
01021,021,01,2014,43751,13,20,33,597,485
01021,021,01,2015,43693,-119,32,-87,534,502
01021,021,01,2016,43854,46,45,91,548,475
01021,021,01,2017,44085,168,14,182,540,490
01021,021,01,2018,44084,-15,30,15,538,552
01021,021,01,2019,44313,170,6,176,541,486
01021,021,01,2020,44397,95,6,101,533,554
01023,023,01,2010,13848,-18,1,-17,28,21
01023,023,01,2011,13608,-194,-1,-195,114,160
01023,023,01,2012,13565,-6,0,-6,111,144
01023,023,01,2013,13401,-108,-1,-109,138,194
01023,023,01,2014,13322,-40,-2,-42,143,178
01023,023,01,2015,13237,-58,-1,-59,159,185
01023,023,01,2016,13049,-148,-6,-154,147,182
01023,023,01,2017,12923,-72,-5,-77,130,178
01023,023,01,2018,12810,-51,-5,-56,139,195
01023,023,01,2019,12577,-193,-5,-198,137,171
01023,023,01,2020,12418,-107,-5,-112,136,183
01025,025,01,2010,25767,-78,2,-76,49,45
01025,025,01,2011,25589,-141,3,-138,260,300
01025,025,01,2012,25161,-451,6,-445,293,288
01025,025,01,2013,25131,-10,6,-4,271,293
01025,025,01,2014,24873,-230,-1,-231,267,297
01025,025,01,2015,24711,-177,-2,-179,312,296
01025,025,01,2016,24342,-348,-1,-349,263,285
01025,025,01,2017,24083,-221,-1,-222,271,308
01025,025,01,2018,23965,-140,-1,-141,296,273
01025,025,01,2019,23651,-233,-1,-234,257,336
01025,025,01,2020,23291,-275,-1,-276,265,348
01027,027,01,2010,13897,-21,0,-21,26,38
01027,027,01,2011,13687,-153,3,-150,151,211
01027,027,01,2012,13433,-222,-1,-223,147,183
01027,027,01,2013,13406,26,0,26,121,171
01027,027,01,2014,13443,61,-1,60,150,171
01027,027,01,2015,13415,24,-3,21,152,200
01027,027,01,2016,13393,23,-1,22,135,178
01027,027,01,2017,13355,8,-1,7,133,178
01027,027,01,2018,13301,-32,-1,-33,153,173
01027,027,01,2019,13265,-4,-1,-5,156,186
01027,027,01,2020,13112,-87,-1,-88,158,224
01029,029,01,2010,15004,13,0,13,42,22
01029,029,01,2011,14928,-85,0,-85,184,175
01029,029,01,2012,14889,-64,-1,-65,183,159
01029,029,01,2013,14974,102,-4,98,175,187
01029,029,01,2014,15029,49,-4,45,201,190
01029,029,01,2015,14923,-37,-6,-43,149,209
01029,029,01,2016,14871,-12,-3,-15,167,205
01029,029,01,2017,14924,69,-2,67,163,176
01029,029,01,2018,15047,118,-2,116,195,187
01029,029,01,2019,14952,-66,-3,-69,178,203
01029,029,01,2020,14967,56,-2,54,177,216
01031,031,01,2010,50204,117,42,159,166,77
01031,031,01,2011,50449,-13,86,73,681,508
01031,031,01,2012,51159,351,222,573,625,494
01031,031,01,2013,50709,-679,117,-562,616,519
01031,031,01,2014,50693,-233,61,-172,620,468
01031,031,01,2015,51004,133,96,229,618,532
01031,031,01,2016,51281,-5,119,114,674,508
01031,031,01,2017,51943,457,93,550,626,513
01031,031,01,2018,52097,20,86,106,605,555
01031,031,01,2019,52639,466,54,520,590,566
01031,031,01,2020,53230,562,51,613,568,590
01033,033,01,2010,54527,59,8,67,162,130
01033,033,01,2011,54545,56,31,87,606,672
01033,033,01,2012,54578,78,13,91,623,671
01033,033,01,2013,54544,95,10,105,593,724
01033,033,01,2014,54484,64,9,73,597,717
01033,033,01,2015,54439,43,59,102,604,743
01033,033,01,2016,54483,54,86,140,615,708
01033,033,01,2017,54682,239,50,289,650,738
01033,033,01,2018,54970,364,53,417,612,741
01033,033,01,2019,55241,296,47,343,649,721
01033,033,01,2020,55411,230,33,263,631,724
01035,035,01,2010,13234,-20,0,-20,35,13
01035,035,01,2011,13194,-9,0,-9,159,190
01035,035,01,2012,13043,-128,0,-128,143,170
01035,035,01,2013,12908,-94,2,-92,151,194
01035,035,01,2014,12674,-196,0,-196,131,172
01035,035,01,2015,12677,19,2,21,155,171
01035,035,01,2016,12495,-151,1,-150,141,174
01035,035,01,2017,12431,-28,0,-28,121,154
01035,035,01,2018,12264,-112,1,-111,140,195
01035,035,01,2019,12055,-163,0,-163,122,167
01035,035,01,2020,11851,-124,0,-124,119,199
01037,037,01,2010,11779,16,-1,15,20,11
01037,037,01,2011,11483,-228,0,-228,93,163
01037,037,01,2012,11343,-103,-3,-106,108,139
01037,037,01,2013,11252,-47,4,-43,86,133
01037,037,01,2014,11037,-207,4,-203,105,122
01037,037,01,2015,10935,-72,13,-59,96,137
01037,037,01,2016,10812,-64,14,-50,82,155
01037,037,01,2017,10724,-38,12,-26,90,152
01037,037,01,2018,10619,-83,13,-70,96,131
01037,037,01,2019,10677,112,10,122,84,148
01037,037,01,2020,10650,28,8,36,79,143
01039,039,01,2010,37810,43,0,43,101,91
01039,039,01,2011,38023,234,7,241,461,488
01039,039,01,2012,37809,-141,0,-141,410,478
01039,039,01,2013,37820,56,0,56,477,516
01039,039,01,2014,37766,19,0,19,426,491
01039,039,01,2015,37566,-69,-2,-71,467,590
01039,039,01,2016,37400,-120,-4,-124,460,501
01039,039,01,2017,37077,-221,-2,-223,433,532
01039,039,01,2018,36993,47,-2,45,420,547
01039,039,01,2019,37082,235,-2,233,407,550
01039,039,01,2020,36930,8,-1,7,395,555
01041,041,01,2010,13868,-47,8,-39,37,23
01041,041,01,2011,13894,10,15,25,165,164
01041,041,01,2012,13914,28,15,43,147,167
01041,041,01,2013,13847,-53,2,-51,144,162
01041,041,01,2014,13851,31,-1,30,155,179
01041,041,01,2015,13851,56,3,59,157,215
01041,041,01,2016,13911,70,10,80,151,171
01041,041,01,2017,13871,-16,8,-8,150,181
01041,041,01,2018,13855,23,7,30,137,183
01041,041,01,2019,13811,-6,2,-4,137,176
01041,041,01,2020,13681,-66,4,-62,135,201
01043,043,01,2010,80456,41,1,42,249,228
01043,043,01,2011,80419,-151,29,-122,998,910
01043,043,01,2012,80292,-94,22,-72,925,963
01043,043,01,2013,80704,389,37,426,952,960
01043,043,01,2014,81081,284,42,326,1010,947
01043,043,01,2015,81771,611,41,652,1012,973
01043,043,01,2016,82434,595,41,636,1001,970
01043,043,01,2017,82830,434,9,443,1013,1060
01043,043,01,2018,83300,597,14,611,940,1078
01043,043,01,2019,83644,405,2,407,998,1060
01043,043,01,2020,84515,1037,3,1040,948,1115
01045,045,01,2010,50396,-1,46,45,174,73
01045,045,01,2011,50134,-554,68,-486,693,470
01045,045,01,2012,50313,-245,178,-67,702,451
01045,045,01,2013,49807,-783,111,-672,648,492
01045,045,01,2014,49465,-631,68,-563,668,460
01045,045,01,2015,49428,-273,123,-150,643,528
01045,045,01,2016,49476,-289,160,-129,659,480
01045,045,01,2017,49467,-108,29,-79,637,562
01045,045,01,2018,49268,-335,15,-320,695,573
01045,045,01,2019,49294,-57,3,-54,629,551
01045,045,01,2020,48959,-364,11,-353,642,622
01047,047,01,2010,43855,-7,0,-7,130,76
01047,047,01,2011,43254,-636,-5,-641,584,546
01047,047,01,2012,42794,-554,1,-553,585,507
01047,047,01,2013,41981,-779,-4,-783,511,555
01047,047,01,2014,41560,-438,-2,-440,551,536
01047,047,01,2015,40947,-601,4,-597,493,515
01047,047,01,2016,40105,-803,15,-788,514,571
01047,047,01,2017,39263,-821,12,-809,511,547
01047,047,01,2018,38270,-880,11,-869,435,562
01047,047,01,2019,37182,-1002,11,-991,436,531
01047,047,01,2020,36098,-910,7,-903,398,573
01049,049,01,2010,71133,-42,11,-31,232,152
01049,049,01,2011,71335,-3,86,83,901,778
01049,049,01,2012,70913,-650,59,-591,868,708
01049,049,01,2013,70881,-99,68,-31,794,782
01049,049,01,2014,70963,-34,38,4,816,728
01049,049,01,2015,71065,52,33,85,837,811
01049,049,01,2016,71116,-128,88,-40,894,799
01049,049,01,2017,71441,244,66,310,819,799
01049,049,01,2018,71430,-92,85,-7,832,834
01049,049,01,2019,71506,88,34,122,791,840
01049,049,01,2020,71658,189,39,228,816,893
01051,051,01,2010,79558,218,9,227,232,191
01051,051,01,2011,80005,147,43,190,967,708
01051,051,01,2012,80211,-156,72,-84,960,663
01051,051,01,2013,80557,46,81,127,985,755
01051,051,01,2014,80563,-231,40,-191,950,742
01051,051,01,2015,80903,142,50,192,937,778
01051,051,01,2016,81258,167,49,216,923,781
01051,051,01,2017,81452,23,26,49,938,790
01051,051,01,2018,81189,-371,25,-346,929,848
01051,051,01,2019,81575,251,24,275,897,786
01051,051,01,2020,82158,537,17,554,902,876
01053,053,01,2010,38352,-28,-2,-30,123,62
01053,053,01,2011,38211,-186,4,-182,484,442
01053,053,01,2012,38029,-140,-3,-143,445,482
01053,053,01,2013,37775,-255,7,-248,440,446
01053,053,01,2014,37749,-2,2,0,447,467
01053,053,01,2015,37676,2,3,5,400,472
01053,053,01,2016,37500,-118,4,-114,450,512
01053,053,01,2017,37010,-458,3,-455,460,499
01053,053,01,2018,36515,-446,6,-440,447,505
01053,053,01,2019,36569,87,-1,86,421,452
01053,053,01,2020,36281,-220,1,-219,434,503
01055,055,01,2010,104440,60,10,70,259,287
01055,055,01,2011,104356,-15,38,23,1252,1355
01055,055,01,2012,104271,161,25,186,1156,1408
01055,055,01,2013,103891,-169,4,-165,1148,1347
01055,055,01,2014,103417,-306,26,-280,1205,1386
01055,055,01,2015,103033,-204,51,-153,1159,1379
01055,055,01,2016,102931,-5,82,77,1237,1409
01055,055,01,2017,103076,278,41,319,1210,1379
01055,055,01,2018,102766,-92,48,-44,1193,1455
01055,055,01,2019,102460,-26,36,10,1182,1500
01055,055,01,2020,102371,317,29,346,1173,1609
01057,057,01,2010,17232,-3,0,-3,40,39
01057,057,01,2011,17061,-101,-3,-104,189,255
01057,057,01,2012,16955,-11,-1,-12,163,255
01057,057,01,2013,16837,-70,0,-70,188,237
01057,057,01,2014,16784,-18,4,-14,181,218
01057,057,01,2015,16711,-39,6,-33,192,230
01057,057,01,2016,16581,-89,6,-83,175,222
01057,057,01,2017,16478,-5,4,-1,155,256
01057,057,01,2018,16451,9,3,12,194,233
01057,057,01,2019,16279,-98,1,-97,154,228
01057,057,01,2020,16241,47,3,50,160,247
01059,059,01,2010,31746,-15,-1,-16,120,65
01059,059,01,2011,31776,-35,68,33,419,419
01059,059,01,2012,31699,-196,91,-105,406,381
01059,059,01,2013,31566,-271,114,-157,433,410
01059,059,01,2014,31572,-46,52,6,411,405
01059,059,01,2015,31532,-103,34,-69,404,376
01059,059,01,2016,31674,17,100,117,418,390
01059,059,01,2017,31670,-192,82,-110,450,344
01059,059,01,2018,31495,-341,97,-244,436,366
01059,059,01,2019,31587,-19,66,47,435,391
01059,059,01,2020,31507,-144,52,-92,428,416
01061,061,01,2010,26778,40,-1,39,74,117
01061,061,01,2011,26758,5,-10,-5,319,332
01061,061,01,2012,26928,222,-7,215,306,349
01061,061,01,2013,26688,-205,-2,-207,325,361
01061,061,01,2014,26605,-29,-3,-32,276,322
01061,061,01,2015,26645,104,-4,100,299,355
01061,061,01,2016,26497,-44,-4,-48,273,372
01061,061,01,2017,26404,-9,-4,-13,302,382
01061,061,01,2018,26296,15,-4,11,271,388
01061,061,01,2019,26309,83,-4,79,289,353
01061,061,01,2020,26411,219,-3,216,264,379
01063,063,01,2010,8990,-53,0,-53,37,37
01063,063,01,2011,8903,-88,0,-88,106,106
01063,063,01,2012,8849,-59,0,-59,107,102
01063,063,01,2013,8749,-71,0,-71,104,134
01063,063,01,2014,8585,-175,0,-175,102,96
01063,063,01,2015,8509,-62,1,-61,97,113
01063,063,01,2016,8485,-15,1,-14,96,105
01063,063,01,2017,8312,-154,1,-153,98,118
01063,063,01,2018,8212,-88,1,-87,112,125
01063,063,01,2019,8104,-91,1,-90,74,92
01063,063,01,2020,7990,-104,0,-104,83,91
01065,065,01,2010,15745,-55,8,-47,55,27
01065,065,01,2011,15360,-381,9,-372,188,205
01065,065,01,2012,15366,-42,-1,-43,203,153
01065,065,01,2013,15249,-140,-1,-141,203,183
01065,065,01,2014,15047,-209,-2,-211,188,182
01065,065,01,2015,15016,-62,-3,-65,212,179
01065,065,01,2016,14845,-191,0,-191,204,185
01065,065,01,2017,14812,-24,2,-22,184,195
01065,065,01,2018,14773,-53,2,-51,215,203
01065,065,01,2019,14669,-103,2,-101,167,170
01065,065,01,2020,14670,25,2,27,178,203
01067,067,01,2010,17293,13,5,18,40,59
01067,067,01,2011,17377,106,17,123,190,228
01067,067,01,2012,17152,-174,0,-174,182,234
01067,067,01,2013,17128,10,8,18,170,211
01067,067,01,2014,17074,-31,1,-30,170,190
01067,067,01,2015,17097,71,2,73,162,211
01067,067,01,2016,17062,22,1,23,174,230
01067,067,01,2017,17105,79,-2,77,200,232
01067,067,01,2018,17100,54,0,54,168,226
01067,067,01,2019,17125,79,-2,77,155,208
01067,067,01,2020,17223,182,-2,180,149,229
01069,069,01,2010,101800,144,6,150,322,231
01069,069,01,2011,102509,252,43,295,1333,914
01069,069,01,2012,103410,521,55,576,1335,1006
01069,069,01,2013,103691,98,42,140,1254,1095
01069,069,01,2014,104216,281,35,316,1286,1060
01069,069,01,2015,104326,-90,35,-55,1270,1092
01069,069,01,2016,104355,-311,50,-261,1371,1075
01069,069,01,2017,104472,-24,28,4,1281,1162
01069,069,01,2018,104943,252,32,284,1338,1147
01069,069,01,2019,106240,1109,15,1124,1353,1177
01069,069,01,2020,106580,198,14,212,1376,1253
01071,071,01,2010,53207,-57,7,-50,143,130
01071,071,01,2011,53240,74,35,109,573,647
01071,071,01,2012,53107,-105,72,-33,599,692
01071,071,01,2013,52986,-28,53,25,556,691
01071,071,01,2014,52592,-313,14,-299,553,645
01071,071,01,2015,52229,-164,2,-162,526,722
01071,071,01,2016,52058,-16,-4,-20,592,738
01071,071,01,2017,51865,-29,-6,-35,561,716
01071,071,01,2018,51649,-68,-6,-74,585,726
01071,071,01,2019,51672,167,-9,158,558,692
01071,071,01,2020,51582,91,-7,84,559,736
01073,073,01,2010,658230,-968,114,-854,2109,1585
01073,073,01,2011,658175,-2813,830,-1983,8828,6896
01073,073,01,2012,658183,-2918,726,-2192,9009,6738
01073,073,01,2013,659434,-1226,807,-419,8840,7057
01073,073,01,2014,660185,-1490,570,-920,8658,6853
01073,073,01,2015,660717,-1899,720,-1179,8992,7211
01073,073,01,2016,660507,-2634,844,-1790,8626,7017
01073,073,01,2017,659892,-2446,446,-2000,8624,7204
01073,073,01,2018,659672,-1933,502,-1431,8663,7433
01073,073,01,2019,658539,-2522,337,-2185,8399,7356
01073,073,01,2020,655342,-3949,252,-3697,8257,7768
01075,075,01,2010,14496,-28,0,-28,33,71
01075,075,01,2011,14292,-148,2,-146,141,199
01075,075,01,2012,14250,-8,1,-7,142,173
01075,075,01,2013,14214,18,4,22,142,198
01075,075,01,2014,14071,-80,0,-80,142,204
01075,075,01,2015,13931,-117,1,-116,163,186
01075,075,01,2016,13926,65,-1,64,150,218
01075,075,01,2017,13885,29,0,29,140,209
01075,075,01,2018,13878,15,0,15,160,182
01075,075,01,2019,13817,-69,0,-69,182,174
01075,075,01,2020,13764,-5,0,-5,175,223
01077,077,01,2010,92738,15,17,32,239,227
01077,077,01,2011,92615,-18,49,31,950,1100
01077,077,01,2012,92687,155,54,209,895,1021
01077,077,01,2013,92738,220,25,245,942,1124
01077,077,01,2014,93049,440,31,471,939,1090
01077,077,01,2015,92524,-430,57,-373,953,1099
01077,077,01,2016,92521,100,106,206,925,1128
01077,077,01,2017,92701,392,55,447,894,1157
01077,077,01,2018,92733,166,60,226,935,1126
01077,077,01,2019,93028,498,40,538,885,1127
01077,077,01,2020,93368,608,32,640,916,1217
01079,079,01,2010,34314,-10,1,-9,79,60
01079,079,01,2011,34026,-215,3,-212,345,421
01079,079,01,2012,33782,-236,2,-234,375,388
01079,079,01,2013,33553,-210,-1,-211,373,391
01079,079,01,2014,33423,-64,-2,-66,355,413
01079,079,01,2015,33116,-266,-1,-267,371,411
01079,079,01,2016,33196,121,-5,116,361,395
01079,079,01,2017,33035,-144,-6,-150,396,407
01079,079,01,2018,32905,-66,-6,-72,372,429
01079,079,01,2019,32851,52,-7,45,319,418
01079,079,01,2020,32857,153,-3,150,332,476
01081,081,01,2010,140815,216,115,331,415,238
01081,081,01,2011,144194,2020,521,2541,1630,807
01081,081,01,2012,148670,2740,868,3608,1663,883
01081,081,01,2013,151943,1795,652,2447,1829,1040
01081,081,01,2014,154682,1486,513,1999,1829,1117
01081,081,01,2015,157162,1121,538,1659,1913,1094
01081,081,01,2016,159446,733,596,1329,1937,982
01081,081,01,2017,161808,1179,392,1571,1889,1103
01081,081,01,2018,164206,1210,393,1603,1876,1076
01081,081,01,2019,165015,-84,299,215,1791,1202
01081,081,01,2020,166831,1082,242,1324,1754,1272
01083,083,01,2010,83168,295,9,304,222,155
01083,083,01,2011,85553,1957,83,2040,1012,684
01083,083,01,2012,87336,1405,66,1471,1004,716
01083,083,01,2013,88931,1190,76,1266,977,672
01083,083,01,2014,90622,1339,50,1389,1008,728
01083,083,01,2015,91596,659,44,703,1027,754
01083,083,01,2016,92896,939,85,1024,1045,771
01083,083,01,2017,94144,999,35,1034,980,767
01083,083,01,2018,96199,1896,40,1936,1030,915
01083,083,01,2019,99136,2792,15,2807,1004,870
01083,083,01,2020,102228,2978,24,3002,1037,931
01085,085,01,2010,11294,-26,0,-26,36,18
01085,085,01,2011,11144,-145,3,-142,148,157
01085,085,01,2012,10857,-329,0,-329,147,115
01085,085,01,2013,10666,-193,0,-193,139,142
01085,085,01,2014,10497,-181,-1,-182,118,109
01085,085,01,2015,10350,-127,-1,-128,127,146
01085,085,01,2016,10245,-97,-1,-98,120,128
01085,085,01,2017,10100,-129,0,-129,129,144
01085,085,01,2018,9969,-110,0,-110,117,138
01085,085,01,2019,9726,-218,0,-218,120,144
01085,085,01,2020,9641,-34,0,-34,110,161
01087,087,01,2010,21515,31,-3,28,65,40
01087,087,01,2011,21299,-189,-8,-197,218,238
01087,087,01,2012,20625,-692,9,-683,210,225
01087,087,01,2013,20043,-560,9,-551,178,227
01087,087,01,2014,19670,-363,11,-352,202,234
01087,087,01,2015,19331,-292,6,-286,186,240
01087,087,01,2016,19077,-178,4,-174,177,258
01087,087,01,2017,18828,-194,4,-190,179,238
01087,087,01,2018,18320,-444,2,-442,181,249
01087,087,01,2019,18065,-177,2,-175,189,269
01087,087,01,2020,17895,-59,1,-58,170,283
01089,089,01,2010,336114,788,118,906,964,600
01089,089,01,2011,339623,1423,553,1976,4252,2717
01089,089,01,2012,342823,1095,681,1776,4035,2576
01089,089,01,2013,346764,2323,504,2827,3999,2892
01089,089,01,2014,349973,1316,449,1765,4190,2701
01089,089,01,2015,353194,1508,577,2085,4208,3042
01089,089,01,2016,356985,2067,647,2714,4191,3109
01089,089,01,2017,362061,3690,398,4088,4242,3258
01089,089,01,2018,367386,3871,483,4354,4324,3362
01089,089,01,2019,372547,4023,178,4201,4227,3266
01089,089,01,2020,379453,5986,214,6200,4315,3585
01091,091,01,2010,20955,-41,1,-40,48,100
01091,091,01,2011,20663,-292,13,-279,234,248
01091,091,01,2012,20378,-339,18,-321,253,227
01091,091,01,2013,20123,-236,16,-220,234,271
01091,091,01,2014,19990,-140,3,-137,257,253
01091,091,01,2015,19772,-208,5,-203,256,273
01091,091,01,2016,19536,-249,13,-236,249,249
01091,091,01,2017,19411,-103,8,-95,237,268
01091,091,01,2018,19093,-238,8,-230,207,295
01091,091,01,2019,18919,-110,3,-107,202,269
01091,091,01,2020,18733,-122,6,-116,190,259
01093,093,01,2010,30822,43,2,45,75,77
01093,093,01,2011,30661,-35,13,-22,288,426
01093,093,01,2012,30495,-92,18,-74,325,412
01093,093,01,2013,30236,-154,10,-144,302,418
01093,093,01,2014,30215,45,1,46,313,372
01093,093,01,2015,30137,7,6,13,317,403
01093,093,01,2016,29958,-62,15,-47,281,412
01093,093,01,2017,29825,-60,13,-47,299,383
01093,093,01,2018,29776,92,14,106,296,448
01093,093,01,2019,29826,127,11,138,330,417
01093,093,01,2020,29703,4,8,12,312,448
01095,095,01,2010,93119,39,17,56,321,269
01095,095,01,2011,93899,319,170,489,1311,1016
01095,095,01,2012,94264,-2,150,148,1292,1053
01095,095,01,2013,94358,-104,110,6,1210,1105
01095,095,01,2014,94262,-305,20,-285,1299,1096
01095,095,01,2015,94588,19,63,82,1328,1071
01095,095,01,2016,95123,205,112,317,1371,1147
01095,095,01,2017,95589,228,69,297,1373,1197
01095,095,01,2018,96230,241,89,330,1436,1124
01095,095,01,2019,96751,316,26,342,1376,1196
01095,095,01,2020,96990,94,32,126,1371,1263
01097,097,01,2010,413328,-315,138,-177,1343,949
01097,097,01,2011,413126,-2324,646,-1678,5605,4130
01097,097,01,2012,413893,-1515,709,-806,5675,4049
01097,097,01,2013,414025,-1468,620,-848,5391,4376
01097,097,01,2014,414298,-1550,501,-1049,5653,4282
01097,097,01,2015,414654,-1767,613,-1154,5691,4148
01097,097,01,2016,415169,-1364,591,-773,5636,4331
01097,097,01,2017,414209,-2433,377,-2056,5534,4433
01097,097,01,2018,414275,-1578,413,-1165,5649,4407
01097,097,01,2019,413516,-1809,242,-1567,5417,4615
01097,097,01,2020,412716,-1425,229,-1196,5393,5011
01099,099,01,2010,23004,-82,0,-82,56,39
01099,099,01,2011,22799,-200,-3,-203,259,263
01099,099,01,2012,22582,-173,-1,-174,246,291
01099,099,01,2013,22174,-382,-1,-383,229,264
01099,099,01,2014,21927,-227,-1,-228,222,244
01099,099,01,2015,21720,-144,-1,-145,217,279
01099,099,01,2016,21553,-136,0,-136,219,251
01099,099,01,2017,21294,-207,0,-207,230,280
01099,099,01,2018,21035,-174,0,-174,192,277
01099,099,01,2019,20689,-263,0,-263,197,281
01099,099,01,2020,20459,-125,0,-125,182,286
01101,101,01,2010,229498,-188,95,-93,709,458
01101,101,01,2011,229218,-1915,390,-1525,3146,1907
01101,101,01,2012,228923,-2141,641,-1500,3117,1945
01101,101,01,2013,228261,-2195,492,-1703,3090,2083
01101,101,01,2014,227647,-2161,389,-1772,3209,2075
01101,101,01,2015,227420,-1719,494,-1225,3230,2229
01101,101,01,2016,227398,-1626,634,-992,3150,2181
01101,101,01,2017,227514,-1246,361,-885,3129,2121
01101,101,01,2018,226631,-2228,344,-1884,3143,2141
01101,101,01,2019,226074,-1796,291,-1505,3131,2191
01101,101,01,2020,224639,-2308,230,-2078,3064,2419
01103,103,01,2010,119642,26,21,47,384,292
01103,103,01,2011,120058,19,139,158,1504,1240
01103,103,01,2012,120148,-160,85,-75,1398,1215
01103,103,01,2013,119625,-701,20,-681,1393,1233
01103,103,01,2014,119496,-379,83,-296,1409,1235
01103,103,01,2015,119316,-391,118,-273,1359,1257
01103,103,01,2016,119090,-536,226,-310,1441,1356
01103,103,01,2017,118940,-327,54,-273,1436,1311
01103,103,01,2018,119216,145,91,236,1423,1376
01103,103,01,2019,119630,312,17,329,1445,1361
01103,103,01,2020,119883,191,25,216,1416,1383
01105,105,01,2010,10564,-27,0,-27,31,18
01105,105,01,2011,10452,-100,2,-98,133,146
01105,105,01,2012,10166,-283,7,-276,125,144
01105,105,01,2013,10005,-133,0,-133,121,149
01105,105,01,2014,9809,-156,2,-154,91,136
01105,105,01,2015,9650,-159,5,-154,126,133
01105,105,01,2016,9538,-113,0,-113,130,128
01105,105,01,2017,9304,-207,-1,-208,108,134
01105,105,01,2018,9049,-224,0,-224,100,133
01105,105,01,2019,8940,-95,-1,-96,90,102
01105,105,01,2020,8687,-201,0,-201,88,138
01107,107,01,2010,19749,-18,-1,-19,53,31
01107,107,01,2011,19357,-345,-1,-346,220,267
01107,107,01,2012,19314,-24,0,-24,224,240
01107,107,01,2013,19309,52,5,57,199,261
01107,107,01,2014,20283,934,6,940,229,244
01107,107,01,2015,20788,508,11,519,236,261
01107,107,01,2016,20337,-447,28,-419,228,262
01107,107,01,2017,20224,-122,12,-110,216,219
01107,107,01,2018,19949,-241,18,-223,195,248
01107,107,01,2019,19940,-30,3,-27,239,221
01107,107,01,2020,19793,-75,3,-72,207,283
01109,109,01,2010,32972,27,30,57,93,79
01109,109,01,2011,33031,-103,100,-3,388,326
01109,109,01,2012,33225,-30,131,101,413,314
01109,109,01,2013,33728,371,115,486,352,347
01109,109,01,2014,33217,-734,125,-609,393,319
01109,109,01,2015,33518,127,106,233,381,314
01109,109,01,2016,33540,-250,173,-77,395,296
01109,109,01,2017,33441,-232,107,-125,346,322
01109,109,01,2018,33390,-200,103,-97,374,329
01109,109,01,2019,33034,-466,95,-371,345,330
01109,109,01,2020,32966,-123,76,-47,353,376
01111,111,01,2010,22937,30,0,30,42,49
01111,111,01,2011,22751,-105,-4,-109,223,300
01111,111,01,2012,22541,-188,-7,-195,240,255
01111,111,01,2013,22558,34,-4,30,269,281
01111,111,01,2014,22362,-152,-8,-160,255,293
01111,111,01,2015,22603,272,-4,268,274,302
01111,111,01,2016,22515,-17,-2,-19,241,309
01111,111,01,2017,22702,244,-2,242,260,314
01111,111,01,2018,22742,136,-1,135,239,333
01111,111,01,2019,22781,44,-3,41,268,271
01111,111,01,2020,22920,203,0,203,243,306
01113,113,01,2010,53327,232,10,242,189,93
01113,113,01,2011,54884,1318,2,1320,800,572
01113,113,01,2012,57549,2127,123,2250,902,577
01113,113,01,2013,59219,1213,65,1278,867,522
01113,113,01,2014,59310,-413,40,-373,919,459
01113,113,01,2015,58946,-755,61,-694,938,615
01113,113,01,2016,58290,-882,-2,-884,848,624
01113,113,01,2017,57134,-1270,-7,-1277,811,693
01113,113,01,2018,57933,658,-16,642,791,638
01113,113,01,2019,58098,21,-29,-8,782,609
01113,113,01,2020,58237,101,-11,90,747,701
01115,115,01,2010,83587,122,12,134,277,192
01115,115,01,2011,83992,89,46,135,1103,829
01115,115,01,2012,84779,489,47,536,1059,801
01115,115,01,2013,85831,848,41,889,1045,893
01115,115,01,2014,86014,96,23,119,994,911
01115,115,01,2015,86569,404,43,447,1028,913
01115,115,01,2016,87342,598,47,645,1055,925
01115,115,01,2017,87985,547,50,597,1024,976
01115,115,01,2018,88842,756,50,806,1008,956
01115,115,01,2019,89735,850,47,897,956,959
01115,115,01,2020,90739,1066,39,1105,946,1046
01117,117,01,2010,196036,393,55,448,631,317
01117,117,01,2011,197968,381,339,720,2477,1259
01117,117,01,2012,200949,1647,226,1873,2381,1285
01117,117,01,2013,204088,1825,253,2078,2403,1349
01117,117,01,2014,206346,1044,164,1208,2353,1280
01117,117,01,2015,209047,1502,181,1683,2403,1377
01117,117,01,2016,211538,1041,368,1409,2484,1390
01117,117,01,2017,213854,1379,204,1583,2229,1486
01117,117,01,2018,215877,1038,235,1273,2299,1537
01117,117,01,2019,218176,1588,135,1723,2241,1661
01117,117,01,2020,221428,2789,117,2906,2223,1868
01119,119,01,2010,13730,-2,0,-2,27,57
01119,119,01,2011,13491,-229,21,-208,129,160
01119,119,01,2012,13444,-60,42,-18,127,156
01119,119,01,2013,13398,-74,44,-30,138,153
01119,119,01,2014,13276,-165,31,-134,171,163
01119,119,01,2015,13212,-123,50,-73,165,157
01119,119,01,2016,12973,-286,40,-246,149,144
01119,119,01,2017,12756,-219,34,-185,136,169
01119,119,01,2018,12661,-108,33,-75,139,159
01119,119,01,2019,12358,-323,29,-294,134,142
01119,119,01,2020,12225,-133,23,-110,137,160
01121,121,01,2010,82175,-185,-1,-186,202,193
01121,121,01,2011,81875,-260,34,-226,855,927
01121,121,01,2012,82170,318,41,359,895,949
01121,121,01,2013,81604,-470,43,-427,877,1015
01121,121,01,2014,81550,48,33,81,858,973
01121,121,01,2015,81168,-375,50,-325,867,919
01121,121,01,2016,80598,-474,44,-430,876,1015
01121,121,01,2017,80192,-245,52,-193,840,1049
01121,121,01,2018,80219,149,71,220,852,1043
01121,121,01,2019,80226,186,18,204,883,1082
01121,121,01,2020,79985,42,23,65,845,1155
01123,123,01,2010,41480,-112,2,-110,128,162
01123,123,01,2011,41414,-40,13,-27,467,506
01123,123,01,2012,41060,-340,12,-328,498,528
01123,123,01,2013,41039,60,3,63,445,526
01123,123,01,2014,40898,-67,-6,-73,454,514
01123,123,01,2015,40628,-263,-2,-265,476,480
01123,123,01,2016,40607,48,1,49,467,535
01123,123,01,2017,40624,219,-5,214,410,603
01123,123,01,2018,40550,43,-2,41,432,545
01123,123,01,2019,40337,-22,-7,-29,367,551
01123,123,01,2020,40133,13,-8,5,375,585
01125,125,01,2010,195008,61,51,112,559,323
01125,125,01,2011,196788,822,273,1095,2407,1725
01125,125,01,2012,198884,891,331,1222,2450,1585
01125,125,01,2013,201192,1139,417,1556,2400,1658
01125,125,01,2014,203228,860,320,1180,2470,1611
01125,125,01,2015,204953,623,403,1026,2485,1774
01125,125,01,2016,206737,461,421,882,2624,1716
01125,125,01,2017,207849,99,224,323,2569,1771
01125,125,01,2018,208607,-133,246,113,2461,1814
01125,125,01,2019,210321,1037,165,1202,2377,1875
01125,125,01,2020,210758,-23,144,121,2362,2063
01127,127,01,2010,66995,5,3,8,217,240
01127,127,01,2011,66586,-340,27,-313,814,909
01127,127,01,2012,66110,-314,42,-272,826,1024
01127,127,01,2013,65790,-67,33,-34,754,1030
01127,127,01,2014,65354,-294,18,-276,806,961
01127,127,01,2015,64950,-153,7,-146,804,1058
01127,127,01,2016,64559,-220,18,-202,797,984
01127,127,01,2017,63929,-329,5,-324,774,1077
01127,127,01,2018,63701,77,7,84,781,1088
01127,127,01,2019,63680,134,-1,133,757,912
01127,127,01,2020,63143,-320,4,-316,767,988
01129,129,01,2010,17627,27,2,29,42,25
01129,129,01,2011,17356,-259,20,-239,169,200
01129,129,01,2012,17147,-224,26,-198,165,183
01129,129,01,2013,16898,-196,17,-179,160,231
01129,129,01,2014,16868,-5,23,18,166,212
01129,129,01,2015,16831,-9,17,8,177,222
01129,129,01,2016,16607,-177,4,-173,183,233
01129,129,01,2017,16484,-101,3,-98,160,186
01129,129,01,2018,16336,-136,2,-134,179,192
01129,129,01,2019,16279,-52,2,-50,173,181
01129,129,01,2020,15976,-253,3,-250,181,231
01131,131,01,2010,11560,-67,0,-67,21,64
01131,131,01,2011,11438,-122,0,-122,142,142
01131,131,01,2012,11304,-131,0,-131,137,144
01131,131,01,2013,11148,-149,0,-149,141,151
01131,131,01,2014,10950,-169,0,-169,142,176
01131,131,01,2015,10900,-22,0,-22,122,150
01131,131,01,2016,10860,-47,0,-47,141,133
01131,131,01,2017,10704,-165,7,-158,135,134
01131,131,01,2018,10592,-92,7,-85,150,178
01131,131,01,2019,10396,-204,6,-198,124,122
01131,131,01,2020,10206,-174,5,-169,123,143
01133,133,01,2010,24412,-76,0,-76,59,61
01133,133,01,2011,24362,18,-2,16,251,315
01133,133,01,2012,24194,-95,0,-95,228,298
01133,133,01,2013,24190,67,1,68,249,319
01133,133,01,2014,24141,4,5,9,248,300
01133,133,01,2015,23929,-162,2,-160,232,284
01133,133,01,2016,23911,50,1,51,246,314
01133,133,01,2017,23753,-74,-1,-75,262,342
01133,133,01,2018,23690,50,0,50,223,335
01133,133,01,2019,23700,67,-1,66,249,305
01133,133,01,2020,23508,-69,-1,-70,241,362
02013,013,02,2010,3167,9,15,24,2,1
02013,013,02,2011,3260,-4,84,80,20,6
02013,013,02,2012,3297,-30,54,24,17,4
02013,013,02,2013,3346,-48,87,39,15,7
02013,013,02,2014,3347,-82,73,-9,17,9
02013,013,02,2015,3373,-54,77,23,9,7
02013,013,02,2016,3354,-107,87,-20,10,10
02013,013,02,2017,3445,-28,115,87,15,11
02013,013,02,2018,3391,-117,51,-66,14,3
02013,013,02,2019,3355,-99,67,-32,6,9
02013,013,02,2020,3401,-2,49,47,4,7
02016,016,02,2010,5561,-17,12,-5,4,0
02016,016,02,2011,5585,-70,67,-3,30,5
02016,016,02,2012,5681,-2,83,81,33,16
02016,016,02,2013,5779,-87,162,75,37,16
02016,016,02,2014,5825,-54,77,23,37,15
02016,016,02,2015,5782,-160,104,-56,29,17
02016,016,02,2016,5718,-221,136,-85,34,16
02016,016,02,2017,5760,-137,162,25,35,19
02016,016,02,2018,5678,-169,62,-107,35,11
02016,016,02,2019,5702,-86,80,-6,33,4
02016,016,02,2020,5680,-115,68,-47,33,7
02020,020,02,2010,293760,361,282,643,1160,313
02020,020,02,2011,296693,-1132,780,-352,4784,1498
02020,020,02,2012,298806,-2283,1303,-980,4588,1504
02020,020,02,2013,301801,-1609,1525,-84,4701,1587
02020,020,02,2014,300647,-5037,615,-4422,4792,1619
02020,020,02,2015,298337,-6477,1135,-5342,4644,1686
02020,020,02,2016,298072,-4344,1198,-3146,4566,1705
02020,020,02,2017,295118,-6881,1350,-5531,4287,1746
02020,020,02,2018,291377,-6485,313,-6172,4086,1679
02020,020,02,2019,288790,-5148,582,-4566,3930,1943
02020,020,02,2020,287095,-3994,490,-3504,3861,2047
02050,050,02,2010,17081,-12,0,-12,113,32
02050,050,02,2011,17418,-24,1,-23,465,106
02050,050,02,2012,17655,-65,7,-58,421,123
02050,050,02,2013,17855,-161,8,-153,444,92
02050,050,02,2014,17960,-254,7,-247,441,93
02050,050,02,2015,17970,-291,4,-287,413,119
02050,050,02,2016,18018,-260,9,-251,410,111
02050,050,02,2017,18102,-240,18,-222,435,132
02050,050,02,2018,18267,-131,8,-123,414,126
02050,050,02,2019,18493,-62,11,-51,422,146
02050,050,02,2020,18437,-325,8,-317,426,165
02060,060,02,2010,1002,5,0,5,3,3
02060,060,02,2011,1029,21,0,21,15,8
02060,060,02,2012,980,-52,0,-52,9,10
02060,060,02,2013,952,-34,0,-34,15,8
02060,060,02,2014,949,0,0,0,5,8
02060,060,02,2015,906,-50,1,-49,11,6
02060,060,02,2016,906,-4,1,-3,13,9
02060,060,02,2017,869,-40,1,-39,7,5
02060,060,02,2018,881,14,0,14,9,11
02060,060,02,2019,840,-49,0,-49,11,4
02060,060,02,2020,788,-55,0,-55,8,6
02068,068,02,2010,1839,2,4,6,9,3
02068,068,02,2011,1878,5,19,24,19,5
02068,068,02,2012,1915,5,17,22,21,7
02068,068,02,2013,1948,-5,28,23,23,10
02068,068,02,2014,1922,-53,14,-39,17,6
02068,068,02,2015,1940,-14,23,9,16,7
02068,068,02,2016,2068,74,38,112,22,8
02068,068,02,2017,2103,-20,43,23,21,9
02068,068,02,2018,2047,-60,9,-51,8,13
02068,068,02,2019,2125,47,18,65,21,8
02068,068,02,2020,2081,-72,14,-58,14,0
02070,070,02,2010,4850,2,0,2,19,17
02070,070,02,2011,4947,23,0,23,110,37
02070,070,02,2012,4948,-61,1,-60,99,39
02070,070,02,2013,4976,-51,0,-51,105,27
02070,070,02,2014,4981,-47,0,-47,90,38
02070,070,02,2015,4987,-56,1,-55,98,36
02070,070,02,2016,4968,-99,1,-98,111,34
02070,070,02,2017,4934,-106,0,-106,104,32
02070,070,02,2018,5003,13,0,13,86,31
02070,070,02,2019,4932,-114,0,-114,90,47
02070,070,02,2020,4833,-126,1,-125,81,54
02090,090,02,2010,98272,196,97,293,483,116
02090,090,02,2011,98151,-1610,148,-1462,1775,447
02090,090,02,2012,100388,570,462,1032,1600,449
02090,090,02,2013,101046,-1073,503,-570,1712,473
02090,090,02,2014,99404,-3235,240,-2995,1701,433
02090,090,02,2015,99812,-1314,511,-803,1698,493
02090,090,02,2016,100877,-530,366,-164,1719,488
02090,090,02,2017,99911,-2347,253,-2094,1614,494
02090,090,02,2018,98749,-2284,-6,-2290,1626,505
02090,090,02,2019,97088,-2668,74,-2594,1433,492
02090,090,02,2020,95651,-2380,88,-2292,1408,540
02100,100,02,2010,2501,1,1,2,2,10
02100,100,02,2011,2575,46,13,59,30,16
02100,100,02,2012,2580,-10,13,3,26,24
02100,100,02,2013,2561,-12,1,-11,13,20
02100,100,02,2014,2558,-2,1,-1,19,21
02100,100,02,2015,2519,-42,1,-41,18,17
02100,100,02,2016,2531,10,6,16,15,18
02100,100,02,2017,2526,-16,3,-13,19,11
02100,100,02,2018,2502,-35,0,-35,25,14
02100,100,02,2019,2561,48,1,49,21,12
02100,100,02,2020,2614,39,1,40,19,5
02105,105,02,2010,2100,0,0,0,4,0
02105,105,02,2011,2079,-37,2,-35,32,17
02105,105,02,2012,2107,20,3,23,17,13
02105,105,02,2013,2109,-10,1,-9,19,8
02105,105,02,2014,2091,-37,2,-35,27,11
02105,105,02,2015,2126,31,9,40,18,23
02105,105,02,2016,2115,-26,12,-14,18,14
02105,105,02,2017,2135,-8,12,4,29,14
02105,105,02,2018,2139,8,5,13,6,16
02105,105,02,2019,2144,-17,8,-9,25,10
02105,105,02,2020,2141,-6,7,1,19,23
02110,110,02,2010,31387,61,8,69,101,61
02110,110,02,2011,32165,454,68,522,410,157
02110,110,02,2012,32391,-35,86,51,365,184
02110,110,02,2013,32605,-108,107,-1,400,181
02110,110,02,2014,32501,-380,45,-335,406,178
02110,110,02,2015,32644,-132,94,-38,382,200
02110,110,02,2016,32456,-456,86,-370,382,203
02110,110,02,2017,32106,-632,101,-531,356,181
02110,110,02,2018,32044,-213,27,-186,331,205
02110,110,02,2019,32038,-205,41,-164,324,167
02110,110,02,2020,31849,-339,35,-304,315,200
02122,122,02,2010,55554,75,7,82,183,108
02122,122,02,2011,56311,407,28,435,711,389
02122,122,02,2012,56920,209,32,241,716,346
02122,122,02,2013,57039,-294,88,-206,714,393
02122,122,02,2014,57594,211,28,239,711,393
02122,122,02,2015,58075,159,66,225,702,442
02122,122,02,2016,58515,106,68,174,748,481
02122,122,02,2017,58594,-274,93,-181,696,436
02122,122,02,2018,58609,-229,27,-202,704,485
02122,122,02,2019,58914,61,44,105,674,475
02122,122,02,2020,59414,335,35,370,680,550
02130,130,02,2010,13584,15,4,19,43,14
02130,130,02,2011,13688,-19,40,21,188,104
02130,130,02,2012,13743,-80,57,-23,188,110
02130,130,02,2013,13748,-142,57,-85,173,84
02130,130,02,2014,13826,-24,23,-1,175,94
02130,130,02,2015,13737,-197,41,-156,166,102
02130,130,02,2016,13760,-104,44,-60,167,85
02130,130,02,2017,13874,13,61,74,138,97
02130,130,02,2018,13881,-74,25,-49,162,106
02130,130,02,2019,13905,-65,36,-29,133,80
02130,130,02,2020,13747,-217,26,-191,135,101
02150,150,02,2010,13653,-38,30,-8,66,11
02150,150,02,2011,13807,-49,46,-3,219,62
02150,150,02,2012,14037,-39,114,75,218,66
02150,150,02,2013,14091,-238,122,-116,222,57
02150,150,02,2014,13899,-438,59,-379,238,62
02150,150,02,2015,13760,-413,107,-306,221,60
02150,150,02,2016,13722,-312,119,-193,201,48
02150,150,02,2017,13605,-452,201,-251,194,63
02150,150,02,2018,13389,-385,54,-331,181,67
02150,150,02,2019,13209,-372,105,-267,143,56
02150,150,02,2020,12992,-379,83,-296,145,64
02158,158,02,2010,7469,-42,0,-42,57,8
02158,158,02,2011,7656,3,3,6,245,63
02158,158,02,2012,7800,-42,0,-42,242,57
02158,158,02,2013,7980,17,5,22,227,68
02158,158,02,2014,8107,-61,3,-58,236,52
02158,158,02,2015,8201,-91,14,-77,222,53
02158,158,02,2016,8180,-192,16,-176,217,62
02158,158,02,2017,8247,-119,21,-98,233,69
02158,158,02,2018,8349,-84,11,-73,235,60
02158,158,02,2019,8384,-139,12,-127,243,82
02158,158,02,2020,8328,-189,10,-179,234,109
02164,164,02,2010,1641,-5,0,-5,12,1
02164,164,02,2011,1652,0,1,1,22,11
02164,164,02,2012,1651,-27,2,-25,37,15
02164,164,02,2013,1670,-2,7,5,22,9
02164,164,02,2014,1648,-51,2,-49,39,12
02164,164,02,2015,1597,-72,7,-65,32,19
02164,164,02,2016,1595,-25,4,-21,31,12
02164,164,02,2017,1606,-15,3,-12,40,18
02164,164,02,2018,1586,-49,1,-48,36,8
02164,164,02,2019,1583,-21,1,-20,24,8
02164,164,02,2020,1493,-98,0,-98,26,16
02170,170,02,2010,89731,482,13,495,321,100
02170,170,02,2011,91741,1162,24,1186,1338,519
02170,170,02,2012,93718,1080,79,1159,1315,520
02170,170,02,2013,95940,1275,120,1395,1348,557
02170,170,02,2014,98185,1295,73,1368,1379,523
02170,170,02,2015,101162,1930,100,2030,1511,584
02170,170,02,2016,104258,2052,111,2163,1541,614
02170,170,02,2017,106426,1156,170,1326,1426,582
02170,170,02,2018,107325,86,55,141,1376,617
02170,170,02,2019,108578,477,70,547,1379,675
02170,170,02,2020,110213,912,73,985,1372,721
02180,180,02,2010,9543,22,0,22,55,29
02180,180,02,2011,9775,55,4,59,262,89
02180,180,02,2012,9825,-139,4,-135,254,72
02180,180,02,2013,9851,-124,9,-115,204,64
02180,180,02,2014,9812,-182,5,-177,199,65
02180,180,02,2015,9901,-109,9,-100,245,56
02180,180,02,2016,9983,-78,8,-70,223,71
02180,180,02,2017,10038,-104,11,-93,222,72
02180,180,02,2018,10073,-69,3,-66,186,84
02180,180,02,2019,10040,-111,5,-106,163,90
02180,180,02,2020,9909,-189,4,-185,167,113
02185,185,02,2010,9067,3,2,5,49,5
02185,185,02,2011,9145,-71,20,-51,174,45
02185,185,02,2012,9287,-23,23,0,175,33
02185,185,02,2013,9383,-52,21,-31,177,50
02185,185,02,2014,9370,-157,13,-144,173,45
02185,185,02,2015,9382,-124,7,-117,172,44
02185,185,02,2016,9292,-202,18,-184,155,63
02185,185,02,2017,9401,-7,17,10,163,64
02185,185,02,2018,9455,-74,0,-74,162,36
02185,185,02,2019,9433,-125,5,-120,144,47
02185,185,02,2020,9294,-218,7,-211,144,71
02188,188,02,2010,7562,-18,1,-17,57,1
02188,188,02,2011,7711,-27,6,-21,214,44
02188,188,02,2012,7715,-129,2,-127,183,56
02188,188,02,2013,7735,-144,6,-138,195,38
02188,188,02,2014,7785,-106,14,-92,178,39
02188,188,02,2015,7787,-122,9,-113,159,45
02188,188,02,2016,7709,-212,9,-203,181,56
02188,188,02,2017,7805,-47,9,-38,193,59
02188,188,02,2018,7715,-188,4,-184,150,57
02188,188,02,2019,7673,-150,5,-145,175,73
02188,188,02,2020,7644,-102,5,-97,158,89
02195,195,02,2010,3219,0,1,1,14,3
02195,195,02,2011,3255,3,8,11,45,19
02195,195,02,2012,3276,-11,15,4,38,20
02195,195,02,2013,3288,-32,17,-15,39,13
02195,195,02,2014,3256,-63,5,-58,40,14
02195,195,02,2015,3251,-36,6,-30,40,16
02195,195,02,2016,3262,-9,13,4,32,26
02195,195,02,2017,3284,-16,22,6,35,19
02195,195,02,2018,3256,-45,9,-36,36,28
02195,195,02,2019,3294,22,11,33,22,17
02195,195,02,2020,3296,2,10,12,26,38
02198,198,02,2010,6211,26,0,26,18,3
02198,198,02,2011,6375,127,1,128,83,47
02198,198,02,2012,6421,-6,0,-6,87,35
02198,198,02,2013,6443,-19,1,-18,81,40
02198,198,02,2014,6461,0,2,2,71,53
02198,198,02,2015,6508,-3,4,1,77,31
02198,198,02,2016,6521,-11,5,-6,81,62
02198,198,02,2017,6441,-85,6,-79,59,59
02198,198,02,2018,6372,-90,4,-86,78,62
02198,198,02,2019,6211,-160,4,-156,57,61
02198,198,02,2020,6147,-76,5,-71,64,57
02220,220,02,2010,8880,-2,2,0,26,26
02220,220,02,2011,8888,-79,35,-44,119,68
02220,220,02,2012,9022,22,57,79,113,57
02220,220,02,2013,8980,-126,54,-72,96,70
02220,220,02,2014,8845,-199,27,-172,97,64
02220,220,02,2015,8789,-101,42,-59,72,69
02220,220,02,2016,8744,-99,38,-61,79,64
02220,220,02,2017,8640,-160,35,-125,85,64
02220,220,02,2018,8555,-136,19,-117,94,62
02220,220,02,2019,8501,-86,15,-71,70,52
02220,220,02,2020,8405,-143,18,-125,80,51
02230,230,02,2010,968,-4,0,-4,3,0
02230,230,02,2011,961,-21,1,-20,14,1
02230,230,02,2012,998,30,0,30,7,1
02230,230,02,2013,1025,15,2,17,9,0
02230,230,02,2014,1054,22,0,22,9,2
02230,230,02,2015,1090,22,0,22,17,4
02230,230,02,2016,1132,35,1,36,10,4
02230,230,02,2017,1173,29,3,32,12,3
02230,230,02,2018,1172,-10,1,-9,15,8
02230,230,02,2019,1193,19,3,22,3,4
02230,230,02,2020,1179,-5,1,-4,6,16
02240,240,02,2010,7064,10,0,10,45,19
02240,240,02,2011,7155,-11,18,7,123,39
02240,240,02,2012,7180,-107,36,-71,129,37
02240,240,02,2013,6996,-267,27,-240,97,47
02240,240,02,2014,6937,-136,9,-127,111,46
02240,240,02,2015,6827,-212,32,-180,124,57
02240,240,02,2016,6853,-37,22,-15,86,45
02240,240,02,2017,6918,-37,50,13,105,53
02240,240,02,2018,6946,-87,43,-44,109,37
02240,240,02,2019,6879,-134,16,-118,99,48
02240,240,02,2020,6957,8,23,31,96,48
02275,275,02,2010,2373,2,0,2,8,2
02275,275,02,2011,2397,10,0,10,28,13
02275,275,02,2012,2424,20,5,25,24,22
02275,275,02,2013,2450,17,8,25,23,22
02275,275,02,2014,2441,-27,3,-24,26,11
02275,275,02,2015,2452,13,8,21,22,32
02275,275,02,2016,2493,28,8,36,21,17
02275,275,02,2017,2516,18,10,28,19,21
02275,275,02,2018,2521,0,7,7,23,26
02275,275,02,2019,2513,-23,8,-15,22,14
02275,275,02,2020,2510,6,7,13,23,40
02282,282,02,2010,662,-4,1,-3,2,0
02282,282,02,2011,657,-14,5,-9,9,5
02282,282,02,2012,665,-2,4,2,8,2
02282,282,02,2013,652,-21,1,-20,9,3
02282,282,02,2014,655,-3,1,-2,7,2
02282,282,02,2015,637,-26,1,-25,10,4
02282,282,02,2016,615,-30,3,-27,8,3
02282,282,02,2017,610,-13,2,-11,9,3
02282,282,02,2018,600,-10,2,-8,0,2
02282,282,02,2019,576,-26,2,-24,10,9
02282,282,02,2020,637,60,2,62,6,6
02290,290,02,2010,5607,13,0,13,21,9
02290,290,02,2011,5625,-27,2,-25,96,55
02290,290,02,2012,5616,-37,2,-35,86,61
02290,290,02,2013,5554,-97,4,-93,91,62
02290,290,02,2014,5456,-126,0,-126,84,59
02290,290,02,2015,5461,-36,3,-33,89,52
02290,290,02,2016,5418,-69,3,-66,82,59
02290,290,02,2017,5400,-37,0,-37,84,65
02290,290,02,2018,5375,-48,0,-48,70,48
02290,290,02,2019,5254,-140,0,-140,77,58
02290,290,02,2020,5077,-185,0,-185,78,69
04001,001,04,2010,71828,115,6,121,278,89
04001,001,04,2011,72181,-154,31,-123,1074,595
04001,001,04,2012,72231,-466,52,-414,985,519
04001,001,04,2013,72333,-453,90,-363,996,531
04001,001,04,2014,71808,-1001,78,-923,977,601
04001,001,04,2015,71026,-1216,73,-1143,961,611
04001,001,04,2016,71418,3,50,53,1020,676
04001,001,04,2017,71538,-235,41,-194,969,654
04001,001,04,2018,71819,7,33,40,935,691
04001,001,04,2019,71920,-93,32,-61,901,740
04001,001,04,2020,71875,-194,29,-165,891,774
04003,003,04,2010,131823,233,103,336,397,266
04003,003,04,2011,133124,446,302,748,1770,1217
04003,003,04,2012,132085,-2082,532,-1550,1689,1218
04003,003,04,2013,129664,-3237,364,-2873,1631,1269
04003,003,04,2014,127437,-3061,309,-2752,1682,1244
04003,003,04,2015,126594,-1699,488,-1211,1605,1250
04003,003,04,2016,125885,-1140,224,-916,1550,1338
04003,003,04,2017,125048,-1050,128,-922,1412,1330
04003,003,04,2018,126581,1522,65,1587,1343,1404
04003,003,04,2019,127248,568,115,683,1376,1387
04003,003,04,2020,127450,191,115,306,1335,1442
04005,005,04,2010,134624,-103,41,-62,428,165
04005,005,04,2011,134309,-1562,159,-1403,1801,723
04005,005,04,2012,136204,672,180,852,1725,726
04005,005,04,2013,136788,-627,282,-345,1682,739
04005,005,04,2014,137675,-372,328,-44,1666,711
04005,005,04,2015,139100,371,161,532,1675,784
04005,005,04,2016,140609,506,267,773,1564,831
04005,005,04,2017,141300,-165,148,-17,1594,883
04005,005,04,2018,142914,897,75,972,1503,869
04005,005,04,2019,143967,391,101,492,1442,886
04005,005,04,2020,142481,-2049,86,-1963,1440,963
04007,007,04,2010,53565,12,7,19,166,207
04007,007,04,2011,53445,-116,27,-89,659,687
04007,007,04,2012,53009,-357,32,-325,592,698
04007,007,04,2013,53026,56,31,87,604,670
04007,007,04,2014,53074,135,39,174,623,742
04007,007,04,2015,53020,94,34,128,608,784
04007,007,04,2016,53400,599,28,627,583,828
04007,007,04,2017,53619,409,19,428,592,799
04007,007,04,2018,53833,444,9,453,519,758
04007,007,04,2019,54077,547,14,561,490,804
04007,007,04,2020,54303,644,17,661,481,910
04009,009,04,2010,37154,-145,2,-143,125,46
04009,009,04,2011,37129,-305,4,-301,558,283
04009,009,04,2012,37027,-392,14,-378,530,269
04009,009,04,2013,37456,97,45,142,594,302
04009,009,04,2014,38123,241,61,302,639,275
04009,009,04,2015,37888,-627,91,-536,574,279
04009,009,04,2016,37859,-370,49,-321,578,287
04009,009,04,2017,37530,-646,44,-602,545,276
04009,009,04,2018,38032,285,35,320,512,328
04009,009,04,2019,38890,604,51,655,508,304
04009,009,04,2020,39211,86,40,126,514,321
04011,011,04,2010,8342,-105,2,-103,21,27
04011,011,04,2011,8587,158,26,184,112,52
04011,011,04,2012,8764,116,17,133,124,83
04011,011,04,2013,8918,79,21,100,106,55
04011,011,04,2014,9356,311,22,333,140,47
04011,011,04,2015,9587,103,19,122,164,54
04011,011,04,2016,9642,-26,11,-15,140,70
04011,011,04,2017,9451,-304,12,-292,157,58
04011,011,04,2018,9424,-104,10,-94,143,75
04011,011,04,2019,9467,-52,10,-42,121,37
04011,011,04,2020,9341,-202,11,-191,123,57
04012,012,04,2010,20499,-9,3,-6,44,25
04012,012,04,2011,20606,62,50,112,196,199
04012,012,04,2012,20524,-84,38,-46,184,218
04012,012,04,2013,20526,10,49,59,202,257
04012,012,04,2014,20521,-49,81,32,214,246
04012,012,04,2015,20476,-108,119,11,214,269
04012,012,04,2016,20670,171,88,259,205,268
04012,012,04,2017,20737,82,76,158,204,292
04012,012,04,2018,21030,373,58,431,210,348
04012,012,04,2019,21257,268,80,348,173,289
04012,012,04,2020,21480,295,71,366,188,330
04013,013,04,2010,3825183,-458,1868,1410,13121,6315
04013,013,04,2011,3875371,10836,11929,22765,53379,25930
04013,013,04,2012,3948165,33545,10444,43989,54290,26038
04013,013,04,2013,4018657,30514,12495,43009,54621,27400
04013,013,04,2014,4094842,33417,14856,48273,54619,27074
04013,013,04,2015,4174423,39284,12903,52187,55664,28481
04013,013,04,2016,4258019,44692,14692,59384,54438,30340
04013,013,04,2017,4329227,38523,9690,48213,53252,30352
04013,013,04,2018,4405306,50310,5844,56154,52001,32276
04013,013,04,2019,4492261,59870,7754,67624,52375,33085
04013,013,04,2020,4579081,64403,6185,70588,52573,36247
04015,015,04,2010,200336,257,-23,234,493,571
04015,015,04,2011,202888,2898,5,2903,2011,2374
04015,015,04,2012,203484,1369,-90,1279,1868,2575
04015,015,04,2013,203322,798,-53,745,1746,2646
04015,015,04,2014,203670,1152,-72,1080,1786,2520
04015,015,04,2015,204890,2301,-80,2221,1852,2865
04015,015,04,2016,205899,2309,7,2316,1812,3119
04015,015,04,2017,207668,3214,-54,3160,1789,3187
04015,015,04,2018,210371,4361,-106,4255,1757,3318
04015,015,04,2019,213846,5183,-68,5115,1793,3417
04015,015,04,2020,217206,5322,-62,5260,1780,3656
04017,017,04,2010,107693,-38,6,-32,454,203
04017,017,04,2011,107560,-1030,42,-988,1739,886
04017,017,04,2012,107334,-981,43,-938,1607,913
04017,017,04,2013,107164,-881,69,-812,1625,987
04017,017,04,2014,107741,-144,97,-47,1540,895
04017,017,04,2015,107695,-745,86,-659,1570,956
04017,017,04,2016,108569,200,89,289,1555,963
04017,017,04,2017,109145,79,66,145,1456,1018
04017,017,04,2018,110490,925,54,979,1491,1122
04017,017,04,2019,111037,326,75,401,1376,1230
04017,017,04,2020,112112,884,55,939,1363,1227
04019,019,04,2010,981649,111,495,606,2900,2004
04019,019,04,2011,988500,904,2537,3441,12079,8634
04019,019,04,2012,993231,-690,2511,1821,11821,8703
04019,019,04,2013,997374,-1792,2919,1127,12040,8869
04019,019,04,2014,1004521,799,3334,4133,12031,8781
04019,019,04,2015,1009490,-739,3245,2506,11742,9170
04019,019,04,2016,1017083,2758,3136,5894,11306,9561
04019,019,04,2017,1027115,6084,2205,8289,11257,9500
04019,019,04,2018,1037746,8058,1391,9449,10957,9775
04019,019,04,2019,1049261,9262,2008,11270,10633,10380
04019,019,04,2020,1061175,10778,1584,12362,10667,11132
04021,021,04,2010,379106,2419,131,2550,1172,637
04021,021,04,2011,378114,-4760,1193,-3567,4911,2365
04021,021,04,2012,382371,1118,1125,2243,4534,2473
04021,021,04,2013,385574,-172,1295,1123,4647,2515
04021,021,04,2014,395563,6462,1407,7869,4551,2604
04021,021,04,2015,405922,7389,1156,8545,4509,2779
04021,021,04,2016,417312,8985,883,9868,4470,2977
04021,021,04,2017,431490,12234,558,12792,4440,3134
04021,021,04,2018,446524,13372,332,13704,4431,3146
04021,021,04,2019,461640,13448,506,13954,4603,3402
04021,021,04,2020,480828,17977,405,18382,4678,3777
04023,023,04,2010,47402,-145,-17,-162,180,40
04023,023,04,2011,47640,-265,68,-197,711,277
04023,023,04,2012,47330,-708,-2,-710,662,279
04023,023,04,2013,46902,-855,32,-823,670,293
04023,023,04,2014,46596,-788,126,-662,619,285
04023,023,04,2015,46493,-718,269,-449,621,282
04023,023,04,2016,46412,-555,125,-430,651,304
04023,023,04,2017,46578,-263,98,-165,635,305
04023,023,04,2018,46446,-547,71,-476,633,290
04023,023,04,2019,46728,-187,182,-5,597,310
04023,023,04,2020,46808,-292,129,-163,612,371
04025,025,04,2010,210990,138,54,192,460,643
04025,025,04,2011,211081,635,231,866,1844,2611
04025,025,04,2012,212065,1721,110,1831,1732,2601
04025,025,04,2013,214539,3187,87,3274,1859,2726
04025,025,04,2014,217882,4100,77,4177,1876,2833
04025,025,04,2015,221019,3921,59,3980,1970,2857
04025,025,04,2016,224828,4769,113,4882,1857,2950
04025,025,04,2017,228398,4726,50,4776,1848,3075
04025,025,04,2018,232467,5500,-5,5495,1783,3218
04025,025,04,2019,236062,4893,38,4931,1802,3119
04025,025,04,2020,240226,5671,22,5693,1798,3298
04027,027,04,2010,197148,828,45,873,712,268
04027,027,04,2011,202881,3295,500,3795,3253,1340
04027,027,04,2012,202520,-2925,667,-2258,3238,1435
04027,027,04,2013,202447,-2707,854,-1853,3074,1353
04027,027,04,2014,204064,-1297,1124,-173,3166,1383
04027,027,04,2015,205187,-2003,1518,-485,3026,1422
04027,027,04,2016,207162,-441,932,491,3007,1511
04027,027,04,2017,209244,-40,581,541,3006,1457
04027,027,04,2018,211245,374,314,688,2916,1594
04027,027,04,2019,214182,777,720,1497,3104,1659
04027,027,04,2020,217824,1920,585,2505,3008,1880
05001,001,05,2010,19049,-39,5,-34,72,33
05001,001,05,2011,18915,-138,25,-113,234,257
05001,001,05,2012,19007,45,20,65,284,254
05001,001,05,2013,18797,-214,9,-205,242,248
05001,001,05,2014,18524,-284,-1,-285,220,215
05001,001,05,2015,18376,-151,-2,-153,249,243
05001,001,05,2016,18204,-189,3,-186,247,234
05001,001,05,2017,17925,-272,4,-268,238,250
05001,001,05,2018,17779,-139,5,-134,221,232
05001,001,05,2019,17515,-248,4,-244,219,239
05001,001,05,2020,17383,-109,4,-105,208,236
05003,003,05,2010,21832,-26,1,-25,60,47
05003,003,05,2011,21678,-188,2,-186,303,271
05003,003,05,2012,21523,-207,-5,-212,265,210
05003,003,05,2013,21289,-242,-5,-247,269,258
05003,003,05,2014,20974,-324,-2,-326,264,261
05003,003,05,2015,20856,-97,-5,-102,254,269
05003,003,05,2016,20544,-294,-3,-297,235,252
05003,003,05,2017,20333,-174,-4,-178,234,266
05003,003,05,2018,20041,-227,-5,-232,224,284
05003,003,05,2019,19742,-294,-4,-298,236,237
05003,003,05,2020,19339,-347,-3,-350,222,271
05005,005,05,2010,41511,56,0,56,82,135
05005,005,05,2011,41354,193,2,195,331,681
05005,005,05,2012,41091,100,-10,90,325,673
05005,005,05,2013,41000,232,1,233,343,664
05005,005,05,2014,40903,220,20,240,326,663
05005,005,05,2015,41156,484,19,503,384,636
05005,005,05,2016,41159,322,18,340,378,714
05005,005,05,2017,41319,499,-4,495,361,695
05005,005,05,2018,41665,667,-5,662,366,681
05005,005,05,2019,41978,667,-5,662,344,689
05005,005,05,2020,42242,677,-5,672,350,753
05007,007,05,2010,222601,528,156,684,829,292
05007,007,05,2011,229208,4048,841,4889,3279,1588
05007,007,05,2012,235010,3051,970,4021,3364,1661
05007,007,05,2013,239559,2368,566,2934,3234,1660
05007,007,05,2014,244962,2738,809,3547,3434,1621
05007,007,05,2015,251759,4321,715,5036,3563,1855
05007,007,05,2016,259497,4904,874,5778,3711,1773
05007,007,05,2017,266882,4841,606,5447,3663,1748
05007,007,05,2018,272560,3600,287,3887,3757,1979
05007,007,05,2019,279835,4973,370,5343,3801,1865
05007,007,05,2020,288774,6765,330,7095,3875,1998
05009,009,05,2010,36893,16,-1,15,93,128
05009,009,05,2011,37093,191,0,191,419,411
05009,009,05,2012,37348,179,3,182,476,397
05009,009,05,2013,37353,-8,-9,-17,485,458
05009,009,05,2014,37150,-266,4,-262,459,400
05009,009,05,2015,37165,24,2,26,441,447
05009,009,05,2016,37307,150,10,160,462,476
05009,009,05,2017,37531,205,0,205,482,463
05009,009,05,2018,37545,69,-6,63,388,434
05009,009,05,2019,37616,152,-7,145,391,464
05009,009,05,2020,37625,134,-4,130,372,493
05011,011,05,2010,11470,-15,8,-7,35,62
05011,011,05,2011,11432,-33,0,-33,147,152
05011,011,05,2012,11262,-152,-4,-156,129,147
05011,011,05,2013,11120,-138,1,-137,151,157
05011,011,05,2014,11006,-64,-5,-69,121,167
05011,011,05,2015,10999,-2,-1,-3,139,142
05011,011,05,2016,10961,-33,-2,-35,138,139
05011,011,05,2017,10813,-118,-1,-119,125,157
05011,011,05,2018,10818,35,-4,31,141,167
05011,011,05,2019,10792,-44,-4,-48,141,118
05011,011,05,2020,10639,-157,-1,-158,136,131
05013,013,05,2010,5361,-16,0,-16,14,4
05013,013,05,2011,5241,-103,0,-103,39,57
05013,013,05,2012,5276,37,0,37,48,50
05013,013,05,2013,5190,-66,0,-66,50,70
05013,013,05,2014,5165,-4,0,-4,46,65
05013,013,05,2015,5197,46,0,46,42,57
05013,013,05,2016,5147,-35,0,-35,56,71
05013,013,05,2017,5196,88,0,88,41,80
05013,013,05,2018,5206,51,0,51,36,76
05013,013,05,2019,5137,-44,-1,-45,31,55
05013,013,05,2020,5113,-1,0,-1,29,53
05015,015,05,2010,27556,60,7,67,74,38
05015,015,05,2011,27478,-105,18,-87,313,303
05015,015,05,2012,27643,136,29,165,305,305
05015,015,05,2013,27815,123,38,161,309,298
05015,015,05,2014,27763,-103,55,-48,311,308
05015,015,05,2015,27777,-21,36,15,338,335
05015,015,05,2016,27730,-113,65,-48,310,308
05015,015,05,2017,27901,130,54,184,331,342
05015,015,05,2018,28049,137,34,171,308,332
05015,015,05,2019,28352,255,39,294,316,306
05015,015,05,2020,28276,-98,32,-66,322,331
05017,017,05,2010,11799,-17,2,-15,34,20
05017,017,05,2011,11706,-100,19,-81,169,181
05017,017,05,2012,11503,-238,19,-219,169,160
05017,017,05,2013,11370,-122,12,-110,129,153
05017,017,05,2014,11223,-162,19,-143,142,148
05017,017,05,2015,10987,-192,9,-183,105,159
05017,017,05,2016,10929,-56,-1,-57,151,151
05017,017,05,2017,10655,-260,-1,-261,127,139
05017,017,05,2018,10466,-144,-1,-145,112,156
05017,017,05,2019,10189,-261,-1,-262,125,138
05017,017,05,2020,9924,-216,0,-216,114,161
05019,019,05,2010,22928,-47,8,-39,65,93
05019,019,05,2011,22937,18,23,41,238,269
05019,019,05,2012,22768,-190,13,-177,250,247
05019,019,05,2013,22600,-160,18,-142,221,249
05019,019,05,2014,22578,-42,15,-27,243,232
05019,019,05,2015,22536,-37,17,-20,250,270
05019,019,05,2016,22643,50,32,82,233,208
05019,019,05,2017,22234,-396,23,-373,229,269
05019,019,05,2018,22358,111,9,120,247,244
05019,019,05,2019,22365,-8,27,19,218,231
05019,019,05,2020,22103,-237,18,-219,218,259
05021,021,05,2010,16050,16,0,16,37,84
05021,021,05,2011,15876,-115,0,-115,176,236
05021,021,05,2012,15710,-74,-1,-75,165,256
05021,021,05,2013,15482,-129,-2,-131,145,241
05021,021,05,2014,15298,-105,-1,-106,175,254
05021,021,05,2015,15206,-60,0,-60,180,212
05021,021,05,2016,15059,-83,-1,-84,181,242
05021,021,05,2017,14859,-100,0,-100,157,257
05021,021,05,2018,14763,-24,0,-24,185,256
05021,021,05,2019,14494,-204,0,-204,142,206
05021,021,05,2020,14375,-64,0,-64,153,208
05023,023,05,2010,25989,55,-1,54,71,104
05023,023,05,2011,25888,0,-5,-5,267,361
05023,023,05,2012,25776,20,-2,18,231,358
05023,023,05,2013,25645,-17,-5,-22,264,367
05023,023,05,2014,25616,123,-2,121,211,356
05023,023,05,2015,25384,-132,5,-127,261,364
05023,023,05,2016,25171,-32,-2,-34,205,382
05023,023,05,2017,25085,47,-4,43,256,383
05023,023,05,2018,25105,153,-4,149,238,364
05023,023,05,2019,25019,106,-4,102,211,397
05023,023,05,2020,24935,117,-2,115,215,413
05025,025,05,2010,8677,7,0,7,21,42
05025,025,05,2011,8673,0,1,1,85,91
05025,025,05,2012,8610,-80,0,-80,100,84
05025,025,05,2013,8517,-74,0,-74,87,108
05025,025,05,2014,8404,-108,2,-106,78,86
05025,025,05,2015,8290,-97,1,-96,88,105
05025,025,05,2016,8253,4,2,6,76,119
05025,025,05,2017,8177,-48,0,-48,90,118
05025,025,05,2018,7991,-173,-1,-174,86,99
05025,025,05,2019,7937,-26,-1,-27,58,84
05025,025,05,2020,7957,50,0,50,65,94
05027,027,05,2010,24722,179,11,190,72,118
05027,027,05,2011,24707,-33,43,10,288,313
05027,027,05,2012,24408,-340,51,-289,300,317
05027,027,05,2013,24282,-128,34,-94,285,315
05027,027,05,2014,24051,-297,40,-257,307,284
05027,027,05,2015,24118,7,27,34,315,278
05027,027,05,2016,24015,-110,10,-100,292,293
05027,027,05,2017,23675,-303,6,-297,267,311
05027,027,05,2018,23582,-84,5,-79,294,307
05027,027,05,2019,23496,-92,5,-87,280,281
05027,027,05,2020,23331,-148,3,-145,281,300
05029,029,05,2010,21219,-28,1,-27,57,76
05029,029,05,2011,21127,-118,10,-108,271,254
05029,029,05,2012,21141,3,2,5,268,254
05029,029,05,2013,21091,-63,2,-61,270,257
05029,029,05,2014,20999,-79,1,-78,254,265
05029,029,05,2015,20939,-49,3,-46,252,262
05029,029,05,2016,20877,-35,1,-34,231,260
05029,029,05,2017,20821,-5,9,4,238,296
05029,029,05,2018,20836,66,3,69,235,288
05029,029,05,2019,20905,32,14,46,241,218
05029,029,05,2020,21037,116,15,131,239,238
05031,031,05,2010,96751,117,29,146,334,171
05031,031,05,2011,98420,997,162,1159,1365,860
05031,031,05,2012,100018,887,173,1060,1406,886
05031,031,05,2013,101682,957,119,1076,1423,848
05031,031,05,2014,102707,362,168,530,1428,920
05031,031,05,2015,104509,974,179,1153,1558,912
05031,031,05,2016,106039,629,220,849,1579,896
05031,031,05,2017,107274,623,144,767,1440,969
05031,031,05,2018,109074,1090,66,1156,1545,902
05031,031,05,2019,110772,1115,95,1210,1519,1030
05031,031,05,2020,112245,969,80,1049,1544,1123
05033,033,05,2010,61961,6,4,10,183,163
05033,033,05,2011,61816,-271,-9,-280,710,574
05033,033,05,2012,61940,-92,37,-55,774,584
05033,033,05,2013,61708,-439,54,-385,768,617
05033,033,05,2014,61856,-154,76,-78,819,586
05033,033,05,2015,61963,-120,92,-28,807,667
05033,033,05,2016,62312,166,51,217,755,620
05033,033,05,2017,62982,513,36,549,761,637
05033,033,05,2018,63480,393,25,418,756,672
05033,033,05,2019,63406,-213,13,-200,761,636
05033,033,05,2020,63409,-12,18,6,714,719
05035,035,05,2010,50955,-66,3,-63,196,89
05035,035,05,2011,50517,-732,9,-723,794,513
05035,035,05,2012,50038,-779,9,-770,789,523
05035,035,05,2013,49677,-633,-5,-638,794,526
05035,035,05,2014,49479,-489,11,-478,769,496
05035,035,05,2015,48972,-894,13,-881,829,464
05035,035,05,2016,49296,-47,25,-22,826,479
05035,035,05,2017,48704,-796,14,-782,736,545
05035,035,05,2018,48365,-552,5,-547,739,533
05035,035,05,2019,47924,-610,7,-603,702,541
05035,035,05,2020,47616,-433,3,-430,689,567
05037,037,05,2010,17868,-44,0,-44,48,23
05037,037,05,2011,17813,-57,0,-57,219,217
05037,037,05,2012,17703,-112,0,-112,244,244
05037,037,05,2013,17521,-170,0,-170,234,249
05037,037,05,2014,17180,-356,0,-356,218,211
05037,037,05,2015,17253,98,6,104,203,233
05037,037,05,2016,17029,-243,8,-235,229,219
05037,037,05,2017,16792,-186,6,-180,209,265
05037,037,05,2018,16584,-205,4,-201,216,224
05037,037,05,2019,16333,-238,4,-234,201,216
05037,037,05,2020,16142,-167,3,-164,199,225
05039,039,05,2010,8066,-34,-1,-35,26,50
05039,039,05,2011,8056,-15,9,-6,98,101
05039,039,05,2012,7954,-66,3,-63,79,119
05039,039,05,2013,7896,-28,5,-23,78,113
05039,039,05,2014,7698,-161,1,-160,67,107
05039,039,05,2015,7539,-127,2,-125,80,115
05039,039,05,2016,7401,-102,-4,-106,71,103
05039,039,05,2017,7312,-34,-2,-36,76,129
05039,039,05,2018,7106,-179,-3,-182,82,106
05039,039,05,2019,6951,-130,-2,-132,58,82
05039,039,05,2020,6802,-113,-1,-114,53,87
05041,041,05,2010,12953,-41,1,-40,43,51
05041,041,05,2011,12726,-273,1,-272,192,149
05041,041,05,2012,12586,-169,4,-165,174,154
05041,041,05,2013,12497,-137,25,-112,154,133
05041,041,05,2014,12265,-262,6,-256,172,153
05041,041,05,2015,12024,-252,18,-234,162,172
05041,041,05,2016,11904,-127,12,-115,160,164
05041,041,05,2017,11762,-163,17,-146,161,159
05041,041,05,2018,11516,-218,8,-210,146,182
05041,041,05,2019,11400,-111,22,-89,140,167
05041,041,05,2020,11110,-267,17,-250,139,178
05043,043,05,2010,18666,146,3,149,45,65
05043,043,05,2011,18735,-9,25,16,219,164
05043,043,05,2012,18789,-17,9,-8,242,179
05043,043,05,2013,18684,-168,12,-156,223,176
05043,043,05,2014,18643,-65,1,-64,254,230
05043,043,05,2015,18615,-68,-2,-70,239,196
05043,043,05,2016,18574,-63,-2,-65,261,236
05043,043,05,2017,18372,-218,-1,-219,228,211
05043,043,05,2018,18302,-86,-1,-87,236,219
05043,043,05,2019,18092,-268,-1,-269,244,186
05043,043,05,2020,17977,-147,-1,-148,247,213
05045,045,05,2010,114035,568,26,594,387,237
05045,045,05,2011,116307,1376,113,1489,1579,806
05045,045,05,2012,118572,1333,160,1493,1567,826
05045,045,05,2013,119251,9,70,79,1517,900
05045,045,05,2014,120646,596,126,722,1545,867
05045,045,05,2015,121333,-78,139,61,1558,917
05045,045,05,2016,122213,92,197,289,1572,976
05045,045,05,2017,123706,761,157,918,1506,932
05045,045,05,2018,125336,986,82,1068,1560,1002
05045,045,05,2019,125828,-90,117,27,1447,986
05045,045,05,2020,126919,549,104,653,1441,1012
05047,047,05,2010,18137,-3,1,-2,45,35
05047,047,05,2011,18006,-101,3,-98,201,234
05047,047,05,2012,17958,-17,5,-12,205,245
05047,047,05,2013,17917,-11,5,-6,184,216
05047,047,05,2014,17828,-67,3,-64,195,219
05047,047,05,2015,17753,-47,4,-43,219,249
05047,047,05,2016,17676,-49,11,-38,200,240
05047,047,05,2017,17833,207,13,220,177,238
05047,047,05,2018,17780,-49,16,-33,190,209
05047,047,05,2019,17737,-15,2,-13,174,205
05047,047,05,2020,17897,187,5,192,173,203
05049,049,05,2010,12210,17,1,18,31,70
05049,049,05,2011,12236,100,-1,99,95,167
05049,049,05,2012,12170,-33,-2,-35,120,151
05049,049,05,2013,12175,43,-1,42,117,152
05049,049,05,2014,12090,-19,6,-13,109,181
05049,049,05,2015,12149,89,11,100,113,154
05049,049,05,2016,12112,12,12,24,111,171
05049,049,05,2017,12147,96,7,103,122,191
05049,049,05,2018,12351,264,3,267,122,184
05049,049,05,2019,12516,237,4,241,123,198
05049,049,05,2020,12381,-32,2,-30,119,223
05051,051,05,2010,96080,137,11,148,293,365
05051,051,05,2011,96884,979,13,992,1152,1340
05051,051,05,2012,97043,428,-6,422,1079,1333
05051,051,05,2013,97734,965,11,976,1112,1410
05051,051,05,2014,97851,349,9,358,1078,1301
05051,051,05,2015,97930,321,58,379,1096,1387
05051,051,05,2016,98356,694,51,745,1059,1374
05051,051,05,2017,98476,366,17,383,1133,1390
05051,051,05,2018,99121,980,-13,967,1125,1445
05051,051,05,2019,99472,686,13,699,1035,1384
05051,051,05,2020,99789,711,12,723,1043,1445
05053,053,05,2010,17887,29,1,30,47,31
05053,053,05,2011,17950,44,24,68,189,194
05053,053,05,2012,18039,71,5,76,206,192
05053,053,05,2013,18047,-29,1,-28,217,183
05053,053,05,2014,18084,44,1,45,168,172
05053,053,05,2015,18031,-53,-2,-55,199,196
05053,053,05,2016,18080,70,-4,66,188,204
05053,053,05,2017,18118,56,-3,53,181,196
05053,053,05,2018,18209,102,-3,99,183,189
05053,053,05,2019,18287,94,-3,91,180,194
05053,053,05,2020,18449,181,0,181,182,201
05055,055,05,2010,42202,74,0,74,129,92
05055,055,05,2011,42767,465,14,479,539,453
05055,055,05,2012,43237,316,33,349,577,458
05055,055,05,2013,43176,-143,21,-122,571,504
05055,055,05,2014,43809,526,17,543,549,467
05055,055,05,2015,44321,360,3,363,602,450
05055,055,05,2016,44733,336,-7,329,574,490
05055,055,05,2017,45002,210,-9,201,580,513
05055,055,05,2018,45339,278,-11,267,583,512
05055,055,05,2019,45316,-42,-11,-53,535,506
05055,055,05,2020,45597,290,-4,286,534,539
05057,057,05,2010,22604,-47,0,-47,103,47
05057,057,05,2011,22498,-159,-15,-174,319,251
05057,057,05,2012,22355,-227,-17,-244,339,246
05057,057,05,2013,22434,3,-3,0,315,233
05057,057,05,2014,22339,-168,-14,-182,321,235
05057,057,05,2015,22095,-325,0,-325,328,247
05057,057,05,2016,22047,-138,-7,-145,321,222
05057,057,05,2017,21895,-224,-4,-228,314,237
05057,057,05,2018,21714,-191,-10,-201,293,275
05057,057,05,2019,21568,-173,1,-172,289,264
05057,057,05,2020,21253,-337,2,-335,274,251
05059,059,05,2010,33236,177,2,179,76,55
05059,059,05,2011,33145,-123,7,-116,381,356
05059,059,05,2012,33512,395,3,398,330,381
05059,059,05,2013,33534,42,16,58,358,388
05059,059,05,2014,33418,-32,3,-29,336,414
05059,059,05,2015,33511,138,6,144,372,422
05059,059,05,2016,33452,-16,8,-8,348,396
05059,059,05,2017,33630,224,8,232,365,419
05059,059,05,2018,33680,165,4,169,356,474
05059,059,05,2019,33784,98,12,110,375,380
05059,059,05,2020,33787,41,10,51,361,410
05061,061,05,2010,13798,1,3,4,48,33
05061,061,05,2011,13817,-15,12,-3,187,163
05061,061,05,2012,13676,-183,7,-176,192,161
05061,061,05,2013,13541,-161,21,-140,186,184
05061,061,05,2014,13489,-87,6,-81,190,161
05061,061,05,2015,13332,-163,5,-158,176,177
05061,061,05,2016,13347,-11,0,-11,187,160
05061,061,05,2017,13361,-19,-1,-20,197,163
05061,061,05,2018,13297,-53,-6,-59,169,174
05061,061,05,2019,13219,-76,5,-71,158,164
05061,061,05,2020,13109,-104,6,-98,165,177
05063,063,05,2010,36811,132,6,138,120,101
05063,063,05,2011,36887,-66,79,13,453,389
05063,063,05,2012,36961,-17,18,1,482,403
05063,063,05,2013,36899,-153,40,-113,474,418
05063,063,05,2014,37095,136,2,138,457,393
05063,063,05,2015,37055,-32,13,-19,455,472
05063,063,05,2016,37121,6,9,15,464,410
05063,063,05,2017,37416,275,11,286,468,457
05063,063,05,2018,37799,264,-1,263,527,406
05063,063,05,2019,37819,-1,15,14,415,410
05063,063,05,2020,37757,-45,13,-32,431,461
05065,065,05,2010,13732,10,1,11,36,21
05065,065,05,2011,13579,-77,6,-71,114,196
05065,065,05,2012,13548,16,14,30,122,182
05065,065,05,2013,13420,-60,7,-53,124,198
05065,065,05,2014,13566,203,12,215,118,194
05065,065,05,2015,13495,27,8,35,97,203
05065,065,05,2016,13500,62,3,65,112,172
05065,065,05,2017,13673,252,1,253,121,200
05065,065,05,2018,13574,7,0,7,111,215
05065,065,05,2019,13620,104,1,105,132,190
05065,065,05,2020,13613,71,0,71,125,202
05067,067,05,2010,18066,46,0,46,44,36
05067,067,05,2011,17898,-118,0,-118,184,234
05067,067,05,2012,17691,-187,4,-183,209,237
05067,067,05,2013,17741,81,3,84,207,241
05067,067,05,2014,17608,-125,2,-123,201,211
05067,067,05,2015,17386,-153,-1,-154,174,240
05067,067,05,2016,17314,-68,-2,-70,217,218
05067,067,05,2017,17033,-222,-2,-224,200,258
05067,067,05,2018,16776,-200,-2,-202,196,252
05067,067,05,2019,16782,29,-2,27,174,194
05067,067,05,2020,16636,-105,-1,-106,187,227
05069,069,05,2010,77332,-170,2,-168,254,188
05069,069,05,2011,76039,-1515,19,-1496,974,781
05069,069,05,2012,74658,-1523,29,-1494,902,844
05069,069,05,2013,73233,-1577,24,-1553,947,856
05069,069,05,2014,72504,-906,25,-881,958,819
05069,069,05,2015,71920,-689,39,-650,948,880
05069,069,05,2016,70512,-1521,60,-1461,928,881
05069,069,05,2017,69350,-1189,41,-1148,841,859
05069,069,05,2018,68241,-1152,22,-1130,836,818
05069,069,05,2019,67137,-1103,35,-1068,814,847
05069,069,05,2020,65377,-1684,27,-1657,789,880
05071,071,05,2010,25560,0,7,7,93,80
05071,071,05,2011,25683,-12,63,51,331,257
05071,071,05,2012,25921,80,43,123,367,248
05071,071,05,2013,25941,-79,35,-44,362,294
05071,071,05,2014,25976,-108,19,-89,349,226
05071,071,05,2015,26103,36,30,66,339,274
05071,071,05,2016,26160,-89,21,-68,385,259
05071,071,05,2017,26423,192,15,207,343,285
05071,071,05,2018,26684,189,-3,186,338,263
05071,071,05,2019,26596,-188,19,-169,349,269
05071,071,05,2020,26513,-163,20,-143,329,271
05073,073,05,2010,7638,-6,0,-6,20,10
05073,073,05,2011,7528,-69,4,-65,74,119
05073,073,05,2012,7444,-62,0,-62,66,89
05073,073,05,2013,7279,-110,5,-105,59,120
05073,073,05,2014,7157,-102,6,-96,82,108
05073,073,05,2015,7009,-121,3,-118,73,105
05073,073,05,2016,6895,-113,5,-108,79,85
05073,073,05,2017,6807,-62,7,-55,79,110
05073,073,05,2018,6684,-106,3,-103,65,87
05073,073,05,2019,6656,-20,14,-6,69,91
05073,073,05,2020,6596,-31,8,-23,66,103
05075,075,05,2010,17518,85,1,86,50,37
05075,075,05,2011,17281,-176,5,-171,166,233
05075,075,05,2012,17040,-189,1,-188,190,248
05075,075,05,2013,17051,48,3,51,185,223
05075,075,05,2014,16970,-18,3,-15,200,261
05075,075,05,2015,16705,-248,5,-243,197,222
05075,075,05,2016,16662,1,6,7,195,243
05075,075,05,2017,16588,5,2,7,183,263
05075,075,05,2018,16452,-100,-1,-101,211,247
05075,075,05,2019,16440,42,0,42,182,235
05075,075,05,2020,16410,59,2,61,185,276
05077,077,05,2010,10388,-46,3,-43,20,22
05077,077,05,2011,10282,-97,0,-97,104,113
05077,077,05,2012,10174,-78,1,-77,112,146
05077,077,05,2013,9996,-131,1,-130,98,147
05077,077,05,2014,9827,-155,0,-155,107,123
05077,077,05,2015,9660,-150,0,-150,106,123
05077,077,05,2016,9330,-326,3,-323,103,112
05077,077,05,2017,9121,-187,6,-181,86,115
05077,077,05,2018,8962,-139,1,-138,93,114
05077,077,05,2019,8889,-70,14,-56,78,95
05077,077,05,2020,8513,-345,12,-333,81,121
05079,079,05,2010,14090,-71,1,-70,33,19
05079,079,05,2011,14344,239,3,242,124,115
05079,079,05,2012,14186,-184,-2,-186,131,108
05079,079,05,2013,14070,-67,-3,-70,107,153
05079,079,05,2014,14034,-29,-7,-36,126,123
05079,079,05,2015,13872,-136,8,-128,91,125
05079,079,05,2016,13745,-130,4,-126,130,131
05079,079,05,2017,13481,-232,9,-223,111,153
05079,079,05,2018,13208,-234,0,-234,121,162
05079,079,05,2019,13012,-200,25,-175,119,141
05079,079,05,2020,12944,-46,19,-27,126,167
05081,081,05,2010,13133,-25,0,-25,45,57
05081,081,05,2011,12949,-136,-2,-138,126,171
05081,081,05,2012,12926,-1,-2,-3,138,156
05081,081,05,2013,12743,-180,-4,-184,141,144
05081,081,05,2014,12515,-224,-3,-227,157,162
05081,081,05,2015,12417,-47,-2,-49,116,165
05081,081,05,2016,12435,52,-2,50,153,184
05081,081,05,2017,12386,-16,-4,-20,142,170
05081,081,05,2018,12357,-26,-4,-30,156,156
05081,081,05,2019,12368,33,-4,29,148,166
05081,081,05,2020,12180,-156,-3,-159,155,182
05083,083,05,2010,22307,-12,3,-9,53,96
05083,083,05,2011,22241,-60,0,-60,258,264
05083,083,05,2012,21928,-353,21,-332,271,261
05083,083,05,2013,22034,80,40,120,260,270
05083,083,05,2014,21866,-132,37,-95,223,294
05083,083,05,2015,21728,-164,37,-127,290,302
05083,083,05,2016,21743,-16,20,4,302,288
05083,083,05,2017,21740,-7,9,2,269,273
05083,083,05,2018,21705,-2,2,0,252,286
05083,083,05,2019,21495,-185,8,-177,251,283
05083,083,05,2020,21410,-22,6,-16,243,312
05085,085,05,2010,68739,186,43,229,230,103
05085,085,05,2011,69537,293,134,427,974,602
05085,085,05,2012,70131,89,164,253,958,602
05085,085,05,2013,70775,235,105,340,954,638
05085,085,05,2014,71408,135,126,261,962,576
05085,085,05,2015,71409,-421,117,-304,980,674
05085,085,05,2016,71845,108,40,148,963,672
05085,085,05,2017,72843,762,12,774,919,693
05085,085,05,2018,73560,547,-14,533,885,698
05085,085,05,2019,73648,-135,0,-135,907,687
05085,085,05,2020,73921,128,6,134,888,755
05087,087,05,2010,15686,-25,2,-23,47,64
05087,087,05,2011,15665,-13,6,-7,166,180
05087,087,05,2012,15604,-108,6,-102,206,165
05087,087,05,2013,15690,39,4,43,193,149
05087,087,05,2014,15741,-6,17,11,209,168
05087,087,05,2015,15719,-27,17,-10,183,193
05087,087,05,2016,16136,344,10,354,230,168
05087,087,05,2017,16307,156,9,165,234,227
05087,087,05,2018,16359,32,7,39,208,193
05087,087,05,2019,16519,158,8,166,168,175
05087,087,05,2020,16644,82,5,87,195,157
05089,089,05,2010,16665,14,2,16,41,35
05089,089,05,2011,16676,84,5,89,159,236
05089,089,05,2012,16628,17,8,25,154,225
05089,089,05,2013,16449,-60,1,-59,141,258
05089,089,05,2014,16428,75,3,78,156,253
05089,089,05,2015,16226,-102,16,-86,148,262
05089,089,05,2016,16408,235,22,257,174,250
05089,089,05,2017,16458,154,10,164,154,268
05089,089,05,2018,16631,303,1,304,154,285
05089,089,05,2019,16645,139,2,141,137,265
05089,089,05,2020,16790,303,5,308,141,300
05091,091,05,2010,43568,15,4,19,164,74
05091,091,05,2011,43777,23,-1,22,636,448
05091,091,05,2012,43686,-237,-7,-244,601,444
05091,091,05,2013,43439,-327,-20,-347,607,506
05091,091,05,2014,43509,-98,-2,-100,605,427
05091,091,05,2015,43858,187,-12,175,611,434
05091,091,05,2016,43776,-128,-12,-140,593,532
05091,091,05,2017,43819,-23,-19,-42,590,502
05091,091,05,2018,43431,-381,-21,-402,551,537
05091,091,05,2019,43370,-84,-21,-105,538,493
05091,091,05,2020,43177,-210,-14,-224,524,495
05093,093,05,2010,46350,-150,7,-143,176,167
05093,093,05,2011,45988,-504,18,-486,649,526
05093,093,05,2012,45499,-666,2,-664,686,524
05093,093,05,2013,44642,-987,16,-971,599,506
05093,093,05,2014,44203,-646,5,-641,674,482
05093,093,05,2015,43692,-703,7,-696,677,500
05093,093,05,2016,42863,-984,0,-984,642,492
05093,093,05,2017,42093,-863,4,-859,625,540
05093,093,05,2018,41239,-898,-7,-905,585,538
05093,093,05,2019,40717,-620,6,-614,598,505
05093,093,05,2020,40066,-688,7,-681,563,532
05095,095,05,2010,8138,-39,0,-39,30,9
05095,095,05,2011,8099,-41,-1,-42,107,105
05095,095,05,2012,7856,-225,0,-225,84,110
05095,095,05,2013,7693,-138,0,-138,86,111
05095,095,05,2014,7636,-41,0,-41,100,116
05095,095,05,2015,7454,-155,0,-155,98,126
05095,095,05,2016,7195,-220,0,-220,86,125
05095,095,05,2017,7012,-133,0,-133,88,140
05095,095,05,2018,6880,-120,0,-120,102,114
05095,095,05,2019,6723,-153,0,-153,107,109
05095,095,05,2020,6584,-119,0,-119,104,124
05097,097,05,2010,9515,-2,0,-2,26,8
05097,097,05,2011,9404,-70,-3,-73,94,132
05097,097,05,2012,9344,6,-1,5,67,133
05097,097,05,2013,9254,-68,5,-63,87,114
05097,097,05,2014,9163,-74,13,-61,89,118
05097,097,05,2015,9029,-83,11,-72,85,147
05097,097,05,2016,8947,-42,8,-34,91,138
05097,097,05,2017,8893,14,2,16,82,151
05097,097,05,2018,8927,77,0,77,89,131
05097,097,05,2019,9047,166,-2,164,83,125
05097,097,05,2020,9006,33,0,33,86,160
05099,099,05,2010,8994,-23,0,-23,34,33
05099,099,05,2011,9007,16,0,16,115,117
05099,099,05,2012,8909,-80,0,-80,98,117
05099,099,05,2013,8767,-149,0,-149,136,130
05099,099,05,2014,8642,-83,-2,-85,84,124
05099,099,05,2015,8506,-133,-2,-135,111,113
05099,099,05,2016,8368,-119,-4,-123,102,116
05099,099,05,2017,8300,-36,-3,-39,102,132
05099,099,05,2018,8272,-14,-3,-17,101,111
05099,099,05,2019,8205,-45,-3,-48,75,94
05099,099,05,2020,8099,-67,-3,-70,79,114
05101,101,05,2010,8305,10,0,10,16,36
05101,101,05,2011,8252,-49,0,-49,87,91
05101,101,05,2012,8053,-182,1,-181,69,90
05101,101,05,2013,8045,22,0,22,73,102
05101,101,05,2014,7869,-159,1,-158,74,95
05101,101,05,2015,7848,16,1,17,65,102
05101,101,05,2016,7855,13,0,13,86,92
05101,101,05,2017,7816,-22,-1,-23,81,95
05101,101,05,2018,7780,-8,-1,-9,80,106
05101,101,05,2019,7712,-40,-1,-41,63,88
05101,101,05,2020,7602,-62,0,-62,66,115
05103,103,05,2010,26048,-2,1,-1,54,131
05103,103,05,2011,25738,-278,-1,-279,328,360
05103,103,05,2012,25405,-317,15,-302,312,347
05103,103,05,2013,24957,-373,10,-363,299,388
05103,103,05,2014,24767,-154,9,-145,303,348
05103,103,05,2015,24324,-395,4,-391,287,341
05103,103,05,2016,24021,-240,4,-236,271,338
05103,103,05,2017,23820,-98,2,-96,251,355
05103,103,05,2018,23605,-130,0,-130,260,344
05103,103,05,2019,23372,-174,1,-173,260,320
05103,103,05,2020,23167,-101,1,-100,257,360
05105,105,05,2010,10445,18,0,18,32,48
05105,105,05,2011,10384,-77,2,-75,115,101
05105,105,05,2012,10328,-33,3,-30,102,127
05105,105,05,2013,10334,30,1,31,99,122
05105,105,05,2014,10358,36,1,37,105,119
05105,105,05,2015,10303,-44,2,-42,118,130
05105,105,05,2016,10266,-8,0,-8,108,137
05105,105,05,2017,10332,77,0,77,124,134
05105,105,05,2018,10366,38,0,38,115,118
05105,105,05,2019,10417,84,0,84,89,122
05105,105,05,2020,10327,-41,0,-41,96,143
05107,107,05,2010,21675,-115,1,-114,66,38
05107,107,05,2011,21407,-310,0,-310,318,277
05107,107,05,2012,20736,-682,-2,-684,301,311
05107,107,05,2013,20435,-337,1,-336,298,269
05107,107,05,2014,19952,-540,0,-540,315,272
05107,107,05,2015,19548,-460,0,-460,307,253
05107,107,05,2016,19041,-529,-3,-532,293,271
05107,107,05,2017,18607,-507,-3,-510,324,250
05107,107,05,2018,18038,-558,-3,-561,263,271
05107,107,05,2019,17769,-266,-3,-269,257,257
05107,107,05,2020,17299,-437,-2,-439,247,275
05109,109,05,2010,11263,0,2,2,25,49
05109,109,05,2011,11239,-41,4,-37,133,120
05109,109,05,2012,11251,26,1,27,117,131
05109,109,05,2013,11117,-87,8,-79,109,164
05109,109,05,2014,10988,-80,3,-77,106,156
05109,109,05,2015,10834,-119,4,-115,112,152
05109,109,05,2016,10836,-11,4,-7,129,118
05109,109,05,2017,10731,-90,3,-87,103,120
05109,109,05,2018,10657,-24,0,-24,104,154
05109,109,05,2019,10705,77,8,85,104,141
05109,109,05,2020,10643,-27,8,-19,104,148
05111,111,05,2010,24510,-21,5,-16,59,100
05111,111,05,2011,24445,-72,36,-36,304,332
05111,111,05,2012,24294,-164,25,-139,312,323
05111,111,05,2013,24184,-63,16,-47,295,356
05111,111,05,2014,24151,-49,8,-41,310,300
05111,111,05,2015,24004,-89,1,-88,307,365
05111,111,05,2016,23993,-13,-1,-14,343,338
05111,111,05,2017,24082,128,0,128,323,360
05111,111,05,2018,23877,-170,0,-170,312,348
05111,111,05,2019,23502,-328,2,-326,285,332
05111,111,05,2020,23283,-139,2,-137,278,362
05113,113,05,2010,20669,6,1,7,54,44
05113,113,05,2011,20560,-64,5,-59,219,267
05113,113,05,2012,20421,-147,7,-140,242,244
05113,113,05,2013,20344,-33,8,-25,244,292
05113,113,05,2014,20257,-83,14,-69,238,254
05113,113,05,2015,20205,-14,13,-1,255,304
05113,113,05,2016,20164,-23,7,-16,239,263
05113,113,05,2017,20163,27,1,28,236,263
05113,113,05,2018,20019,-89,-1,-90,214,269
05113,113,05,2019,19944,31,-1,30,188,293
05113,113,05,2020,19707,-113,1,-112,192,316
05115,115,05,2010,62110,228,17,245,200,112
05115,115,05,2011,62694,286,51,337,796,550
05115,115,05,2012,62653,-278,67,-211,748,578
05115,115,05,2013,62612,-185,55,-130,729,631
05115,115,05,2014,63145,214,73,287,814,561
05115,115,05,2015,63642,141,99,240,841,575
05115,115,05,2016,63916,-38,63,25,827,576
05115,115,05,2017,63657,-487,32,-455,809,613
05115,115,05,2018,63577,-212,5,-207,792,666
05115,115,05,2019,64145,375,11,386,770,588
05115,115,05,2020,64334,39,16,55,767,636
05117,117,05,2010,8726,-13,0,-13,32,14
05117,117,05,2011,8604,-101,0,-101,85,105
05117,117,05,2012,8488,-98,0,-98,86,106
05117,117,05,2013,8381,-100,0,-100,89,99
05117,117,05,2014,8355,-11,0,-11,104,117
05117,117,05,2015,8311,-26,0,-26,88,105
05117,117,05,2016,8267,-4,-1,-5,81,119
05117,117,05,2017,8263,14,-1,13,86,102
05117,117,05,2018,8100,-135,-1,-136,91,119
05117,117,05,2019,8093,21,-1,20,85,111
05117,117,05,2020,7966,-83,0,-83,86,130
05119,119,05,2010,383569,63,197,260,1416,836
05119,119,05,2011,387081,369,755,1124,5751,3358
05119,119,05,2012,389392,-814,975,161,5607,3374
05119,119,05,2013,391745,-236,738,502,5633,3732
05119,119,05,2014,393210,-1529,883,-646,5628,3451
05119,119,05,2015,393857,-2233,894,-1339,5640,3629
05119,119,05,2016,394322,-2002,740,-1262,5326,3589
05119,119,05,2017,393585,-2653,460,-2193,5226,3761
05119,119,05,2018,392184,-2945,149,-2796,5229,3834
05119,119,05,2019,392318,-1508,357,-1151,5123,3840
05119,119,05,2020,392980,-578,309,-269,5010,4104
05121,121,05,2010,17955,5,3,8,55,77
05121,121,05,2011,17972,28,-3,25,224,230
05121,121,05,2012,17840,-101,-7,-108,213,236
05121,121,05,2013,17628,-173,-8,-181,198,229
05121,121,05,2014,17579,-10,-5,-15,198,232
05121,121,05,2015,17447,-82,-2,-84,192,239
05121,121,05,2016,17452,51,7,58,203,255
05121,121,05,2017,17724,228,34,262,248,238
05121,121,05,2018,18085,359,23,382,262,282
05121,121,05,2019,18161,26,24,50,258,233
05121,121,05,2020,18247,73,17,90,269,272
05123,123,05,2010,28131,-126,3,-123,94,91
05123,123,05,2011,27934,-288,23,-265,352,287
05123,123,05,2012,27927,-147,46,-101,366,272
05123,123,05,2013,27442,-538,22,-516,328,306
05123,123,05,2014,27029,-517,25,-492,355,285
05123,123,05,2015,26600,-544,30,-514,356,277
05123,123,05,2016,26306,-408,23,-385,348,259
05123,123,05,2017,25959,-429,23,-406,338,281
05123,123,05,2018,25459,-525,9,-516,304,287
05123,123,05,2019,24977,-522,19,-503,306,285
05123,123,05,2020,24682,-265,17,-248,287,334
05125,125,05,2010,107651,441,17,458,287,249
05125,125,05,2011,109554,1435,69,1504,1299,907
05125,125,05,2012,111454,1345,113,1458,1321,908
05125,125,05,2013,113380,1473,46,1519,1413,1026
05125,125,05,2014,114906,1168,78,1246,1346,1076
05125,125,05,2015,116428,1206,48,1254,1380,1115
05125,125,05,2016,117707,959,39,998,1363,1082
05125,125,05,2017,119578,1711,33,1744,1263,1138
05125,125,05,2018,121147,1461,-1,1460,1321,1212
05125,125,05,2019,122550,1153,52,1205,1352,1149
05125,125,05,2020,123968,1243,40,1283,1339,1201
05127,127,05,2010,11251,35,3,38,35,42
05127,127,05,2011,11241,-25,5,-20,143,131
05127,127,05,2012,11007,-266,-3,-269,149,123
05127,127,05,2013,10908,-79,-3,-82,109,127
05127,127,05,2014,10663,-240,-3,-243,111,117
05127,127,05,2015,10538,-143,-4,-147,132,112
05127,127,05,2016,10318,-205,1,-204,121,136
05127,127,05,2017,10360,73,-1,72,119,148
05127,127,05,2018,10288,-62,-1,-63,117,127
05127,127,05,2019,10217,-83,-1,-84,126,113
05127,127,05,2020,10164,-38,0,-38,114,129
05129,129,05,2010,8182,6,0,6,14,32
05129,129,05,2011,8077,-81,2,-79,77,104
05129,129,05,2012,8005,-32,5,-27,76,119
05129,129,05,2013,7992,15,0,15,81,109
05129,129,05,2014,7926,-18,4,-14,74,125
05129,129,05,2015,7838,-48,3,-45,79,121
05129,129,05,2016,7960,161,5,166,75,118
05129,129,05,2017,7928,0,3,3,87,122
05129,129,05,2018,7898,12,1,13,81,123
05129,129,05,2019,7862,-6,4,-2,68,100
05129,129,05,2020,7842,31,2,33,68,121
05131,131,05,2010,125782,-134,41,-93,418,304
05131,131,05,2011,127067,478,235,713,1761,1187
05131,131,05,2012,127645,-133,202,69,1757,1221
05131,131,05,2013,127266,-827,76,-751,1629,1260
05131,131,05,2014,126852,-945,95,-850,1699,1265
05131,131,05,2015,127511,131,119,250,1679,1255
05131,131,05,2016,127578,-470,108,-362,1723,1291
05131,131,05,2017,127910,-122,11,-111,1735,1287
05131,131,05,2018,127582,-585,-35,-620,1660,1365
05131,131,05,2019,127688,-245,-28,-273,1661,1286
05131,131,05,2020,127590,-324,-11,-335,1615,1383
05133,133,05,2010,17153,28,13,41,73,21
05133,133,05,2011,17219,-97,59,-38,276,171
05133,133,05,2012,17186,-149,-8,-157,284,161
05133,133,05,2013,17358,49,12,61,282,169
05133,133,05,2014,17411,-77,-9,-86,287,148
05133,133,05,2015,17263,-217,-5,-222,236,163
05133,133,05,2016,16959,-385,-25,-410,262,156
05133,133,05,2017,17085,64,-25,39,269,181
05133,133,05,2018,17019,-121,-33,-154,243,156
05133,133,05,2019,16972,-129,-18,-147,239,139
05133,133,05,2020,16702,-323,-12,-335,233,166
05135,135,05,2010,17244,-8,0,-8,39,44
05135,135,05,2011,17264,118,4,122,173,274
05135,135,05,2012,17032,-152,9,-143,180,270
05135,135,05,2013,17041,86,3,89,168,249
05135,135,05,2014,16821,-138,6,-132,161,247
05135,135,05,2015,16811,93,8,101,174,284
05135,135,05,2016,17016,272,2,274,202,271
05135,135,05,2017,17146,230,3,233,174,278
05135,135,05,2018,17222,182,2,184,184,293
05135,135,05,2019,17276,131,3,134,183,262
05135,135,05,2020,17424,223,3,226,176,250
05137,137,05,2010,12391,25,1,26,20,50
05137,137,05,2011,12505,158,-3,155,128,172
05137,137,05,2012,12552,93,-6,87,132,172
05137,137,05,2013,12434,-59,-7,-66,123,174
05137,137,05,2014,12392,20,-8,12,110,162
05137,137,05,2015,12405,57,-3,54,140,179
05137,137,05,2016,12525,171,-1,170,113,163
05137,137,05,2017,12555,87,-1,86,120,176
05137,137,05,2018,12542,19,-1,18,141,171
05137,137,05,2019,12614,129,-1,128,125,180
05137,137,05,2020,12674,111,-1,110,135,184
05139,139,05,2010,41570,-103,6,-97,112,81
05139,139,05,2011,41404,-122,14,-108,526,583
05139,139,05,2012,40868,-593,-11,-604,529,478
05139,139,05,2013,40619,-217,-3,-220,486,514
05139,139,05,2014,40156,-411,-11,-422,524,573
05139,139,05,2015,40112,-71,3,-68,546,519
05139,139,05,2016,39920,-252,8,-244,564,511
05139,139,05,2017,39499,-444,16,-428,523,518
05139,139,05,2018,39130,-252,6,-246,460,584
05139,139,05,2019,38677,-365,10,-355,442,540
05139,139,05,2020,38219,-325,7,-318,434,573
05141,141,05,2010,17306,13,0,13,40,39
05141,141,05,2011,17212,-89,-1,-90,197,201
05141,141,05,2012,17166,-6,-4,-10,189,221
05141,141,05,2013,16988,-81,0,-81,147,239
05141,141,05,2014,16911,-11,3,-8,173,240
05141,141,05,2015,16811,-48,15,-33,157,223
05141,141,05,2016,16682,-70,17,-53,165,240
05141,141,05,2017,16557,-21,16,-5,132,251
05141,141,05,2018,16580,135,10,145,148,269
05141,141,05,2019,16529,6,14,20,143,213
05141,141,05,2020,16541,120,10,130,145,262
05143,143,05,2010,204021,321,179,500,802,327
05143,143,05,2011,208088,1269,913,2182,3200,1323
05143,143,05,2012,211824,1128,696,1824,3317,1415
05143,143,05,2013,216107,2154,292,2446,3235,1437
05143,143,05,2014,220075,1592,547,2139,3211,1418
05143,143,05,2015,224600,2199,682,2881,3150,1528
05143,143,05,2016,228612,1502,868,2370,3202,1567
05143,143,05,2017,232915,2158,612,2770,3161,1644
05143,143,05,2018,236855,1938,383,2321,3241,1637
05143,143,05,2019,239392,589,378,967,3194,1633
05143,143,05,2020,243216,2028,324,2352,3220,1761
05145,145,05,2010,77349,148,13,161,244,135
05145,145,05,2011,78087,505,100,605,936,803
05145,145,05,2012,78659,332,80,412,986,823
05145,145,05,2013,78590,-364,62,-302,1036,807
05145,145,05,2014,78500,-298,66,-232,997,851
05145,145,05,2015,78954,193,40,233,1049,817
05145,145,05,2016,78941,-119,42,-77,897,832
05145,145,05,2017,78944,-115,37,-78,947,864
05145,145,05,2018,78390,-590,3,-587,910,877
05145,145,05,2019,78621,179,12,191,896,856
05145,145,05,2020,78729,111,12,123,880,899
05147,147,05,2010,7248,-7,0,-7,15,24
05147,147,05,2011,7175,-47,0,-47,80,106
05147,147,05,2012,7063,-104,0,-104,87,99
05147,147,05,2013,7029,-21,0,-21,84,96
05147,147,05,2014,6869,-141,0,-141,77,100
05147,147,05,2015,6715,-97,0,-97,52,108
05147,147,05,2016,6616,-73,0,-73,77,104
05147,147,05,2017,6580,-9,0,-9,80,106
05147,147,05,2018,6496,-60,0,-60,80,103
05147,147,05,2019,6431,-79,0,-79,99,86
05147,147,05,2020,6264,-152,0,-152,91,105
05149,149,05,2010,22148,-43,14,-29,78,87
05149,149,05,2011,21965,-346,60,-286,316,214
05149,149,05,2012,21827,-154,6,-148,281,269
05149,149,05,2013,21823,-59,25,-34,297,264
05149,149,05,2014,21771,-82,14,-68,253,235
05149,149,05,2015,21505,-283,16,-267,271,272
05149,149,05,2016,21520,-41,25,-16,297,266
05149,149,05,2017,21544,-20,52,32,273,279
05149,149,05,2018,21506,-99,75,-24,255,268
05149,149,05,2019,21376,-123,2,-121,249,257
05149,149,05,2020,21181,-214,22,-192,250,252
06001,001,06,2010,1512997,-1591,1678,87,4876,2152
06001,001,06,2011,1530893,-1223,9005,7782,19222,9075
06001,001,06,2012,1553729,4028,9063,13091,18978,9204
06001,001,06,2013,1579508,5720,10138,15858,19471,9628
06001,001,06,2014,1607638,6290,11475,17765,19494,9252
06001,001,06,2015,1634326,2857,13960,16817,19494,9604
06001,001,06,2016,1650765,-6168,12664,6496,19582,9566
06001,001,06,2017,1659824,-11720,11302,-418,19497,9971
06001,001,06,2018,1666596,-9958,8351,-1607,18337,9909
06001,001,06,2019,1668412,-11531,5545,-5986,18329,10526
06001,001,06,2020,1662323,-16777,4436,-12341,18186,11948
06003,003,06,2010,1161,-13,0,-13,2,4
06003,003,06,2011,1093,-65,0,-65,5,8
06003,003,06,2012,1111,17,1,18,5,6
06003,003,06,2013,1131,17,2,19,7,7
06003,003,06,2014,1083,-46,1,-45,6,9
06003,003,06,2015,1080,1,2,3,4,12
06003,003,06,2016,1053,-26,2,-24,6,8
06003,003,06,2017,1116,66,2,68,6,10
06003,003,06,2018,1081,-31,1,-30,9,15
06003,003,06,2019,1113,42,0,42,8,17
06003,003,06,2020,1119,8,0,8,10,13
06005,005,06,2010,37883,-219,1,-218,77,84
06005,005,06,2011,37539,-179,13,-166,264,441
06005,005,06,2012,37105,-297,5,-292,278,426
06005,005,06,2013,36624,-345,22,-323,253,419
06005,005,06,2014,36734,218,28,246,288,425
06005,005,06,2015,37039,404,37,441,303,439
06005,005,06,2016,37443,516,29,545,308,450
06005,005,06,2017,38549,1212,27,1239,297,444
06005,005,06,2018,39349,906,17,923,309,437
06005,005,06,2019,39693,468,14,482,309,444
06005,005,06,2020,40083,564,11,575,314,494
06007,007,06,2010,219951,-183,40,-143,623,516
06007,007,06,2011,219983,-301,79,-222,2444,2181
06007,007,06,2012,220877,629,137,766,2401,2247
06007,007,06,2013,221649,556,219,775,2319,2304
06007,007,06,2014,223525,1233,316,1549,2505,2171
06007,007,06,2015,224643,731,257,988,2477,2327
06007,007,06,2016,226222,1316,218,1534,2448,2400
06007,007,06,2017,228700,2336,166,2502,2463,2495
06007,007,06,2018,230330,1650,89,1739,2412,2521
06007,007,06,2019,218726,-11525,32,-11493,2290,2372
06007,007,06,2020,212744,-5850,20,-5830,2236,2371
06009,009,06,2010,45467,-39,3,-36,74,141
06009,009,06,2011,45159,-200,13,-187,333,453
06009,009,06,2012,44816,-252,8,-244,354,451
06009,009,06,2013,44658,13,23,36,325,510
06009,009,06,2014,44677,95,31,126,365,469
06009,009,06,2015,44972,364,41,405,356,467
06009,009,06,2016,45307,464,25,489,366,521
06009,009,06,2017,45658,453,12,465,402,517
06009,009,06,2018,45747,179,6,185,406,500
06009,009,06,2019,46119,501,3,504,391,519
06009,009,06,2020,46308,369,3,372,390,569
06011,011,06,2010,21435,-30,1,-29,69,13
06011,011,06,2011,21315,-250,-32,-282,337,176
06011,011,06,2012,21274,-166,-34,-200,303,144
06011,011,06,2013,21239,-209,-22,-231,317,124
06011,011,06,2014,21156,-240,-14,-254,308,142
06011,011,06,2015,21208,-70,-12,-82,276,140
06011,011,06,2016,21476,116,-5,111,308,150
06011,011,06,2017,21558,-40,-28,-68,318,168
06011,011,06,2018,21389,-229,-46,-275,272,167
06011,011,06,2019,21474,38,-49,-11,262,165
06011,011,06,2020,21558,-8,-35,-43,260,134
06013,013,06,2010,1052516,1568,488,2056,3010,1739
06013,013,06,2011,1065361,4790,3007,7797,12331,7263
06013,013,06,2012,1077439,4560,2705,7265,11940,6988
06013,013,06,2013,1093253,7391,3426,10817,12244,7246
06013,013,06,2014,1108665,6444,4027,10471,12243,7227
06013,013,06,2015,1124148,5429,5125,10554,12569,7568
06013,013,06,2016,1137259,3517,4854,8371,12590,7800
06013,013,06,2017,1145623,-205,4312,4107,12162,7842
06013,013,06,2018,1150840,-1963,3138,1175,12112,8047
06013,013,06,2019,1152883,-3704,1877,-1827,11922,8076
06013,013,06,2020,1152333,-4664,1515,-3149,11771,9228
06015,015,06,2010,28568,-44,2,-42,90,93
06015,015,06,2011,28447,-161,4,-157,334,297
06015,015,06,2012,28195,-317,16,-301,324,283
06015,015,06,2013,27821,-436,-6,-442,332,275
06015,015,06,2014,27182,-700,-1,-701,311,273
06015,015,06,2015,27198,1,9,10,301,291
06015,015,06,2016,27415,165,44,209,316,306
06015,015,06,2017,27383,-15,34,19,278,328
06015,015,06,2018,27793,366,22,388,282,262
06015,015,06,2019,27903,70,17,87,276,254
06015,015,06,2020,27968,87,16,103,267,306
06017,017,06,2010,181161,-12,29,17,380,296
06017,017,06,2011,180963,-607,91,-516,1632,1311
06017,017,06,2012,180613,-642,115,-527,1598,1423
06017,017,06,2013,181529,650,126,776,1498,1327
06017,017,06,2014,183157,1317,116,1433,1611,1398
06017,017,06,2015,184627,1228,201,1429,1611,1557
06017,017,06,2016,186027,1206,207,1413,1553,1556
06017,017,06,2017,188793,2548,161,2709,1638,1577
06017,017,06,2018,190925,1980,102,2082,1619,1560
06017,017,06,2019,193057,2086,44,2130,1584,1571
06017,017,06,2020,192925,67,41,108,1608,1846
06019,019,06,2010,932011,-864,75,-789,3897,1590
06019,019,06,2011,939251,-3530,454,-3076,16320,5995
06019,019,06,2012,944779,-4649,512,-4137,15946,6268
06019,019,06,2013,951143,-3715,916,-2799,15731,6523
06019,019,06,2014,960072,-1729,1273,-456,15854,6322
06019,019,06,2015,968889,-1924,1778,-146,15657,6601
06019,019,06,2016,976231,-3203,1925,-1278,15205,6569
06019,019,06,2017,984726,-440,1237,797,14794,7060
06019,019,06,2018,991298,-1145,506,-639,14408,7192
06019,019,06,2019,997847,-506,-59,-565,14441,7368
06019,019,06,2020,1000918,-3336,41,-3295,14251,7941
06021,021,06,2010,28125,-72,-4,-76,108,29
06021,021,06,2011,28131,-158,-24,-182,424,236
06021,021,06,2012,27836,-411,-26,-437,372,241
06021,021,06,2013,27784,-203,-26,-229,385,212
06021,021,06,2014,27802,-91,-28,-119,408,270
06021,021,06,2015,27723,-196,-11,-207,394,267
06021,021,06,2016,27796,-26,-15,-41,379,262
06021,021,06,2017,27876,-21,-24,-45,382,255
06021,021,06,2018,27899,-30,-30,-60,367,283
06021,021,06,2019,28445,467,-46,421,383,257
06021,021,06,2020,28283,-273,-25,-298,385,249
06023,023,06,2010,135010,253,20,273,384,287
06023,023,06,2011,135257,-185,72,-113,1549,1187
06023,023,06,2012,134597,-867,59,-808,1439,1289
06023,023,06,2013,134447,-433,52,-381,1539,1292
06023,023,06,2014,134556,-20,19,-1,1484,1347
06023,023,06,2015,135177,435,46,481,1445,1295
06023,023,06,2016,136477,1028,68,1096,1522,1320
06023,023,06,2017,136710,138,59,197,1424,1387
06023,023,06,2018,136502,-240,35,-205,1333,1328
06023,023,06,2019,135839,-635,8,-627,1407,1442
06023,023,06,2020,134977,-725,13,-712,1370,1523
06025,025,06,2010,174704,-267,-73,-340,688,181
06025,025,06,2011,175731,-1000,-124,-1124,3128,978
06025,025,06,2012,176487,-1241,-80,-1321,3015,955
06025,025,06,2013,176301,-2470,169,-2301,3012,969
06025,025,06,2014,177786,-959,300,-659,3166,1023
06025,025,06,2015,178701,-1872,516,-1356,3290,1031
06025,025,06,2016,179881,-1525,700,-825,3128,1124
06025,025,06,2017,181250,-771,207,-564,2960,1022
06025,025,06,2018,181062,-1787,-38,-1825,2743,1117
06025,025,06,2019,180439,-2003,-131,-2134,2604,1096
06025,025,06,2020,180267,-1522,-75,-1597,2541,1120
06027,027,06,2010,18503,-34,-2,-36,40,35
06027,027,06,2011,18385,-113,3,-110,191,199
06027,027,06,2012,18344,-68,6,-62,228,203
06027,027,06,2013,18348,-20,10,-10,211,198
06027,027,06,2014,18280,-104,8,-96,238,207
06027,027,06,2015,18097,-209,20,-189,196,191
06027,027,06,2016,17897,-210,4,-206,199,194
06027,027,06,2017,17819,-21,9,-12,196,261
06027,027,06,2018,17894,79,8,87,186,197
06027,027,06,2019,17993,70,4,74,189,164
06027,027,06,2020,18046,61,4,65,181,192
06029,029,06,2010,841365,-487,142,-345,3485,1368
06029,029,06,2011,848651,-2234,534,-1700,14406,5404
06029,029,06,2012,854392,-3993,701,-3292,14210,5235
06029,029,06,2013,862727,-1406,1046,-360,14416,5651
06029,029,06,2014,869837,-2190,971,-1219,14090,5638
06029,029,06,2015,876548,-2584,1197,-1387,14080,5915
06029,029,06,2016,881094,-4617,1162,-3455,13817,5814
06029,029,06,2017,887316,-1669,466,-1203,13544,6105
06029,029,06,2018,893618,-175,-143,-318,12930,6298
06029,029,06,2019,898898,-723,-496,-1219,13010,6544
06029,029,06,2020,901362,-3122,-316,-3438,12826,6980
06031,031,06,2010,152342,-1159,53,-1106,570,215
06031,031,06,2011,151779,-2377,-27,-2404,2577,752
06031,031,06,2012,150884,-2815,263,-2552,2395,815
06031,031,06,2013,150237,-2495,121,-2374,2465,802
06031,031,06,2014,149373,-2551,128,-2423,2301,813
06031,031,06,2015,149960,-1198,225,-973,2357,801
06031,031,06,2016,149269,-2304,140,-2164,2251,788
06031,031,06,2017,149542,-1196,-7,-1203,2308,841
06031,031,06,2018,151221,471,-158,313,2301,938
06031,031,06,2019,152727,260,-129,131,2209,843
06031,031,06,2020,152692,-1143,-94,-1237,2184,986
06033,033,06,2010,64736,80,-2,78,162,167
06033,033,06,2011,64258,-391,-27,-418,740,799
06033,033,06,2012,63966,-131,-25,-156,727,854
06033,033,06,2013,63811,-38,-18,-56,743,829
06033,033,06,2014,64056,328,-18,310,768,828
06033,033,06,2015,64266,351,-3,348,710,844
06033,033,06,2016,63912,-234,22,-212,724,862
06033,033,06,2017,64132,388,-11,377,776,932
06033,033,06,2018,64394,382,-28,354,755,846
06033,033,06,2019,64463,263,-33,230,716,873
06033,033,06,2020,64479,226,-23,203,732,917
06035,035,06,2010,34828,-60,2,-58,84,92
06035,035,06,2011,34235,-722,25,-697,297,199
06035,035,06,2012,33622,-690,18,-672,303,270
06035,035,06,2013,32128,-1626,8,-1618,286,225
06035,035,06,2014,31664,-582,15,-567,322,228
06035,035,06,2015,31256,-500,11,-489,301,229
06035,035,06,2016,30715,-585,6,-579,297,263
06035,035,06,2017,30919,112,9,121,316,233
06035,035,06,2018,30658,-381,8,-373,299,192
06035,035,06,2019,30694,-107,6,-101,299,163
06035,035,06,2020,30016,-761,2,-759,291,208
06037,037,06,2010,9821647,-21698,6283,-15415,31736,13806
06037,037,06,2011,9873700,-54778,32340,-22438,132633,58180
06037,037,06,2012,9931394,-38795,26618,-12177,129153,57984
06037,037,06,2013,9987189,-45695,31818,-13877,130664,60080
06037,037,06,2014,10033449,-59714,35319,-24395,129435,58126
06037,037,06,2015,10077263,-65200,41539,-23661,128536,60652
06037,037,06,2016,10094865,-78923,36989,-41934,122688,63172
06037,037,06,2017,10092365,-91033,30417,-60616,121087,62990
06037,037,06,2018,10061533,-99487,19529,-79958,113480,64454
06037,037,06,2019,10011602,-101328,8911,-92417,108800,66321
06037,037,06,2020,9943046,-110428,7573,-102855,107789,73513
06039,039,06,2010,151006,-39,-35,-74,578,325
06039,039,06,2011,151685,-659,-87,-746,2436,1008
06039,039,06,2012,151520,-1457,-80,-1537,2377,1049
06039,039,06,2013,151295,-1530,43,-1487,2288,1048
06039,039,06,2014,153357,887,-61,826,2262,1046
06039,039,06,2015,153448,-1157,2,-1155,2295,1051
06039,039,06,2016,153694,-893,-55,-948,2280,1086
06039,039,06,2017,155079,479,-149,330,2186,1125
06039,039,06,2018,156373,465,-206,259,2155,1116
06039,039,06,2019,156717,-386,-250,-636,2064,1086
06039,039,06,2020,157761,360,-184,176,2042,1178
06041,041,06,2010,252906,225,164,389,590,474
06041,041,06,2011,255380,1243,679,1922,2386,1830
06041,041,06,2012,256087,-361,641,280,2326,1877
06041,041,06,2013,258441,1296,634,1930,2325,1890
06041,041,06,2014,260403,847,600,1447,2431,1876
06041,041,06,2015,260974,-500,751,251,2302,1957
06041,041,06,2016,260722,-1379,741,-638,2294,1901
06041,041,06,2017,259975,-1700,692,-1008,2225,1959
06041,041,06,2018,260091,-586,519,-67,2192,1997
06041,041,06,2019,259085,-1476,321,-1155,2097,1945
06041,041,06,2020,257332,-1892,255,-1637,2065,2183
06043,043,06,2010,18302,20,2,22,31,22
06043,043,06,2011,18199,-100,4,-96,148,155
06043,043,06,2012,17912,-291,10,-281,141,156
06043,043,06,2013,17840,-19,19,0,136,204
06043,043,06,2014,17745,-78,14,-64,157,185
06043,043,06,2015,17653,-63,14,-49,145,186
06043,043,06,2016,17498,-143,24,-119,157,193
06043,043,06,2017,17461,17,15,32,146,215
06043,043,06,2018,17361,-30,9,-21,141,218
06043,043,06,2019,17117,-207,6,-201,143,185
06043,043,06,2020,17160,87,7,94,136,185
06045,045,06,2010,87796,-194,11,-183,303,178
06045,045,06,2011,87335,-652,17,-635,1011,838
06045,045,06,2012,87293,-311,-30,-341,1123,812
06045,045,06,2013,87070,-443,14,-429,1063,849
06045,045,06,2014,87247,-18,4,-14,1057,845
06045,045,06,2015,87131,-272,0,-272,1022,854
06045,045,06,2016,87319,39,50,89,1005,902
06045,045,06,2017,87690,157,22,179,1035,838
06045,045,06,2018,87549,-187,-13,-200,946,881
06045,045,06,2019,86932,-651,-38,-689,924,849
06045,045,06,2020,86061,-756,-24,-780,890,979
06047,047,06,2010,256709,268,8,276,1068,432
06047,047,06,2011,259249,-340,39,-301,4303,1454
06047,047,06,2012,260776,-1126,-79,-1205,4302,1563
06047,047,06,2013,261888,-1513,34,-1479,4190,1615
06047,047,06,2014,264241,-281,75,-206,4211,1610
06047,047,06,2015,266133,-704,179,-525,4105,1676
06047,047,06,2016,267370,-1316,253,-1063,4089,1793
06047,047,06,2017,270837,1016,-11,1005,4307,1832
06047,047,06,2018,273733,1014,-201,813,3867,1782
06047,047,06,2019,277114,1546,-299,1247,3940,1808
06047,047,06,2020,279252,392,-205,187,3855,1922
06049,049,06,2010,9698,4,0,4,26,17
06049,049,06,2011,9513,-192,8,-184,98,100
06049,049,06,2012,9358,-115,8,-107,74,124
06049,049,06,2013,9154,-188,12,-176,81,113
06049,049,06,2014,9078,-51,12,-39,74,111
06049,049,06,2015,9064,6,10,16,93,122
06049,049,06,2016,8957,-80,-1,-81,87,113
06049,049,06,2017,8864,-72,-1,-73,84,103
06049,049,06,2018,8816,-55,-4,-59,90,78
06049,049,06,2019,8866,59,-4,55,74,77
06049,049,06,2020,8763,-64,-2,-66,68,104
06051,051,06,2010,14256,31,3,34,31,20
06051,051,06,2011,14424,44,7,51,155,38
06051,051,06,2012,14328,-216,19,-197,146,49
06051,051,06,2013,14064,-389,33,-356,136,52
06051,051,06,2014,14130,-77,38,-39,157,51
06051,051,06,2015,14074,-278,108,-170,157,46
06051,051,06,2016,14256,19,84,103,137,57
06051,051,06,2017,14333,-76,77,1,140,62
06051,051,06,2018,14400,-93,57,-36,135,32
06051,051,06,2019,14450,-73,39,-34,119,35
06051,051,06,2020,14534,-29,33,4,119,42
06053,053,06,2010,416358,93,71,164,1673,517
06053,053,06,2011,420379,-515,8,-507,6861,2323
06053,053,06,2012,424222,-808,292,-516,6808,2377
06053,053,06,2013,426163,-2518,345,-2173,6563,2462
06053,053,06,2014,427985,-2806,534,-2272,6460,2375
06053,053,06,2015,430178,-2651,890,-1761,6454,2488
06053,053,06,2016,433436,-1439,980,-459,6346,2610
06053,053,06,2017,433803,-3371,275,-3096,6016,2557
06053,053,06,2018,433359,-3406,-252,-3658,5823,2614
06053,053,06,2019,433380,-2736,-412,-3148,5904,2736
06053,053,06,2020,430906,-5111,-260,-5371,5799,2892
06055,055,06,2010,136752,128,39,167,386,321
06055,055,06,2011,137668,390,189,579,1502,1160
06055,055,06,2012,138504,273,190,463,1528,1129
06055,055,06,2013,139522,708,154,862,1412,1245
06055,055,06,2014,140331,370,148,518,1481,1166
06055,055,06,2015,140766,49,160,209,1466,1222
06055,055,06,2016,140778,-383,166,-217,1459,1224
06055,055,06,2017,139818,-1059,97,-962,1299,1298
06055,055,06,2018,138620,-1206,23,-1183,1269,1285
06055,055,06,2019,137678,-949,-71,-1020,1253,1174
06055,055,06,2020,135965,-1490,-29,-1519,1226,1415
06057,057,06,2010,98795,25,10,35,217,190
06057,057,06,2011,98716,92,10,102,770,944
06057,057,06,2012,98165,-373,15,-358,773,953
06057,057,06,2013,97969,22,4,26,804,1008
06057,057,06,2014,98605,709,30,739,863,965
06057,057,06,2015,98716,288,32,320,828,1024
06057,057,06,2016,98939,373,30,403,810,985
06057,057,06,2017,99421,718,16,734,797,1045
06057,057,06,2018,99472,323,6,329,789,1059
06057,057,06,2019,99648,400,-10,390,801,1010
06057,057,06,2020,99606,239,-4,235,790,1065
06059,059,06,2010,3016376,151,1322,1473,9305,4312
06059,059,06,2011,3050199,5419,7924,13343,38240,17667
06059,059,06,2012,3078710,2111,7106,9217,37846,17808
06059,059,06,2013,3105262,-1114,9349,8235,37619,18779
06059,059,06,2014,3126523,-8638,10878,2240,37893,18398
06059,059,06,2015,3148952,-9578,12679,3101,38565,18977
06059,059,06,2016,3164277,-14058,11759,-2299,37300,19608
06059,059,06,2017,3174159,-18046,9531,-8515,38261,19823
06059,059,06,2018,3175579,-20664,5959,-14705,36521,20433
06059,059,06,2019,3170851,-21909,2765,-19144,35514,21161
06059,059,06,2020,3166857,-18375,2336,-16039,35163,23233
06061,061,06,2010,350007,1108,131,1239,953,711
06061,061,06,2011,356323,4902,333,5235,3853,2788
06061,061,06,2012,360269,2791,241,3032,3694,2762
06061,061,06,2013,365415,3968,302,4270,3691,2835
06061,061,06,2014,369241,2647,419,3066,3725,2933
06061,061,06,2015,372870,2657,432,3089,3649,3077
06061,061,06,2016,379046,5243,430,5673,3722,3216
06061,061,06,2017,385348,5499,344,5843,3780,3311
06061,061,06,2018,392735,6942,160,7102,3632,3337
06061,061,06,2019,398918,5850,45,5895,3678,3363
06061,061,06,2020,402950,4017,51,4068,3678,3692
06063,063,06,2010,19915,-49,2,-47,42,87
06063,063,06,2011,19720,-148,8,-140,169,224
06063,063,06,2012,19380,-308,10,-298,156,205
06063,063,06,2013,18901,-364,-2,-366,148,264
06063,063,06,2014,18631,-199,1,-198,160,234
06063,063,06,2015,18435,-108,3,-105,148,236
06063,063,06,2016,18691,295,12,307,173,223
06063,063,06,2017,18680,13,6,19,180,210
06063,063,06,2018,18830,179,3,182,157,189
06063,063,06,2019,19052,232,1,233,153,163
06063,063,06,2020,18967,-27,1,-26,154,212
06065,065,06,2010,2201562,7485,-26,7459,7219,3374
06065,065,06,2011,2233840,14839,888,15727,31003,14460
06065,065,06,2012,2260763,10891,723,11614,30105,14592
06065,065,06,2013,2286087,9149,1535,10684,29935,14986
06065,065,06,2014,2315238,12007,2002,14009,30349,14963
06065,065,06,2015,2344648,11844,2956,14800,30534,15760
06065,065,06,2016,2378282,16973,2565,19538,30316,16179
06065,065,06,2017,2413058,19476,1261,20737,30488,16410
06065,065,06,2018,2443221,18378,-82,18296,29252,17364
06065,065,06,2019,2465569,13014,-1216,11798,28596,18058
06065,065,06,2020,2489188,15656,-781,14875,28383,19696
06067,067,06,2010,1421381,-409,654,245,5027,2490
06067,067,06,2011,1433712,-1276,3672,2396,20192,10206
06067,067,06,2012,1444819,-941,3301,2360,19530,10482
06067,067,06,2013,1457283,-464,4195,3731,19406,10432
06067,067,06,2014,1474828,4040,4777,8817,19653,10741
06067,067,06,2015,1493547,4479,5686,10165,19776,11121
06067,067,06,2016,1511401,3977,5471,9448,19688,11240
06067,067,06,2017,1527984,4155,4850,9005,19206,11609
06067,067,06,2018,1539550,984,3375,4359,19192,11969
06067,067,06,2019,1551660,3340,1959,5299,19154,12402
06067,067,06,2020,1559146,39,1599,1638,19084,13340
06069,069,06,2010,55544,125,-9,116,189,34
06069,069,06,2011,56094,91,-33,58,763,269
06069,069,06,2012,56704,221,-39,182,715,277
06069,069,06,2013,57320,258,-50,208,737,325
06069,069,06,2014,57891,203,-36,167,725,313
06069,069,06,2015,58276,-30,0,-30,718,295
06069,069,06,2016,59270,562,9,571,757,335
06069,069,06,2017,60190,574,-42,532,760,374
06069,069,06,2018,61415,900,-61,839,735,349
06069,069,06,2019,62803,1008,-80,928,799,337
06069,069,06,2020,64055,878,-48,830,808,383
06071,071,06,2010,2040803,1168,176,1344,7466,3057
06071,071,06,2011,2060596,15,599,614,31439,12202
06071,071,06,2012,2073088,-6831,1397,-5434,30165,12092
06071,071,06,2013,2082101,-10233,1387,-8846,30564,12715
06071,071,06,2014,2098346,-2871,1673,-1198,30678,12893
06071,071,06,2015,2114352,-4501,2654,-1847,31277,13265
06071,071,06,2016,2130726,-2752,2379,-373,30680,13876
06071,071,06,2017,2149847,1678,1215,2893,30511,14192
06071,071,06,2018,2165627,1168,-24,1144,29325,14632
06071,071,06,2019,2177279,-1210,-882,-2092,29007,15347
06071,071,06,2020,2189183,-1,-556,-557,28808,16533
06073,073,06,2010,3103260,-204,2377,2173,10719,4679
06073,073,06,2011,3137236,180,8863,9043,44686,19667
06073,073,06,2012,3175148,441,14054,14495,43831,19877
06073,073,06,2013,3210788,-504,13571,13067,43743,20732
06073,073,06,2014,3249307,547,14072,14619,44247,19878
06073,073,06,2015,3280825,-8727,16772,8045,44442,20555
06073,073,06,2016,3305462,-10940,13468,2528,43311,21046
06073,073,06,2017,3319019,-16292,9188,-7104,42315,21531
06073,073,06,2018,3332483,-9636,4645,-4991,40513,21906
06073,073,06,2019,3330459,-21362,2756,-18606,39369,22814
06073,073,06,2020,3332427,-14678,2458,-12220,39080,25040
06075,075,06,2010,805519,-1649,1176,-473,2118,1277
06075,075,06,2011,815694,774,6222,6996,8899,5761
06075,075,06,2012,828963,3631,6154,9785,8782,5543
06075,075,06,2013,839695,665,6659,7324,9096,5761
06075,075,06,2014,850918,753,6895,7648,8950,5472
06075,075,06,2015,863237,1367,7437,8804,9103,5646
06075,075,06,2016,871343,-1361,6164,4803,8995,5694
06075,075,06,2017,877471,-2664,5572,2908,9010,5751
06075,075,06,2018,879676,-4612,4162,-450,8673,5960
06075,075,06,2019,878826,-6162,2684,-3478,8707,6058
06075,075,06,2020,866606,-15926,2118,-13808,8547,6898
06077,077,06,2010,687115,328,101,429,2549,1098
06077,077,06,2011,694265,673,711,1384,10549,4756
06077,077,06,2012,699444,-390,563,173,10082,4982
06077,077,06,2013,701831,-3708,997,-2711,10052,4985
06077,077,06,2014,711296,3609,1121,4730,9922,5114
06077,077,06,2015,721919,4287,1777,6064,9978,5377
06077,077,06,2016,732662,3978,2006,5984,10156,5371
06077,077,06,2017,743286,4644,1470,6114,10127,5590
06077,077,06,2018,752590,4258,793,5051,9914,5649
06077,077,06,2019,761571,4694,292,4986,9941,5955
06077,077,06,2020,767967,2473,269,2742,9957,6339
06079,079,06,2010,269800,64,-12,52,700,519
06079,079,06,2011,271056,839,34,873,2645,2256
06079,079,06,2012,274174,2644,61,2705,2629,2265
06079,079,06,2013,275713,1034,168,1202,2631,2258
06079,079,06,2014,278271,1934,226,2160,2632,2240
06079,079,06,2015,280138,1372,226,1598,2599,2308
06079,079,06,2016,281884,1250,172,1422,2689,2357
06079,079,06,2017,282473,544,50,594,2525,2519
06079,079,06,2018,283250,783,-38,745,2502,2466
06079,079,06,2019,282728,-372,-104,-476,2449,2500
06079,079,06,2020,282249,-222,-50,-272,2423,2641
06081,081,06,2010,719948,-301,647,346,2286,1115
06081,081,06,2011,728945,936,3484,4420,9140,4550
06081,081,06,2012,739700,2833,3541,6374,9011,4660
06081,081,06,2013,749131,831,4264,5095,9068,4716
06081,081,06,2014,757653,-673,4849,4176,8948,4516
06081,081,06,2015,765479,-2240,5733,3493,9168,4766
06081,081,06,2016,767928,-6878,4999,-1879,9005,4657
06081,081,06,2017,768658,-7585,4459,-3126,8739,4858
06081,081,06,2018,768410,-7117,3292,-3825,8413,4819
06081,081,06,2019,764810,-9099,2142,-6957,8328,4947
06081,081,06,2020,758308,-10815,1677,-9138,8226,5556
06083,083,06,2010,424218,-635,147,-488,1510,760
06083,083,06,2011,425404,-2373,668,-1705,5751,2863
06083,083,06,2012,429635,668,845,1513,5641,2858
06083,083,06,2013,434503,1170,1016,2186,5703,2984
06083,083,06,2014,438921,534,1183,1717,5763,2977
06083,083,06,2015,442051,-1166,1533,367,5809,3008
06083,083,06,2016,444112,-1827,1428,-399,5595,3126
06083,083,06,2017,444998,-2277,897,-1380,5511,3233
06083,083,06,2018,445137,-2327,413,-1914,5338,3286
06083,083,06,2019,445464,-2054,140,-1914,5483,3248
06083,083,06,2020,444766,-2710,162,-2548,5390,3550
06085,085,06,2010,1786001,-2009,2663,654,5868,2170
06085,085,06,2011,1811891,-2974,14050,11076,24023,9159
06085,085,06,2012,1837605,-1556,13528,11972,23420,9307
06085,085,06,2013,1866050,-2163,16181,14018,24179,9439
06085,085,06,2014,1891286,-7622,19198,11576,23414,9432
06085,085,06,2015,1915736,-11261,22035,10774,23691,9894
06085,085,06,2016,1928144,-21023,20226,-797,23285,10108
06085,085,06,2017,1932251,-26266,17978,-8288,22550,10221
06085,085,06,2018,1931985,-25110,13244,-11866,21795,10218
06085,085,06,2019,1922411,-28716,8703,-20013,21198,10728
06085,085,06,2020,1907105,-31149,6959,-24190,21070,12110
06087,087,06,2010,263174,438,-8,430,809,442
06087,087,06,2011,264927,127,88,215,3244,1700
06087,087,06,2012,266391,13,13,26,3166,1673
06087,087,06,2013,268836,953,241,1194,2981,1725
06087,087,06,2014,270863,601,294,895,2895,1731
06087,087,06,2015,273495,996,376,1372,2983,1719
06087,087,06,2016,274476,-562,388,-174,2893,1726
06087,087,06,2017,274865,-710,229,-481,2665,1783
06087,087,06,2018,273713,-1998,75,-1923,2549,1780
06087,087,06,2019,272870,-1449,-67,-1516,2451,1782
06087,087,06,2020,269925,-3219,-26,-3245,2402,2096
06089,089,06,2010,177277,-22,36,14,532,465
06089,089,06,2011,177613,129,157,286,2107,2048
06089,089,06,2012,177908,152,135,287,2057,2008
06089,089,06,2013,178447,308,227,535,2108,2070
06089,089,06,2014,178904,299,213,512,2145,2159
06089,089,06,2015,178386,-649,331,-318,2096,2282
06089,089,06,2016,178592,133,268,401,2032,2213
06089,089,06,2017,179403,985,233,1218,2004,2400
06089,089,06,2018,179666,356,188,544,2007,2283
06089,089,06,2019,179645,263,118,381,1954,2351
06089,089,06,2020,179027,-265,102,-163,1918,2381
06091,091,06,2010,3220,-5,0,-5,7,20
06091,091,06,2011,3100,-104,1,-103,18,35
06091,091,06,2012,3068,-24,1,-23,21,31
06091,091,06,2013,3031,-20,-1,-21,21,38
06091,091,06,2014,2976,-32,0,-32,17,41
06091,091,06,2015,2990,27,0,27,23,36
06091,091,06,2016,2956,-31,0,-31,30,32
06091,091,06,2017,3008,50,-1,49,35,32
06091,091,06,2018,2961,-36,-1,-37,28,38
06091,091,06,2019,2959,2,-1,1,21,23
06091,091,06,2020,2920,-17,0,-17,18,40
06093,093,06,2010,44941,51,6,57,93,108
06093,093,06,2011,44622,-258,15,-243,466,540
06093,093,06,2012,44091,-524,15,-509,498,530
06093,093,06,2013,43550,-434,12,-422,454,578
06093,093,06,2014,43357,-150,18,-132,461,513
06093,093,06,2015,43275,48,21,69,439,584
06093,093,06,2016,43402,264,15,279,468,617
06093,093,06,2017,43647,417,11,428,453,636
06093,093,06,2018,43624,38,6,44,440,504
06093,093,06,2019,43663,170,0,170,398,527
06093,093,06,2020,43245,-198,5,-193,383,607
06095,095,06,2010,413963,-82,204,122,1190,643
06095,095,06,2011,416325,-674,748,74,5171,2874
06095,095,06,2012,419645,126,1146,1272,5066,2920
06095,095,06,2013,423634,917,955,1872,5144,2961
06095,095,06,2014,428971,2253,885,3138,5255,3035
06095,095,06,2015,433378,1409,931,2340,5282,3173
06095,095,06,2016,438834,2690,818,3508,5175,3224
06095,095,06,2017,443554,2298,592,2890,5206,3377
06095,095,06,2018,445931,550,268,818,5103,3534
06095,095,06,2019,447434,59,88,147,5022,3680
06095,095,06,2020,446935,-1690,102,-1588,5023,3953
06097,097,06,2010,484675,312,62,374,1421,953
06097,097,06,2011,487231,1049,83,1132,5310,3869
06097,097,06,2012,489784,1314,123,1437,5043,3853
06097,097,06,2013,493870,2568,385,2953,5066,3911
06097,097,06,2014,498317,2846,605,3451,4996,3995
06097,097,06,2015,500598,689,627,1316,5066,4034
06097,097,06,2016,502445,146,705,851,5143,4116
06097,097,06,2017,502203,-1070,363,-707,4779,4285
06097,097,06,2018,497221,-5398,83,-5315,4512,4187
06097,097,06,2019,492318,-5053,-112,-5165,4465,4200
06097,097,06,2020,489819,-2058,-53,-2111,4353,4751
06099,099,06,2010,515137,-416,108,-308,1922,909
06099,099,06,2011,517515,-2282,544,-1738,7788,3672
06099,099,06,2012,520336,-1287,256,-1031,7696,3811
06099,099,06,2013,523313,-1192,544,-648,7505,3854
06099,099,06,2014,527814,502,527,1029,7496,3929
06099,099,06,2015,532954,882,761,1643,7673,4118
06099,099,06,2016,538986,1718,854,2572,7766,4272
06099,099,06,2017,544494,1650,518,2168,7764,4391
06099,099,06,2018,547855,234,156,390,7355,4368
06099,099,06,2019,549761,-861,-116,-977,7393,4529
06099,099,06,2020,550081,-2313,-58,-2371,7335,4676
06101,101,06,2010,94742,-199,76,-123,325,220
06101,101,06,2011,94466,-1160,275,-885,1336,732
06101,101,06,2012,94153,-1206,265,-941,1320,728
06101,101,06,2013,94457,-395,209,-186,1227,736
06101,101,06,2014,94721,-565,260,-305,1295,733
06101,101,06,2015,95224,-289,289,0,1307,796
06101,101,06,2016,95769,-312,269,-43,1407,818
06101,101,06,2017,96161,-195,188,-7,1267,864
06101,101,06,2018,96348,-373,79,-294,1322,838
06101,101,06,2019,96910,197,23,220,1206,866
06101,101,06,2020,96385,-898,31,-867,1244,899
06103,103,06,2010,63562,94,13,107,182,165
06103,103,06,2011,63337,-363,25,-338,732,618
06103,103,06,2012,63213,-217,-16,-233,722,604
06103,103,06,2013,62878,-355,-16,-371,730,691
06103,103,06,2014,62797,-220,-27,-247,806,634
06103,103,06,2015,63150,179,-25,154,818,612
06103,103,06,2016,63468,124,-20,104,840,621
06103,103,06,2017,63827,285,-28,257,728,622
06103,103,06,2018,63904,93,-38,55,716,689
06103,103,06,2019,65186,1263,-48,1215,782,712
06103,103,06,2020,64494,-691,-30,-721,765,735
06105,105,06,2010,13755,-7,0,-7,36,53
06105,105,06,2011,13685,-20,0,-20,111,161
06105,105,06,2012,13494,-159,0,-159,116,146
06105,105,06,2013,13427,-21,-2,-23,115,157
06105,105,06,2014,13126,-249,-2,-251,110,164
06105,105,06,2015,13094,21,-2,19,101,153
06105,105,06,2016,12827,-189,0,-189,104,182
06105,105,06,2017,12727,-67,1,-66,123,156
06105,105,06,2018,12598,-108,2,-106,115,137
06105,105,06,2019,12337,-190,1,-189,102,172
06105,105,06,2020,12216,-40,3,-37,96,180
06107,107,06,2010,442953,-302,-121,-423,1855,648
06107,107,06,2011,446709,-1119,-417,-1536,8150,2849
06107,107,06,2012,449625,-1862,-417,-2279,8021,2810
06107,107,06,2013,452259,-2134,-159,-2293,7767,2828
06107,107,06,2014,454858,-2186,42,-2144,7582,2834
06107,107,06,2015,456794,-2820,234,-2586,7507,2983
06107,107,06,2016,458991,-2596,514,-2082,7330,3050
06107,107,06,2017,462072,-1071,26,-1045,7160,3026
06107,107,06,2018,464279,-1226,-276,-1502,6858,3151
06107,107,06,2019,465751,-1837,-446,-2283,6972,3239
06107,107,06,2020,468680,-194,-291,-485,6787,3404
06109,109,06,2010,55164,-210,8,-202,131,119
06109,109,06,2011,54808,-232,43,-189,442,607
06109,109,06,2012,54201,-491,38,-453,462,624
06109,109,06,2013,53975,-131,52,-79,460,600
06109,109,06,2014,53830,28,55,83,461,679
06109,109,06,2015,53599,-93,34,-59,472,637
06109,109,06,2016,53729,343,29,372,443,684
06109,109,06,2017,53953,444,22,466,473,713
06109,109,06,2018,54250,487,16,503,461,664
06109,109,06,2019,54290,245,13,258,465,682
06109,109,06,2020,54515,438,13,451,457,679
06111,111,06,2010,825144,172,119,291,2768,1266
06111,111,06,2011,829908,-1591,443,-1148,11007,5081
06111,111,06,2012,833287,-2604,512,-2092,10528,5010
06111,111,06,2013,837729,-1651,1000,-651,10531,5361
06111,111,06,2014,842113,-1717,1228,-489,10332,5335
06111,111,06,2015,845599,-2520,1383,-1137,10315,5625
06111,111,06,2016,846921,-4044,1086,-2958,9928,5633
06111,111,06,2017,848264,-2744,436,-2308,9454,5783
06111,111,06,2018,847222,-4073,-175,-4248,9215,6011
06111,111,06,2019,844203,-5456,-446,-5902,8859,5993
06111,111,06,2020,841387,-4601,-320,-4921,8820,6741
06113,113,06,2010,201061,-303,158,-145,565,223
06113,113,06,2011,201931,-1152,815,-337,2426,1225
06113,113,06,2012,204558,690,806,1496,2319,1171
06113,113,06,2013,206267,-563,1068,505,2506,1285
06113,113,06,2014,208368,-328,1151,823,2472,1176
06113,113,06,2015,211998,1052,1473,2525,2409,1299
06113,113,06,2016,215569,1106,1351,2457,2393,1280
06113,113,06,2017,218470,752,1198,1950,2318,1368
06113,113,06,2018,220082,-121,865,744,2265,1397
06113,113,06,2019,220019,-1355,550,-805,2074,1341
06113,113,06,2020,219728,-1317,435,-882,2068,1489
06115,115,06,2010,72345,-23,44,21,283,96
06115,115,06,2011,72480,-606,46,-560,1251,558
06115,115,06,2012,72770,-541,151,-390,1219,537
06115,115,06,2013,73082,-445,123,-322,1229,589
06115,115,06,2014,73527,-261,108,-153,1199,584
06115,115,06,2015,74039,-214,131,-83,1196,596
06115,115,06,2016,74920,246,87,333,1171,622
06115,115,06,2017,76575,1081,26,1107,1219,676
06115,115,06,2018,77418,431,-27,404,1137,697
06115,115,06,2019,78549,611,-9,602,1150,624
06115,115,06,2020,80160,1081,1,1082,1138,604
08001,001,08,2010,443692,700,102,802,1808,668
08001,001,08,2011,452209,2381,1308,3689,7290,2468
08001,001,08,2012,460568,3441,650,4091,6924,2730
08001,001,08,2013,469995,4354,611,4965,7171,2796
08001,001,08,2014,479954,4860,614,5474,7037,2678
08001,001,08,2015,490448,4981,1036,6017,7368,2943
08001,001,08,2016,497735,2315,770,3085,7155,2966
08001,001,08,2017,503717,1005,868,1873,7178,3073
08001,001,08,2018,511485,2658,1260,3918,6928,3106
08001,001,08,2019,516575,1176,330,1506,6825,3262
08001,001,08,2020,519883,-138,312,174,6565,3458
08003,003,08,2010,15515,11,3,14,75,15
08003,003,08,2011,15715,85,13,98,234,132
08003,003,08,2012,15685,-117,0,-117,208,123
08003,003,08,2013,15794,35,-1,34,222,147
08003,003,08,2014,15807,-95,1,-94,236,127
08003,003,08,2015,15894,8,2,10,213,134
08003,003,08,2016,16047,97,4,101,198,146
08003,003,08,2017,16102,11,3,14,200,158
08003,003,08,2018,16235,61,12,73,200,140
08003,003,08,2019,16200,-79,-12,-91,189,132
08003,003,08,2020,16180,-82,-3,-85,191,127
08005,005,08,2010,575124,873,602,1475,2035,884
08005,005,08,2011,586433,4161,2850,7011,7703,3423
08005,005,08,2012,597052,3665,2597,6262,7714,3373
08005,005,08,2013,609089,5286,2382,7668,7856,3571
08005,005,08,2014,619681,3688,2473,6161,7904,3485
08005,005,08,2015,631688,4504,3095,7599,8132,3741
08005,005,08,2016,639605,1389,2342,3731,8089,3904
08005,005,08,2017,645080,-411,2005,1594,7878,3979
08005,005,08,2018,652395,1164,2456,3620,7659,3974
08005,005,08,2019,656051,-808,1013,205,7578,4151
08005,005,08,2020,657452,-2392,779,-1613,7501,4531
08007,007,08,2010,12048,-35,2,-33,23,27
08007,007,08,2011,12027,-90,10,-80,138,80
08007,007,08,2012,12141,63,7,70,116,74
08007,007,08,2013,12225,59,12,71,103,92
08007,007,08,2014,12240,-3,6,3,106,93
08007,007,08,2015,12399,134,7,141,121,104
08007,007,08,2016,12834,401,3,404,117,90
08007,007,08,2017,13312,438,8,446,137,107
08007,007,08,2018,13670,332,11,343,119,106
08007,007,08,2019,13928,235,3,238,105,86
08007,007,08,2020,14196,259,6,265,109,103
08009,009,08,2010,3807,15,0,15,13,7
08009,009,08,2011,3779,6,1,7,39,74
08009,009,08,2012,3722,-40,1,-39,54,71
08009,009,08,2013,3656,-60,1,-59,46,54
08009,009,08,2014,3586,-59,0,-59,36,49
08009,009,08,2015,3554,-8,1,-7,31,56
08009,009,08,2016,3534,3,1,4,38,62
08009,009,08,2017,3554,24,3,27,38,45
08009,009,08,2018,3587,54,3,57,37,61
08009,009,08,2019,3620,20,2,22,47,36
08009,009,08,2020,3555,-56,1,-55,39,49
08011,011,08,2010,6500,11,2,13,13,25
08011,011,08,2011,6424,-77,19,-58,42,61
08011,011,08,2012,5850,-619,13,-606,57,57
08011,011,08,2013,5759,-77,11,-66,36,61
08011,011,08,2014,5821,77,0,77,30,49
08011,011,08,2015,5891,81,1,82,41,55
08011,011,08,2016,5832,-34,2,-32,34,61
08011,011,08,2017,5828,25,1,26,41,70
08011,011,08,2018,5793,18,1,19,30,84
08011,011,08,2019,5578,-211,0,-211,45,50
08011,011,08,2020,5356,-208,1,-207,41,54
08013,013,08,2010,295056,-163,244,81,766,346
08013,013,08,2011,300045,2414,1072,3486,2998,1507
08013,013,08,2012,304717,2401,862,3263,2962,1580
08013,013,08,2013,309538,2716,780,3496,2961,1666
08013,013,08,2014,312525,787,1017,1804,2942,1705
08013,013,08,2015,318408,3504,1264,4768,2868,1793
08013,013,08,2016,321761,1289,1053,2342,2832,1817
08013,013,08,2017,323019,-423,845,422,2637,1792
08013,013,08,2018,325438,650,1038,1688,2581,1844
08013,013,08,2019,326020,-331,336,5,2554,1989
08013,013,08,2020,327171,485,289,774,2517,2164
08014,014,08,2010,56212,250,28,278,161,91
08014,014,08,2011,57485,778,128,906,679,318
08014,014,08,2012,58971,1003,111,1114,678,326
08014,014,08,2013,60158,733,98,831,677,328
08014,014,08,2014,61791,1151,105,1256,700,351
08014,014,08,2015,64914,2625,142,2767,674,366
08014,014,08,2016,66596,1208,108,1316,740,378
08014,014,08,2017,68340,1329,92,1421,671,355
08014,014,08,2018,69431,735,110,845,633,387
08014,014,08,2019,70617,854,42,896,676,389
08014,014,08,2020,72236,1355,40,1395,672,445
08015,015,08,2010,17808,-7,6,-1,30,29
08015,015,08,2011,18035,212,23,235,146,155
08015,015,08,2012,18164,116,16,132,151,158
08015,015,08,2013,18375,273,3,276,111,178
08015,015,08,2014,18471,117,0,117,143,169
08015,015,08,2015,18635,207,18,225,138,203
08015,015,08,2016,19140,542,11,553,135,186
08015,015,08,2017,19700,592,10,602,131,178
08015,015,08,2018,20066,383,10,393,143,173
08015,015,08,2019,20319,309,2,311,122,178
08015,015,08,2020,20661,394,5,399,138,191
08017,017,08,2010,1833,-4,1,-3,4,2
08017,017,08,2011,1863,13,17,30,21,21
08017,017,08,2012,1871,-2,1,-1,37,27
08017,017,08,2013,1878,-4,2,-2,27,18
08017,017,08,2014,1845,-51,5,-46,26,14
08017,017,08,2015,1826,-35,7,-28,28,20
08017,017,08,2016,1848,12,4,16,27,21
08017,017,08,2017,1849,-3,4,1,21,20
08017,017,08,2018,1864,16,4,20,15,21
08017,017,08,2019,1824,-38,3,-35,14,17
08017,017,08,2020,1795,-30,1,-29,14,14
08019,019,08,2010,9084,22,4,26,15,32
08019,019,08,2011,9012,-111,27,-84,67,54
08019,019,08,2012,9017,-39,23,-16,65,42
08019,019,08,2013,9025,-26,22,-4,68,57
08019,019,08,2014,9124,59,23,82,78,61
08019,019,08,2015,9246,97,25,122,59,60
08019,019,08,2016,9355,75,15,90,74,55
08019,019,08,2017,9573,177,14,191,78,52
08019,019,08,2018,9552,-54,18,-36,81,66
08019,019,08,2019,9598,41,10,51,70,74
08019,019,08,2020,9586,-1,8,7,63,81
08021,021,08,2010,8312,19,1,20,41,5
08021,021,08,2011,8291,-51,12,-39,106,88
08021,021,08,2012,8248,-87,5,-82,124,84
08021,021,08,2013,8199,-58,1,-57,107,101
08021,021,08,2014,8230,-26,3,-23,126,72
08021,021,08,2015,8064,-192,2,-190,115,93
08021,021,08,2016,8044,-29,2,-27,97,91
08021,021,08,2017,8141,72,4,76,95,72
08021,021,08,2018,8154,21,4,25,82,94
08021,021,08,2019,8169,-6,1,-5,97,75
08021,021,08,2020,8143,-44,1,-43,97,80
08023,023,08,2010,3529,8,1,9,7,11
08023,023,08,2011,3640,93,17,110,35,35
08023,023,08,2012,3601,-35,8,-27,29,40
08023,023,08,2013,3540,-55,9,-46,28,45
08023,023,08,2014,3560,30,8,38,25,43
08023,023,08,2015,3576,12,9,21,31,34
08023,023,08,2016,3692,131,4,135,30,49
08023,023,08,2017,3758,57,9,66,37,37
08023,023,08,2018,3803,46,13,59,30,45
08023,023,08,2019,3872,57,8,65,36,33
08023,023,08,2020,3921,37,7,44,36,29
08025,025,08,2010,5859,23,3,26,12,3
08025,025,08,2011,5884,-7,34,27,32,35
08025,025,08,2012,5468,-448,15,-433,42,47
08025,025,08,2013,5352,-121,0,-121,39,38
08025,025,08,2014,5610,263,-2,261,30,46
08025,025,08,2015,5633,10,9,19,42,38
08025,025,08,2016,5276,-345,11,-334,27,55
08025,025,08,2017,5820,542,11,553,30,46
08025,025,08,2018,5886,51,21,72,29,36
08025,025,08,2019,5989,122,-6,116,32,45
08025,025,08,2020,5696,-276,5,-271,27,48
08027,027,08,2010,4278,25,0,25,4,4
08027,027,08,2011,4224,-45,0,-45,21,29
08027,027,08,2012,4217,3,0,3,26,36
08027,027,08,2013,4260,58,0,58,20,36
08027,027,08,2014,4339,90,0,90,23,36
08027,027,08,2015,4434,103,0,103,25,33
08027,027,08,2016,4581,180,0,180,17,52
08027,027,08,2017,4861,283,0,283,38,44
08027,027,08,2018,4962,115,0,115,33,48
08027,027,08,2019,5119,157,0,157,35,35
08027,027,08,2020,5183,71,0,71,37,42
08029,029,08,2010,30858,-73,3,-70,82,110
08029,029,08,2011,30398,-477,32,-445,342,359
08029,029,08,2012,30473,48,14,62,338,317
08029,029,08,2013,30349,-130,5,-125,317,318
08029,029,08,2014,29973,-312,4,-308,295,363
08029,029,08,2015,29925,66,-3,63,271,378
08029,029,08,2016,30352,513,-9,504,283,360
08029,029,08,2017,30516,283,-9,274,278,388
08029,029,08,2018,30835,493,-9,484,278,440
08029,029,08,2019,31021,332,-13,319,278,411
08029,029,08,2020,31067,205,-2,203,268,422
08031,031,08,2010,603012,1514,412,1926,2411,1002
08031,031,08,2011,620250,8931,2702,11633,9605,4113
08031,031,08,2012,634965,7177,1963,9140,9227,4128
08031,031,08,2013,649270,7059,1782,8841,9257,4161
08031,031,08,2014,664540,7777,1934,9711,9323,4170
08031,031,08,2015,683328,10820,2607,13427,9365,4305
08031,031,08,2016,696273,5937,1855,7792,9447,4380
08031,031,08,2017,704869,2225,1652,3877,8996,4325
08031,031,08,2018,716340,4655,2220,6875,8938,4402
08031,031,08,2019,725508,4459,673,5132,8749,4709
08031,031,08,2020,735538,5641,588,6229,9233,5406
08033,033,08,2010,2069,0,0,0,5,0
08033,033,08,2011,2044,-25,0,-25,17,17
08033,033,08,2012,2009,-43,0,-43,24,18
08033,033,08,2013,2033,24,0,24,17,18
08033,033,08,2014,1976,-45,0,-45,15,29
08033,033,08,2015,1980,0,0,0,19,14
08033,033,08,2016,2055,76,0,76,15,15
08033,033,08,2017,2044,-2,0,-2,12,21
08033,033,08,2018,2056,18,0,18,15,21
08033,033,08,2019,2042,-8,0,-8,12,18
08033,033,08,2020,2096,48,0,48,16,11
08035,035,08,2010,287011,735,102,837,923,261
08035,035,08,2011,292626,2492,468,2960,3554,904
08035,035,08,2012,298826,3134,586,3720,3484,1038
08035,035,08,2013,306407,4609,536,5145,3425,1047
08035,035,08,2014,314783,5207,568,5775,3539,1034
08035,035,08,2015,322333,4561,849,5410,3373,1259
08035,035,08,2016,328680,3480,705,4185,3501,1341
08035,035,08,2017,336347,4942,558,5500,3493,1346
08035,035,08,2018,343780,4758,675,5433,3430,1439
08035,035,08,2019,351842,5871,226,6097,3491,1522
08035,035,08,2020,360750,6930,183,7113,3525,1704
08037,037,08,2010,52098,-344,28,-316,197,9
08037,037,08,2011,52048,-904,278,-626,652,83
08037,037,08,2012,52330,-381,64,-317,696,98
08037,037,08,2013,52814,-55,56,1,602,118
08037,037,08,2014,53276,-128,62,-66,659,121
08037,037,08,2015,53863,-81,140,59,645,112
08037,037,08,2016,54578,63,109,172,663,120
08037,037,08,2017,55022,-189,156,-33,602,124
08037,037,08,2018,55087,-586,211,-375,578,140
08037,037,08,2019,55183,-404,77,-327,562,139
08037,037,08,2020,54929,-702,52,-650,559,163
08039,039,08,2010,23137,32,5,37,31,13
08039,039,08,2011,23175,-41,9,-32,179,109
08039,039,08,2012,23276,59,0,59,161,117
08039,039,08,2013,23543,235,0,235,158,127
08039,039,08,2014,24035,406,26,432,174,119
08039,039,08,2015,24634,481,47,528,205,138
08039,039,08,2016,25130,403,19,422,196,123
08039,039,08,2017,25735,523,11,534,223,152
08039,039,08,2018,26267,474,15,489,194,148
08039,039,08,2019,26707,371,8,379,219,157
08039,039,08,2020,27313,560,5,565,216,170
08041,041,08,2010,627088,2727,508,3235,2258,864
08041,041,08,2011,637376,3660,1061,4721,9230,3671
08041,041,08,2012,645900,421,2866,3287,9164,3775
08041,041,08,2013,655178,2440,1692,4132,9082,3913
08041,041,08,2014,662968,1207,1550,2757,9185,4061
08041,041,08,2015,674094,3638,2187,5825,9436,4126
08041,041,08,2016,688671,8208,1132,9340,9482,4289
08041,041,08,2017,700838,6720,548,7268,9475,4618
08041,041,08,2018,712746,6736,407,7143,9339,4611
08041,041,08,2019,721929,4944,2,4946,9136,4935
08041,041,08,2020,728310,2429,77,2506,9089,5259
08043,043,08,2010,46834,69,13,82,81,155
08043,043,08,2011,47393,604,102,706,379,530
08043,043,08,2012,47072,-286,65,-221,389,498
08043,043,08,2013,46360,-519,-5,-524,334,529
08043,043,08,2014,46185,-15,8,-7,380,541
08043,043,08,2015,46327,307,1,308,381,546
08043,043,08,2016,47047,865,10,875,382,541
08043,043,08,2017,47633,781,3,784,376,577
08043,043,08,2018,48070,627,4,631,375,571
08043,043,08,2019,48009,118,-4,114,399,572
08043,043,08,2020,47867,91,-1,90,378,612
08045,045,08,2010,56072,-497,10,-487,231,82
08045,045,08,2011,56049,-731,135,-596,862,294
08045,045,08,2012,56765,169,23,192,789,257
08045,045,08,2013,56945,-343,-13,-356,822,285
08045,045,08,2014,57174,-259,11,-248,776,290
08045,045,08,2015,57724,122,14,136,763,344
08045,045,08,2016,58839,627,-15,612,842,341
08045,045,08,2017,59065,-311,40,-271,827,328
08045,045,08,2018,59722,127,98,225,782,350
08045,045,08,2019,60031,-78,-3,-81,758,369
08045,045,08,2020,60366,-28,1,-27,763,405
08047,047,08,2010,5471,9,1,10,10,0
08047,047,08,2011,5429,-61,2,-59,45,28
08047,047,08,2012,5432,-11,2,-9,39,27
08047,047,08,2013,5535,73,0,73,50,21
08047,047,08,2014,5754,203,0,203,40,30
08047,047,08,2015,5813,51,0,51,39,33
08047,047,08,2016,5920,96,0,96,39,30
08047,047,08,2017,6024,91,0,91,41,28
08047,047,08,2018,6131,89,0,89,41,24
08047,047,08,2019,6232,102,0,102,28,30
08047,047,08,2020,6235,10,0,10,31,38
08049,049,08,2010,14795,-80,5,-75,27,4
08049,049,08,2011,14564,-296,23,-273,105,66
08049,049,08,2012,14227,-415,1,-414,110,45
08049,049,08,2013,14320,31,4,35,117,61
08049,049,08,2014,14569,179,6,185,125,67
08049,049,08,2015,14742,114,23,137,110,76
08049,049,08,2016,15198,377,13,390,128,64
08049,049,08,2017,15385,110,12,122,130,67
08049,049,08,2018,15556,132,17,149,105,85
08049,049,08,2019,15748,138,7,145,112,63
08049,049,08,2020,15794,-3,8,5,110,70
08051,051,08,2010,15290,-52,2,-50,41,26
08051,051,08,2011,15267,-136,11,-125,152,52
08051,051,08,2012,15390,42,-8,34,165,77
08051,051,08,2013,15597,123,-1,122,151,68
08051,051,08,2014,15786,106,-1,105,134,55
08051,051,08,2015,16125,266,7,273,137,77
08051,051,08,2016,16447,236,5,241,157,79
08051,051,08,2017,16896,372,8,380,135,69
08051,051,08,2018,17177,224,9,233,125,79
08051,051,08,2019,17480,235,5,240,133,71
08051,051,08,2020,17593,58,0,58,131,77
08053,053,08,2010,844,0,0,0,0,0
08053,053,08,2011,825,-17,0,-17,5,7
08053,053,08,2012,802,-28,0,-28,6,3
08053,053,08,2013,803,-1,0,-1,8,5
08053,053,08,2014,772,-36,0,-36,7,3
08053,053,08,2015,762,-9,0,-9,6,7
08053,053,08,2016,783,24,0,24,2,5
08053,053,08,2017,788,4,0,4,4,4
08053,053,08,2018,786,4,0,4,1,7
08053,053,08,2019,789,7,0,7,7,10
08053,053,08,2020,808,20,0,20,6,7
08055,055,08,2010,6681,-32,4,-28,10,13
08055,055,08,2011,6527,-113,20,-93,45,107
08055,055,08,2012,6567,83,3,86,57,106
08055,055,08,2013,6465,-54,0,-54,49,95
08055,055,08,2014,6399,-13,0,-13,43,95
08055,055,08,2015,6408,58,1,59,54,104
08055,055,08,2016,6583,242,3,245,43,114
08055,055,08,2017,6632,121,2,123,43,118
08055,055,08,2018,6877,297,4,301,44,101
08055,055,08,2019,6868,43,0,43,48,99
08055,055,08,2020,6883,84,0,84,39,106
08057,057,08,2010,1388,-8,0,-8,3,0
08057,057,08,2011,1357,-33,0,-33,12,10
08057,057,08,2012,1325,-26,0,-26,9,15
08057,057,08,2013,1338,15,0,15,6,10
08057,057,08,2014,1385,41,1,42,16,12
08057,057,08,2015,1352,-35,0,-35,12,10
08057,057,08,2016,1356,6,0,6,12,13
08057,057,08,2017,1376,16,1,17,15,13
08057,057,08,2018,1403,27,1,28,14,15
08057,057,08,2019,1397,-12,1,-11,14,9
08057,057,08,2020,1389,-9,1,-8,12,12
08059,059,08,2010,535567,97,135,232,1482,915
08059,059,08,2011,540582,2473,732,3205,5554,3741
08059,059,08,2012,546736,3823,630,4453,5556,3898
08059,059,08,2013,552242,3409,447,3856,5625,3998
08059,059,08,2014,559099,4392,552,4944,5938,4117
08059,059,08,2015,565240,3937,748,4685,5843,4407
08059,059,08,2016,571823,4370,607,4977,5896,4307
08059,059,08,2017,576041,2124,606,2730,5977,4499
08059,059,08,2018,580027,2065,795,2860,5612,4499
08059,059,08,2019,582800,1409,253,1662,5723,4627
08059,059,08,2020,583283,-447,209,-238,5701,5002
08061,061,08,2010,1404,4,0,4,3,2
08061,061,08,2011,1432,30,0,30,20,22
08061,061,08,2012,1410,-8,0,-8,8,21
08061,061,08,2013,1393,-14,0,-14,15,18
08061,061,08,2014,1382,-11,0,-11,19,20
08061,061,08,2015,1386,13,0,13,15,24
08061,061,08,2016,1346,-39,0,-39,19,21
08061,061,08,2017,1368,25,1,26,17,21
08061,061,08,2018,1385,23,1,24,18,25
08061,061,08,2019,1417,25,1,26,20,12
08061,061,08,2020,1458,34,1,35,19,14
08063,063,08,2010,8271,-5,-2,-7,29,27
08063,063,08,2011,8183,-132,18,-114,104,82
08063,063,08,2012,8088,-130,8,-122,94,69
08063,063,08,2013,8259,153,3,156,82,76
08063,063,08,2014,8028,-258,-2,-260,95,79
08063,063,08,2015,8223,152,2,154,114,76
08063,063,08,2016,7632,-618,4,-614,94,79
08063,063,08,2017,7149,-509,5,-504,87,72
08063,063,08,2018,7166,4,9,13,79,76
08063,063,08,2019,7161,-49,4,-45,93,52
08063,063,08,2020,7121,-64,4,-60,91,71
08065,065,08,2010,7263,-55,-5,-60,25,14
08065,065,08,2011,7344,18,1,19,103,42
08065,065,08,2012,7259,-114,-4,-118,73,41
08065,065,08,2013,7276,-22,0,-22,79,38
08065,065,08,2014,7333,23,-6,17,79,43
08065,065,08,2015,7455,86,-8,78,85,43
08065,065,08,2016,7591,117,-1,116,64,44
08065,065,08,2017,7769,126,4,130,84,37
08065,065,08,2018,7807,-15,9,-6,82,37
08065,065,08,2019,8072,188,1,189,96,20
08065,065,08,2020,7987,-147,2,-145,95,35
08067,067,08,2010,51416,-3,9,6,164,85
08067,067,08,2011,51886,145,31,176,543,249
08067,067,08,2012,52489,372,20,392,533,335
08067,067,08,2013,53432,723,15,738,497,316
08067,067,08,2014,53941,253,7,260,549,302
08067,067,08,2015,54776,597,10,607,577,357
08067,067,08,2016,55459,449,18,467,574,358
08067,067,08,2017,55717,107,9,116,502,359
08067,067,08,2018,56511,661,19,680,458,346
08067,067,08,2019,56440,-180,1,-179,451,342
08067,067,08,2020,56564,81,1,82,439,399
08069,069,08,2010,300453,377,94,471,842,487
08069,069,08,2011,305320,2854,549,3403,3319,1870
08069,069,08,2012,310983,3483,554,4037,3404,1871
08069,069,08,2013,316426,3480,506,3986,3376,1989
08069,069,08,2014,324272,5695,473,6168,3497,1982
08069,069,08,2015,333637,7398,658,8056,3445,2257
08069,069,08,2016,339394,3919,525,4444,3474,2183
08069,069,08,2017,344509,3709,456,4165,3341,2412
08069,069,08,2018,351045,5051,577,5628,3284,2397
08069,069,08,2019,357241,5156,192,5348,3171,2330
08069,069,08,2020,360428,2257,162,2419,3241,2488
08071,071,08,2010,15422,-83,3,-80,30,38
08071,071,08,2011,15054,-339,17,-322,150,197
08071,071,08,2012,14996,-51,7,-44,150,164
08071,071,08,2013,14404,-579,11,-568,147,186
08071,071,08,2014,14054,-329,18,-311,117,164
08071,071,08,2015,14048,29,19,48,126,178
08071,071,08,2016,14085,71,25,96,128,186
08071,071,08,2017,14237,157,29,186,146,181
08071,071,08,2018,14460,261,30,291,101,168
08071,071,08,2019,14415,-27,17,-10,126,159
08071,071,08,2020,14420,57,14,71,111,177
08073,073,08,2010,5471,6,-1,5,12,15
08073,073,08,2011,5420,-71,7,-64,64,51
08073,073,08,2012,5441,22,7,29,48,56
08073,073,08,2013,5435,-36,0,-36,71,42
08073,073,08,2014,5503,61,1,62,51,46
08073,073,08,2015,5545,31,2,33,74,65
08073,073,08,2016,5546,10,3,13,49,60
08073,073,08,2017,5526,-27,4,-23,54,52
08073,073,08,2018,5595,62,5,67,57,55
08073,073,08,2019,5694,89,4,93,63,57
08073,073,08,2020,5680,-27,3,-24,58,48
08075,075,08,2010,22749,15,-1,14,58,29
08075,075,08,2011,22577,-189,-10,-199,211,184
08075,075,08,2012,22360,-256,-8,-264,222,184
08075,075,08,2013,22182,-257,23,-234,253,199
08075,075,08,2014,22446,242,18,260,238,240
08075,075,08,2015,22484,-19,24,5,220,185
08075,075,08,2016,22427,-21,0,-21,223,258
08075,075,08,2017,22314,-118,-3,-121,239,229
08075,075,08,2018,22286,-68,0,-68,236,197
08075,075,08,2019,22409,121,-5,116,217,208
08075,075,08,2020,21974,-427,-7,-434,219,218
08077,077,08,2010,146266,-668,19,-649,474,327
08077,077,08,2011,147205,255,89,344,1908,1306
08077,077,08,2012,147360,-321,-6,-327,1819,1306
08077,077,08,2013,147249,-560,-4,-564,1854,1384
08077,077,08,2014,147215,-354,-36,-390,1760,1385
08077,077,08,2015,148159,614,6,620,1828,1500
08077,077,08,2016,149882,1471,17,1488,1709,1478
08077,077,08,2017,151435,1393,26,1419,1656,1523
08077,077,08,2018,153339,1710,59,1769,1660,1527
08077,077,08,2019,154552,1200,-11,1189,1637,1613
08077,077,08,2020,155603,1141,0,1141,1596,1688
08079,079,08,2010,704,-5,0,-5,1,4
08079,079,08,2011,711,5,0,5,5,3
08079,079,08,2012,719,7,0,7,6,5
08079,079,08,2013,732,12,0,12,4,4
08079,079,08,2014,703,-31,0,-31,5,4
08079,079,08,2015,742,41,0,41,4,7
08079,079,08,2016,756,10,0,10,10,5
08079,079,08,2017,753,6,0,6,6,16
08079,079,08,2018,774,20,0,20,8,5
08079,079,08,2019,756,-14,0,-14,4,9
08079,079,08,2020,773,22,0,22,6,10
08081,081,08,2010,13795,-16,4,-12,59,44
08081,081,08,2011,13424,-517,23,-494,187,68
08081,081,08,2012,13172,-316,10,-306,165,120
08081,081,08,2013,13129,-152,5,-147,192,91
08081,081,08,2014,12941,-279,-1,-280,177,93
08081,081,08,2015,12946,-93,3,-90,192,96
08081,081,08,2016,13155,122,1,123,183,96
08081,081,08,2017,13095,-139,4,-135,177,103
08081,081,08,2018,13148,-11,8,-3,156,99
08081,081,08,2019,13209,8,-1,7,161,107
08081,081,08,2020,13144,-117,-1,-118,154,99
08083,083,08,2010,25576,-11,6,-5,83,40
08083,083,08,2011,25489,-133,26,-107,310,290
08083,083,08,2012,25497,-14,6,-8,293,270
08083,083,08,2013,25575,51,-12,39,293,253
08083,083,08,2014,25551,-63,-11,-74,323,268
08083,083,08,2015,25763,145,-7,138,329,255
08083,083,08,2016,26063,273,-2,271,297,267
08083,083,08,2017,26187,166,-5,161,251,286
08083,083,08,2018,26303,109,-5,104,284,271
08083,083,08,2019,26369,106,-5,101,237,271
08083,083,08,2020,26408,110,-3,107,253,323
08085,085,08,2010,41182,-156,5,-151,124,67
08085,085,08,2011,40980,-371,69,-302,497,398
08085,085,08,2012,40675,-251,3,-248,401,458
08085,085,08,2013,40584,-159,-1,-160,455,384
08085,085,08,2014,40622,-34,-8,-42,477,391
08085,085,08,2015,40609,3,-4,-1,454,460
08085,085,08,2016,41183,602,-11,591,423,441
08085,085,08,2017,41795,614,-6,608,466,462
08085,085,08,2018,42309,485,6,491,448,426
08085,085,08,2019,42791,552,-14,538,385,438
08085,085,08,2020,43322,625,-8,617,410,495
08087,087,08,2010,28243,-38,36,-2,127,41
08087,087,08,2011,28450,-141,168,27,460,278
08087,087,08,2012,28243,-432,61,-371,426,271
08087,087,08,2013,28217,-281,72,-209,412,231
08087,087,08,2014,28098,-399,85,-314,429,240
08087,087,08,2015,28245,-174,132,-42,452,261
08087,087,08,2016,28178,-334,122,-212,429,285
08087,087,08,2017,28275,-158,139,-19,398,280
08087,087,08,2018,28754,102,181,283,470,275
08087,087,08,2019,28938,-73,97,24,412,253
08087,087,08,2020,28941,-237,82,-155,428,268
08089,089,08,2010,18857,12,3,15,43,31
08089,089,08,2011,18837,-55,6,-49,249,221
08089,089,08,2012,18631,-214,3,-211,266,265
08089,089,08,2013,18449,-142,-3,-145,189,227
08089,089,08,2014,18334,-62,-2,-64,215,263
08089,089,08,2015,18182,-100,3,-97,190,244
08089,089,08,2016,18279,122,2,124,228,255
08089,089,08,2017,18344,74,3,77,215,225
08089,089,08,2018,18354,11,8,19,227,235
08089,089,08,2019,18243,-58,-1,-59,202,254
08089,089,08,2020,18201,-18,-1,-19,218,241
08091,091,08,2010,4457,15,1,16,13,15
08091,091,08,2011,4424,-42,-1,-43,28,19
08091,091,08,2012,4508,64,2,66,32,18
08091,091,08,2013,4554,46,1,47,32,34
08091,091,08,2014,4576,30,1,31,34,44
08091,091,08,2015,4611,37,3,40,21,26
08091,091,08,2016,4794,178,2,180,34,32
08091,091,08,2017,4815,9,0,9,32,20
08091,091,08,2018,4834,28,0,28,25,34
08091,091,08,2019,5005,180,0,180,22,30
08091,091,08,2020,5001,-2,-1,-3,22,23
08093,093,08,2010,16278,51,4,55,27,7
08093,093,08,2011,16060,-253,1,-252,115,83
08093,093,08,2012,16052,-48,11,-37,107,77
08093,093,08,2013,16190,105,10,115,96,75
08093,093,08,2014,16392,179,5,184,97,83
08093,093,08,2015,16739,318,-2,316,114,90
08093,093,08,2016,17372,607,5,612,117,101
08093,093,08,2017,17935,533,4,537,115,96
08093,093,08,2018,18583,616,6,622,120,97
08093,093,08,2019,18881,276,2,278,140,121
08093,093,08,2020,18955,38,3,41,138,105
08095,095,08,2010,4471,17,1,18,18,8
08095,095,08,2011,4402,-100,42,-58,50,61
08095,095,08,2012,4417,-3,11,8,54,48
08095,095,08,2013,4384,-31,7,-24,41,50
08095,095,08,2014,4394,-6,-1,-7,64,49
08095,095,08,2015,4328,-78,11,-67,56,56
08095,095,08,2016,4307,-72,25,-47,70,44
08095,095,08,2017,4339,-14,48,34,51,53
08095,095,08,2018,4343,-46,62,16,42,55
08095,095,08,2019,4359,-35,39,4,51,39
08095,095,08,2020,4367,-17,32,15,50,57
08097,097,08,2010,17156,-27,19,-8,35,17
08097,097,08,2011,17177,-167,68,-99,175,56
08097,097,08,2012,17303,0,47,47,126,48
08097,097,08,2013,17474,5,88,93,123,43
08097,097,08,2014,17730,89,88,177,131,54
08097,097,08,2015,17962,46,110,156,129,54
08097,097,08,2016,18009,-156,117,-39,147,61
08097,097,08,2017,18027,-192,97,-95,162,49
08097,097,08,2018,18066,-121,113,-8,117,69
08097,097,08,2019,17902,-327,61,-266,148,45
08097,097,08,2020,17894,-131,45,-86,129,51
08099,099,08,2010,12546,-39,2,-37,40,9
08099,099,08,2011,12500,-55,18,-37,141,149
08099,099,08,2012,12422,-150,12,-138,187,131
08099,099,08,2013,12319,-167,13,-154,168,119
08099,099,08,2014,12064,-321,15,-306,146,103
08099,099,08,2015,11937,-177,11,-166,163,127
08099,099,08,2016,11937,-36,5,-31,183,151
08099,099,08,2017,11990,11,4,15,162,123
08099,099,08,2018,12038,7,10,17,164,133
08099,099,08,2019,12106,24,3,27,148,107
08099,099,08,2020,12106,-22,0,-22,145,123
08101,101,08,2010,159401,235,13,248,504,418
08101,101,08,2011,160208,492,103,595,1865,1648
08101,101,08,2012,160763,213,63,276,1880,1581
08101,101,08,2013,161096,70,47,117,1854,1610
08101,101,08,2014,161434,29,47,76,1919,1619
08101,101,08,2015,163101,1437,81,1518,1877,1727
08101,101,08,2016,164883,1607,21,1628,1853,1698
08101,101,08,2017,166370,1442,25,1467,1787,1769
08101,101,08,2018,167574,1154,52,1206,1826,1827
08101,101,08,2019,168409,945,-11,934,1840,1936
08101,101,08,2020,169823,1616,2,1618,1803,2000
08103,103,08,2010,6623,-68,10,-58,22,17
08103,103,08,2011,6751,43,18,61,107,41
08103,103,08,2012,6763,-25,20,-5,72,55
08103,103,08,2013,6699,-97,5,-92,79,52
08103,103,08,2014,6604,-112,1,-111,70,58
08103,103,08,2015,6487,-155,5,-150,84,53
08103,103,08,2016,6443,-64,5,-59,76,61
08103,103,08,2017,6362,-113,10,-103,67,44
08103,103,08,2018,6347,-59,14,-45,83,54
08103,103,08,2019,6350,-19,10,-9,50,38
08103,103,08,2020,6342,-24,7,-17,58,49
08105,105,08,2010,12022,14,-1,13,42,14
08105,105,08,2011,11914,-138,8,-130,150,128
08105,105,08,2012,11867,-47,-7,-54,136,128
08105,105,08,2013,11674,-202,-12,-214,148,130
08105,105,08,2014,11505,-201,-3,-204,147,115
08105,105,08,2015,11355,-148,-3,-151,129,129
08105,105,08,2016,11354,-8,0,-8,138,130
08105,105,08,2017,11300,-37,2,-35,116,134
08105,105,08,2018,11274,-22,8,-14,127,139
08105,105,08,2019,11277,-8,-1,-9,118,106
08105,105,08,2020,11296,32,-1,31,122,133
08107,107,08,2010,23434,-122,6,-116,68,33
08107,107,08,2011,23256,-352,29,-323,229,88
08107,107,08,2012,23283,-167,66,-101,217,92
08107,107,08,2013,23610,148,77,225,202,101
08107,107,08,2014,24085,280,86,366,210,105
08107,107,08,2015,24388,116,73,189,215,101
08107,107,08,2016,24737,153,54,207,247,107
08107,107,08,2017,25220,338,41,379,232,129
08107,107,08,2018,25489,146,49,195,192,119
08107,107,08,2019,25579,-30,23,-7,204,107
08107,107,08,2020,25560,-92,20,-72,189,139
08109,109,08,2010,6135,8,2,10,17,1
08109,109,08,2011,6187,-2,19,17,73,37
08109,109,08,2012,6331,99,3,102,71,30
08109,109,08,2013,6240,-139,5,-134,76,34
08109,109,08,2014,6195,-60,6,-54,56,47
08109,109,08,2015,6250,31,6,37,78,60
08109,109,08,2016,6413,125,7,132,76,46
08109,109,08,2017,6632,193,7,200,66,48
08109,109,08,2018,6837,181,7,188,75,59
08109,109,08,2019,6829,-23,4,-19,45,34
08109,109,08,2020,6938,114,5,119,54,60
08111,111,08,2010,708,9,0,9,0,1
08111,111,08,2011,690,-18,0,-18,8,8
08111,111,08,2012,692,1,0,1,3,3
08111,111,08,2013,692,2,0,2,1,3
08111,111,08,2014,712,17,0,17,7,3
08111,111,08,2015,690,-24,0,-24,7,6
08111,111,08,2016,691,-2,0,-2,5,3
08111,111,08,2017,713,22,0,22,6,5
08111,111,08,2018,760,44,0,44,3,1
08111,111,08,2019,723,-37,0,-37,4,4
08111,111,08,2020,748,30,0,30,2,6
08113,113,08,2010,7358,-19,8,-11,17,7
08113,113,08,2011,7491,37,38,75,75,18
08113,113,08,2012,7588,37,17,54,72,29
08113,113,08,2013,7632,-11,11,0,69,25
08113,113,08,2014,7751,48,27,75,70,26
08113,113,08,2015,7850,19,36,55,67,23
08113,113,08,2016,8032,111,30,141,68,26
08113,113,08,2017,8049,-64,30,-34,68,16
08113,113,08,2018,8195,65,43,108,49,12
08113,113,08,2019,8169,-81,17,-64,61,22
08113,113,08,2020,8105,-99,17,-82,53,35
08115,115,08,2010,2371,-3,0,-3,6,14
08115,115,08,2011,2371,9,3,12,28,41
08115,115,08,2012,2377,22,1,23,21,38
08115,115,08,2013,2338,-38,1,-37,26,29
08115,115,08,2014,2332,0,2,2,26,32
08115,115,08,2015,2373,70,0,70,23,54
08115,115,08,2016,2399,34,0,34,28,36
08115,115,08,2017,2314,-71,0,-71,20,34
08115,115,08,2018,2284,-15,0,-15,21,35
08115,115,08,2019,2274,2,0,2,15,26
08115,115,08,2020,2260,-7,0,-7,18,25
08117,117,08,2010,28075,-16,35,19,63,3
08117,117,08,2011,28048,-465,183,-282,307,54
08117,117,08,2012,28307,-125,134,9,309,56
08117,117,08,2013,28741,173,59,232,248,54
08117,117,08,2014,29333,274,107,381,269,69
08117,117,08,2015,30064,395,119,514,271,69
08117,117,08,2016,30573,169,105,274,295,63
08117,117,08,2017,30848,-40,106,66,280,70
08117,117,08,2018,30771,-406,125,-281,277,72
08117,117,08,2019,30851,-165,49,-116,253,58
08117,117,08,2020,30631,-447,48,-399,252,75
08119,119,08,2010,23474,84,0,84,51,25
08119,119,08,2011,23378,-181,-6,-187,221,132
08119,119,08,2012,23456,76,-6,70,154,143
08119,119,08,2013,23372,-112,-6,-118,165,125
08119,119,08,2014,23458,77,-6,71,193,173
08119,119,08,2015,23421,-53,2,-51,194,180
08119,119,08,2016,24098,653,2,655,190,173
08119,119,08,2017,24713,581,-2,579,179,149
08119,119,08,2018,25158,447,-1,446,169,172
08119,119,08,2019,25408,274,-5,269,169,186
08119,119,08,2020,25529,168,-1,167,173,218
08121,121,08,2010,4808,3,0,3,13,5
08121,121,08,2011,4750,-50,5,-45,41,53
08121,121,08,2012,4689,-54,1,-53,40,50
08121,121,08,2013,4731,48,1,49,34,41
08121,121,08,2014,4720,-8,1,-7,47,52
08121,121,08,2015,4775,56,0,56,48,49
08121,121,08,2016,4824,60,0,60,57,68
08121,121,08,2017,4909,82,-1,81,45,41
08121,121,08,2018,4861,-43,-1,-44,54,57
08121,121,08,2019,4869,1,-1,0,47,40
08121,121,08,2020,4875,10,-1,9,46,49
08123,123,08,2010,254224,728,33,761,941,368
08123,123,08,2011,258867,1916,408,2324,3753,1444
08123,123,08,2012,264025,2584,184,2768,3792,1454
08123,123,08,2013,270105,3617,130,3747,3820,1566
08123,123,08,2014,277480,4643,270,4913,3956,1616
08123,123,08,2015,286493,6186,382,6568,4080,1724
08123,123,08,2016,296330,6987,284,7271,4264,1741
08123,123,08,2017,306571,7420,296,7716,4309,1835
08123,123,08,2018,315360,5920,443,6363,4275,1879
08123,123,08,2019,324703,6798,109,6907,4318,1882
08123,123,08,2020,333983,6828,96,6924,4428,2042
08125,125,08,2010,10054,-22,2,-20,37,14
08125,125,08,2011,10138,-10,57,47,155,118
08125,125,08,2012,10107,-85,9,-76,156,113
08125,125,08,2013,10139,-38,24,-14,139,92
08125,125,08,2014,10191,-37,26,-11,142,79
08125,125,08,2015,10044,-204,13,-191,140,98
08125,125,08,2016,10057,-45,17,-28,142,101
08125,125,08,2017,9976,-151,41,-110,143,115
08125,125,08,2018,9964,-111,61,-50,135,99
08125,125,08,2019,10020,-29,33,4,143,91
08125,125,08,2020,10047,-48,25,-23,141,91
09001,001,09,2010,919371,483,814,1297,2721,1505
09001,001,09,2011,928099,117,4689,4806,10408,6450
09001,001,09,2012,935293,-2165,5554,3389,10200,6304
09001,001,09,2013,940189,-2223,3792,1569,10051,6620
09001,001,09,2014,944524,-5376,6133,757,10092,6529
09001,001,09,2015,945323,-7856,5193,-2663,10189,6765
09001,001,09,2016,945096,-8416,4716,-3700,10199,6754
09001,001,09,2017,944107,-8851,4850,-4001,9849,6892
09001,001,09,2018,945511,-7249,6002,-1247,9582,6968
09001,001,09,2019,944388,-8161,4225,-3936,9559,6777
09001,001,09,2020,942426,-7417,3386,-4031,9461,7423
09003,003,09,2010,895214,-40,694,654,2457,1819
09003,003,09,2011,896900,-3907,3784,-123,9732,7918
09003,003,09,2012,897795,-5399,4533,-866,9477,7739
09003,003,09,2013,897837,-4749,3266,-1483,9388,7857
09003,003,09,2014,897618,-7297,5392,-1905,9346,7747
09003,003,09,2015,896563,-7748,5098,-2650,9562,8000
09003,003,09,2016,894282,-8259,4446,-3813,9316,7813
09003,003,09,2017,893141,-6747,4511,-2236,9329,8260
09003,003,09,2018,892767,-7464,5936,-1528,9277,8155
09003,003,09,2019,891349,-4940,2678,-2262,9180,8358
09003,003,09,2020,889226,-5105,2671,-2434,9108,8831
09005,005,09,2010,189762,-178,27,-151,418,372
09005,005,09,2011,188979,-795,125,-670,1556,1669
09005,005,09,2012,187591,-1303,176,-1127,1470,1746
09005,005,09,2013,186866,-511,198,-313,1419,1818
09005,005,09,2014,185380,-1415,316,-1099,1424,1819
09005,005,09,2015,184171,-1224,357,-867,1415,1760
09005,005,09,2016,182837,-1242,282,-960,1418,1792
09005,005,09,2017,181719,-975,266,-709,1425,1833
09005,005,09,2018,181151,-419,324,-95,1405,1871
09005,005,09,2019,180396,-473,217,-256,1389,1886
09005,005,09,2020,179610,-378,191,-187,1375,1973
09007,007,09,2010,165624,-112,68,-44,357,346
09007,007,09,2011,166199,191,318,509,1534,1460
09007,007,09,2012,165677,-886,324,-562,1481,1429
09007,007,09,2013,165390,-359,220,-139,1364,1493
09007,007,09,2014,164857,-769,358,-411,1380,1493
09007,007,09,2015,163809,-1224,323,-901,1367,1514
09007,007,09,2016,163403,-499,292,-207,1301,1494
09007,007,09,2017,163058,-261,261,0,1259,1598
09007,007,09,2018,163053,6,329,335,1271,1603
09007,007,09,2019,162538,-409,187,-222,1287,1582
09007,007,09,2020,161657,-675,180,-495,1274,1662
09009,009,09,2010,863398,-66,551,485,2258,1716
09009,009,09,2011,863974,-3997,2880,-1117,9265,7565
09009,009,09,2012,864732,-4469,3766,-703,9047,7579
09009,009,09,2013,863035,-5783,2722,-3061,8912,7584
09009,009,09,2014,863149,-5732,4516,-1216,8985,7679
09009,009,09,2015,860506,-7685,4024,-3661,8802,7830
09009,009,09,2016,858159,-6911,3480,-3431,8842,7769
09009,009,09,2017,857845,-4730,3482,-1248,8749,7822
09009,009,09,2018,856895,-6331,4586,-1745,8597,7828
09009,009,09,2019,853818,-5700,2185,-3515,8513,8098
09009,009,09,2020,851948,-3873,2089,-1784,8397,8512
09011,011,09,2010,274019,-418,251,-167,657,547
09011,011,09,2011,273086,-2316,844,-1472,2765,2235
09011,011,09,2012,274173,-569,1180,611,2862,2332
09011,011,09,2013,273093,-2040,638,-1402,2693,2388
09011,011,09,2014,271593,-2688,827,-1861,2676,2360
09011,011,09,2015,269818,-2825,811,-2014,2676,2462
09011,011,09,2016,268639,-1958,585,-1373,2622,2429
09011,011,09,2017,267829,-1502,588,-914,2636,2533
09011,011,09,2018,267089,-1525,717,-808,2591,2523
09011,011,09,2019,265784,-1582,324,-1258,2458,2510
09011,011,09,2020,264999,-858,376,-482,2455,2768
09013,013,09,2010,153242,383,46,429,338,298
09013,013,09,2011,153066,-643,295,-348,1183,1014
09013,013,09,2012,152005,-1671,373,-1298,1126,948
09013,013,09,2013,151831,-594,287,-307,1127,990
09013,013,09,2014,151766,-704,527,-177,1131,1011
09013,013,09,2015,151815,-637,521,-116,1195,1027
09013,013,09,2016,151223,-1142,445,-697,1106,1008
09013,013,09,2017,151136,-604,411,-193,1204,1098
09013,013,09,2018,150913,-738,472,-266,1135,1095
09013,013,09,2019,150865,-449,371,-78,1158,1130
09013,013,09,2020,150600,-570,297,-273,1156,1151
09015,015,09,2010,118543,87,30,117,291,245
09015,015,09,2011,118329,-680,254,-426,1194,984
09015,015,09,2012,117945,-907,305,-602,1191,987
09015,015,09,2013,117551,-782,208,-574,1180,1005
09015,015,09,2014,116810,-1174,317,-857,1128,1031
09015,015,09,2015,116556,-749,399,-350,1118,1020
09015,015,09,2016,116191,-806,378,-428,1113,1052
09015,015,09,2017,116489,-79,410,331,1050,1076
09015,015,09,2018,117182,114,583,697,1100,1098
09015,015,09,2019,116884,-328,103,-225,1052,1128
09015,015,09,2020,116540,-418,197,-221,1032,1157
10001,001,10,2010,162972,288,75,363,573,326
10001,001,10,2011,165161,1096,255,1351,2210,1373
10001,001,10,2012,167370,1038,357,1395,2188,1382
10001,001,10,2013,169144,748,340,1088,2191,1492
10001,001,10,2014,171600,1373,290,1663,2252,1478
10001,001,10,2015,173308,595,429,1024,2254,1558
10001,001,10,2016,174776,440,319,759,2280,1565
10001,001,10,2017,176754,1242,200,1442,2189,1649
10001,001,10,2018,178954,1615,110,1725,2167,1691
10001,001,10,2019,181492,1905,264,2169,2161,1790
10001,001,10,2020,183643,1746,201,1947,2151,1947
10003,003,10,2010,538792,-591,253,-338,1698,1038
10003,003,10,2011,542031,-344,1168,824,6840,4403
10003,003,10,2012,545053,-116,801,685,6724,4253
10003,003,10,2013,548614,-350,1871,1521,6499,4363
10003,003,10,2014,551124,-1008,1445,437,6478,4308
10003,003,10,2015,553929,-985,1760,775,6580,4498
10003,003,10,2016,555582,-1724,1355,-369,6553,4520
10003,003,10,2017,556491,-1989,1259,-730,6390,4747
10003,003,10,2018,557983,-248,500,252,6326,5072
10003,003,10,2019,559941,-253,969,716,6091,4866
10003,003,10,2020,561531,-146,847,701,6097,5242
10005,005,10,2010,197883,581,72,653,572,472
10005,005,10,2011,200398,2105,252,2357,2250,2096
10005,005,10,2012,203095,2275,194,2469,2243,2061
10005,005,10,2013,206304,2901,293,3194,2203,2231
10005,005,10,2014,210407,3858,166,4024,2254,2285
10005,005,10,2015,214828,4448,213,4661,2189,2487
10005,005,10,2016,219631,4661,160,4821,2383,2421
10005,005,10,2017,224697,5185,255,5440,2251,2655
10005,005,10,2018,230048,5682,60,5742,2267,2674
10005,005,10,2019,235235,5574,214,5788,2299,2884
10005,005,10,2020,241635,7172,169,7341,2268,3179
11001,001,11,2010,605282,1465,757,2222,2242,1181
11001,001,11,2011,620290,7709,2666,10375,9196,4667
11001,001,11,2012,635737,6797,3610,10407,9231,4534
11001,001,11,2013,651559,5972,4980,10952,9448,4813
11001,001,11,2014,663603,1817,5460,7277,9332,4649
11001,001,11,2015,677014,3266,5298,8564,9649,4883
11001,001,11,2016,687576,1969,3710,5679,9695,4852
11001,001,11,2017,697079,1055,3855,4910,9705,5136
11001,001,11,2018,704147,-444,3055,2611,9400,4943
11001,001,11,2019,708253,-2417,2751,334,9194,5417
11001,001,11,2020,712816,-658,2143,1485,9155,6093
12001,001,12,2010,247624,-342,281,-61,697,356
12001,001,12,2011,249879,-54,1251,1197,2824,1764
12001,001,12,2012,251596,-558,976,418,3003,1675
12001,001,12,2013,252585,-1082,1031,-51,2824,1792
12001,001,12,2014,255606,819,1193,2012,2881,1841
12001,001,12,2015,259215,1272,1297,2569,2909,1865
12001,001,12,2016,264127,2500,1454,3954,2802,1855
12001,001,12,2017,266501,84,1393,1477,2883,1976
12001,001,12,2018,269190,918,995,1913,2783,2005
12001,001,12,2019,269489,-1160,791,-369,2742,2084
12001,001,12,2020,271218,585,675,1260,2680,2236
12003,003,12,2010,27067,-57,-1,-58,82,77
12003,003,12,2011,27055,-155,9,-146,362,228
12003,003,12,2012,27059,-120,11,-109,342,226
12003,003,12,2013,27008,-122,7,-115,312,247
12003,003,12,2014,27123,-68,4,-64,393,209
12003,003,12,2015,27357,153,7,160,311,236
12003,003,12,2016,27903,409,9,418,356,229
12003,003,12,2017,28255,249,11,260,348,257
12003,003,12,2018,28381,88,6,94,308,276
12003,003,12,2019,29288,820,6,826,348,263
12003,003,12,2020,29566,194,6,200,359,284
12005,005,12,2010,169209,168,84,252,518,401
12005,005,12,2011,169587,-330,213,-117,2112,1609
12005,005,12,2012,171818,1056,460,1516,2286,1577
12005,005,12,2013,174704,2012,317,2329,2280,1761
12005,005,12,2014,178435,2812,442,3254,2246,1844
12005,005,12,2015,181678,2111,676,2787,2398,1962
12005,005,12,2016,183765,1018,616,1634,2327,1872
12005,005,12,2017,184841,199,523,722,2341,1978
12005,005,12,2018,186555,1016,375,1391,2363,2042
12005,005,12,2019,173895,-12867,225,-12642,2007,1978
12005,005,12,2020,171322,-2627,232,-2395,1894,2065
12007,007,12,2010,28536,22,0,22,83,90
12007,007,12,2011,28430,-159,10,-149,313,269
12007,007,12,2012,27052,-1527,13,-1514,327,269
12007,007,12,2013,26804,-283,2,-281,321,291
12007,007,12,2014,26562,-250,9,-241,300,301
12007,007,12,2015,26759,187,11,198,281,283
12007,007,12,2016,26756,-18,9,-9,299,291
12007,007,12,2017,27158,433,9,442,298,339
12007,007,12,2018,27759,648,10,658,283,346
12007,007,12,2019,28348,598,6,604,286,302
12007,007,12,2020,28593,309,1,310,292,355
12009,009,12,2010,544000,603,260,863,1164,1362
12009,009,12,2011,544442,699,921,1620,5044,6189
12009,009,12,2012,547119,2665,1085,3750,5120,6114
12009,009,12,2013,550478,3884,1027,4911,5008,6542
12009,009,12,2014,555838,5402,1203,6605,5235,6517
12009,009,12,2015,566133,10768,1232,12000,5197,7008
12009,009,12,2016,577380,11603,1340,12943,5331,7065
12009,009,12,2017,588165,11738,1300,13038,5201,7497
12009,009,12,2018,594978,8168,1025,9193,5271,7663
12009,009,12,2019,601024,8257,439,8696,5222,7846
12009,009,12,2020,608459,9874,489,10363,5236,8105
12011,011,12,2010,1752843,388,3158,3546,5070,3742
12011,011,12,2011,1787096,13743,13791,27534,21127,14462
12011,011,12,2012,1814468,8055,12411,20466,21165,14229
12011,011,12,2013,1836869,2813,13155,15968,21156,14409
12011,011,12,2014,1861259,2457,14284,16741,22092,14028
12011,011,12,2015,1885435,105,16963,17068,22157,14778
12011,011,12,2016,1913780,85,20596,20681,22578,14808
12011,011,12,2017,1935945,-5683,20955,15272,22379,15414
12011,011,12,2018,1948058,-10550,15867,5317,22120,15321
12011,011,12,2019,1955475,-12072,13198,1126,21885,15613
12011,011,12,2020,1958105,-12084,10567,-1517,21491,17369
12013,013,12,2010,14657,-2,1,-1,41,14
12013,013,12,2011,14725,92,5,97,134,162
12013,013,12,2012,14673,-68,5,-63,167,156
12013,013,12,2013,14582,-72,4,-68,127,150
12013,013,12,2014,14456,-121,5,-116,149,156
12013,013,12,2015,14412,-18,4,-14,132,163
12013,013,12,2016,14346,-31,18,-13,142,193
12013,013,12,2017,14463,131,17,148,143,175
12013,013,12,2018,14593,181,20,201,129,201
12013,013,12,2019,14140,-417,1,-416,130,167
12013,013,12,2020,14078,-30,7,-23,121,159
12015,015,12,2010,159897,211,58,269,260,579
12015,015,12,2011,159926,1094,222,1316,996,2274
12015,015,12,2012,162840,3730,249,3979,996,2195
12015,015,12,2013,164801,2974,264,3238,1020,2352
12015,015,12,2014,168208,4394,274,4668,1036,2429
12015,015,12,2015,172607,5517,317,5834,1001,2513
12015,015,12,2016,178046,6430,491,6921,1041,2555
12015,015,12,2017,181998,5051,462,5513,1062,2648
12015,015,12,2018,185204,4649,302,4951,1054,2809
12015,015,12,2019,189669,5999,236,6235,984,2724
12015,015,12,2020,194711,7009,200,7209,1002,3117
12017,017,12,2010,141177,284,21,305,243,596
12017,017,12,2011,139782,-224,66,-158,1061,2282
12017,017,12,2012,139215,622,71,693,1065,2306
12017,017,12,2013,138888,1025,69,1094,1011,2436
12017,017,12,2014,138907,1345,58,1403,1035,2430
12017,017,12,2015,140397,2949,66,3015,1022,2580
12017,017,12,2016,142988,3930,95,4025,1059,2508
12017,017,12,2017,145619,4027,83,4110,1029,2520
12017,017,12,2018,147920,3854,46,3900,1102,2704
12017,017,12,2019,150153,3928,11,3939,1032,2720
12017,017,12,2020,153010,4707,22,4729,1029,2865
12019,019,12,2010,191453,290,116,406,520,332
12019,019,12,2011,192335,-175,433,258,2105,1482
12019,019,12,2012,193909,571,434,1005,2086,1487
12019,019,12,2013,195732,1021,295,1316,2064,1531
12019,019,12,2014,198687,2076,331,2407,2107,1562
12019,019,12,2015,202552,2898,474,3372,2185,1705
12019,019,12,2016,207401,3877,438,4315,2211,1682
12019,019,12,2017,212381,4174,409,4583,2163,1773
12019,019,12,2018,215902,2909,329,3238,2190,1905
12019,019,12,2019,219014,2658,139,2797,2238,1913
12019,019,12,2020,221770,2498,162,2660,2211,2104
12021,021,12,2010,322576,571,486,1057,781,751
12021,021,12,2011,327670,2771,1901,4672,3282,2854
12021,021,12,2012,332330,2730,1714,4444,3191,2972
12021,021,12,2013,339133,4621,1912,6533,3142,2926
12021,021,12,2014,347401,6036,1829,7865,3239,2978
12021,021,12,2015,356288,6222,2497,8719,3249,3136
12021,021,12,2016,365894,6234,3212,9446,3326,3179
12021,021,12,2017,373286,4406,3200,7606,3218,3420
12021,021,12,2018,378657,3442,2258,5700,3217,3520
12021,021,12,2019,385917,5782,2041,7823,3151,3679
12021,021,12,2020,392973,6617,1594,8211,3163,4286
12023,023,12,2010,67558,49,8,57,193,212
12023,023,12,2011,67326,-291,37,-254,769,745
12023,023,12,2012,67903,484,26,510,783,728
12023,023,12,2013,67444,-501,29,-472,781,768
12023,023,12,2014,67821,340,16,356,831,803
12023,023,12,2015,68277,301,54,355,853,749
12023,023,12,2016,69300,953,60,1013,793,785
12023,023,12,2017,70051,621,62,683,834,766
12023,023,12,2018,70719,676,53,729,801,862
12023,023,12,2019,71766,1109,24,1133,788,875
12023,023,12,2020,72654,1003,26,1029,789,926
12027,027,12,2010,34935,16,14,30,101,53
12027,027,12,2011,34847,-373,171,-202,424,310
12027,027,12,2012,35003,-59,115,56,382,278
12027,027,12,2013,34903,-232,77,-155,357,300
12027,027,12,2014,35333,254,89,343,380,294
12027,027,12,2015,35644,46,221,267,372,324
12027,027,12,2016,36228,271,228,499,384,298
12027,027,12,2017,37159,754,182,936,378,386
12027,027,12,2018,37128,-120,126,6,353,390
12027,027,12,2019,37821,509,114,623,424,354
12027,027,12,2020,38520,566,103,669,403,371
12029,029,12,2010,16399,-8,2,-6,36,50
12029,029,12,2011,16403,51,6,57,156,209
12029,029,12,2012,16152,-201,2,-199,130,187
12029,029,12,2013,16084,-41,2,-39,179,204
12029,029,12,2014,16041,40,-3,37,167,244
12029,029,12,2015,16352,386,-2,384,144,223
12029,029,12,2016,16455,178,-3,175,145,217
12029,029,12,2017,16609,226,-2,224,155,226
12029,029,12,2018,16692,177,-2,175,150,243
12029,029,12,2019,16887,257,-2,255,152,211
12029,029,12,2020,17057,255,-2,253,153,235
12031,031,12,2010,865653,-440,664,224,3024,1747
12031,031,12,2011,872483,-1349,2655,1306,12575,7030
12031,031,12,2012,880349,-354,3253,2899,12392,7271
12031,031,12,2013,886277,-1621,2940,1319,12307,7552
12031,031,12,2014,897094,2727,3114,5841,12665,7661
12031,031,12,2015,911106,5135,3831,8966,12822,7802
12031,031,12,2016,927038,6049,4501,10550,13266,7910
12031,031,12,2017,939167,3022,4270,7292,13096,8259
12031,031,12,2018,950469,3843,3088,6931,13111,8759
12031,031,12,2019,959853,3059,2289,5348,13053,9044
12031,031,12,2020,966728,1552,1978,3530,12932,9624
12033,033,12,2010,298069,-24,243,219,1000,751
12033,033,12,2011,299478,202,403,605,3818,3008
12033,033,12,2012,303556,1803,1316,3119,3943,3024
12033,033,12,2013,306879,1907,780,2687,3836,3235
12033,033,12,2014,308200,-95,723,628,3838,3082
12033,033,12,2015,309630,28,926,954,3855,3338
12033,033,12,2016,311975,937,794,1731,3958,3332
12033,033,12,2017,313882,636,579,1215,3981,3280
12033,033,12,2018,315857,1542,175,1717,3809,3559
12033,033,12,2019,319379,3076,322,3398,3849,3732
12033,033,12,2020,322364,2836,258,3094,3812,3925
12035,035,12,2010,96065,322,41,363,226,226
12035,035,12,2011,97473,1416,221,1637,804,1037
12035,035,12,2012,98461,1039,171,1210,874,1108
12035,035,12,2013,99845,1642,191,1833,750,1228
12035,035,12,2014,101961,2319,115,2434,800,1186
12035,035,12,2015,104533,2750,180,2930,815,1207
12035,035,12,2016,107608,3279,272,3551,798,1289
12035,035,12,2017,110316,2912,280,3192,818,1314
12035,035,12,2018,112415,2418,239,2657,784,1345
12035,035,12,2019,115481,3643,85,3728,848,1498
12035,035,12,2020,118451,3612,100,3712,840,1560
12037,037,12,2010,11523,-6,5,-1,27,53
12037,037,12,2011,11471,-33,5,-28,105,127
12037,037,12,2012,11609,140,9,149,103,119
12037,037,12,2013,11520,-69,7,-62,105,132
12037,037,12,2014,11656,139,16,155,105,129
12037,037,12,2015,11702,58,13,71,109,134
12037,037,12,2016,11834,153,8,161,106,136
12037,037,12,2017,11730,-65,7,-58,85,129
12037,037,12,2018,11694,-19,5,-14,102,124
12037,037,12,2019,12113,455,5,460,93,134
12037,037,12,2020,12201,139,4,143,88,141
12039,039,12,2010,47792,-48,19,-29,157,70
12039,039,12,2011,47372,-646,78,-568,594,448
12039,039,12,2012,46571,-1013,43,-970,582,447
12039,039,12,2013,46084,-597,64,-533,534,498
12039,039,12,2014,46113,-83,23,-60,540,448
12039,039,12,2015,46057,-194,49,-145,560,467
12039,039,12,2016,46069,-126,65,-61,555,481
12039,039,12,2017,45984,-228,61,-167,546,463
12039,039,12,2018,45933,-171,42,-129,546,467
12039,039,12,2019,45670,-300,34,-266,509,506
12039,039,12,2020,45277,-369,26,-343,492,540
12041,041,12,2010,17006,30,2,32,50,18
12041,041,12,2011,17002,-27,10,-17,179,166
12041,041,12,2012,16908,-107,7,-100,189,183
12041,041,12,2013,16972,34,6,40,218,194
12041,041,12,2014,17007,51,2,53,171,187
12041,041,12,2015,17394,379,7,386,195,196
12041,041,12,2016,17607,213,7,220,172,180
12041,041,12,2017,17899,266,7,273,205,187
12041,041,12,2018,18263,398,7,405,185,227
12041,041,12,2019,18572,316,3,319,195,205
12041,041,12,2020,18885,329,4,333,191,210
12043,043,12,2010,12877,-40,16,-24,18,8
12043,043,12,2011,12842,-69,72,3,71,108
12043,043,12,2012,12676,-172,36,-136,73,106
12043,043,12,2013,12680,35,17,52,67,115
12043,043,12,2014,12956,287,15,302,64,95
12043,043,12,2015,13115,191,25,216,69,128
12043,043,12,2016,13421,320,30,350,72,118
12043,043,12,2017,13591,192,33,225,61,119
12043,043,12,2018,13762,208,24,232,66,126
12043,043,12,2019,13914,194,18,212,57,117
12043,043,12,2020,14198,356,15,371,61,147
12045,045,12,2010,15826,-49,1,-48,26,17
12045,045,12,2011,15767,-33,2,-31,127,155
12045,045,12,2012,15769,35,6,41,131,170
12045,045,12,2013,15887,192,7,199,118,204
12045,045,12,2014,16011,146,6,152,132,163
12045,045,12,2015,15944,-4,7,3,112,183
12045,045,12,2016,16082,192,3,195,128,184
12045,045,12,2017,16115,99,3,102,117,186
12045,045,12,2018,16137,98,5,103,115,195
12045,045,12,2019,13498,-2579,-1,-2580,118,180
12045,045,12,2020,13534,117,1,118,115,196
12047,047,12,2010,14686,-154,1,-153,41,13
12047,047,12,2011,14596,-157,12,-145,180,125
12047,047,12,2012,14726,103,11,114,148,137
12047,047,12,2013,14344,-414,7,-407,136,124
12047,047,12,2014,14071,-292,6,-286,157,156
12047,047,12,2015,14275,188,9,197,154,151
12047,047,12,2016,14309,6,17,23,150,138
12047,047,12,2017,14397,41,21,62,176,148
12047,047,12,2018,14289,-111,15,-96,164,175
12047,047,12,2019,14470,144,11,155,159,134
12047,047,12,2020,14521,16,12,28,167,146
12049,049,12,2010,27731,-46,24,-22,88,73
12049,049,12,2011,27681,-379,121,-258,406,199
12049,049,12,2012,27433,-559,83,-476,409,195
12049,049,12,2013,27307,-352,44,-308,382,208
12049,049,12,2014,27259,-246,-14,-260,394,183
12049,049,12,2015,27167,-277,19,-258,402,237
12049,049,12,2016,27228,-152,32,-120,395,213
12049,049,12,2017,27172,-231,28,-203,373,228
12049,049,12,2018,27106,-233,41,-192,356,231
12049,049,12,2019,26806,-413,-16,-429,326,196
12049,049,12,2020,26822,-90,0,-90,330,225
12051,051,12,2010,39005,-254,40,-214,156,99
12051,051,12,2011,38968,-599,218,-381,618,277
12051,051,12,2012,37864,-1655,148,-1507,574,249
12051,051,12,2013,37802,-596,174,-422,602,253
12051,051,12,2014,38467,223,184,407,553,298
12051,051,12,2015,39242,58,415,473,579,275
12051,051,12,2016,40097,-82,629,547,620,310
12051,051,12,2017,41074,231,485,716,563,300
12051,051,12,2018,41306,-386,377,-9,580,339
12051,051,12,2019,42069,132,332,464,612,313
12051,051,12,2020,42813,245,268,513,593,363
12053,053,12,2010,172978,408,50,458,370,634
12053,053,12,2011,172877,721,152,873,1520,2482
12053,053,12,2012,172777,821,109,930,1439,2467
12053,053,12,2013,173721,1879,117,1996,1437,2513
12053,053,12,2014,175411,2315,247,2562,1500,2415
12053,053,12,2015,178036,3326,300,3626,1518,2550
12053,053,12,2016,182668,5242,356,5598,1623,2606
12053,053,12,2017,186899,5098,347,5445,1577,2814
12053,053,12,2018,190851,4878,391,5269,1566,2893
12053,053,12,2019,194290,4665,55,4720,1607,2871
12053,053,12,2020,198792,5911,127,6038,1607,3098
12055,055,12,2010,98637,35,33,68,217,413
12055,055,12,2011,98493,129,216,345,914,1393
12055,055,12,2012,98244,108,209,317,901,1443
12055,055,12,2013,98118,274,218,492,881,1488
12055,055,12,2014,98636,665,385,1050,896,1428
12055,055,12,2015,100204,1607,467,2074,939,1458
12055,055,12,2016,102058,1928,491,2419,921,1488
12055,055,12,2017,103828,2012,488,2500,910,1641
12055,055,12,2018,104453,1041,421,1462,877,1710
12055,055,12,2019,105890,1994,234,2228,829,1606
12055,055,12,2020,106639,1485,244,1729,835,1807
12057,057,12,2010,1233511,1238,1423,2661,3763,2142
12057,057,12,2011,1255639,7934,6736,14670,16539,9110
12057,057,12,2012,1279861,10008,6850,16858,16447,9256
12057,057,12,2013,1304474,11158,6780,17938,16410,9909
12057,057,12,2014,1332742,13333,7513,20846,16780,9629
12057,057,12,2015,1364645,15413,9452,24865,17288,10379
12057,057,12,2016,1398093,14940,11543,26483,17473,10548
12057,057,12,2017,1428960,12083,11801,23884,17265,10332
12057,057,12,2018,1455351,9711,10226,19937,17446,11042
12057,057,12,2019,1476431,9536,5781,15317,17090,11373
12057,057,12,2020,1497957,11559,5483,17042,17169,12718
12059,059,12,2010,19844,-46,1,-45,49,84
12059,059,12,2011,19841,51,8,59,201,262
12059,059,12,2012,19704,-92,4,-88,190,236
12059,059,12,2013,19604,-24,1,-23,191,266
12059,059,12,2014,19578,48,-2,46,184,250
12059,059,12,2015,19292,-247,0,-247,208,249
12059,059,12,2016,19426,177,4,181,209,256
12059,059,12,2017,19458,107,8,115,184,267
12059,059,12,2018,19512,100,11,111,221,275
12059,059,12,2019,19661,252,-2,250,187,288
12059,059,12,2020,19594,15,3,18,192,277
12061,061,12,2010,138277,308,38,346,315,409
12061,061,12,2011,139122,1046,233,1279,1317,1745
12061,061,12,2012,140515,1626,217,1843,1245,1716
12061,061,12,2013,141961,1812,260,2072,1222,1847
12061,061,12,2014,144532,2868,269,3137,1264,1893
12061,061,12,2015,147547,3488,325,3813,1232,2064
12061,061,12,2016,151281,4102,319,4421,1286,1990
12061,061,12,2017,154260,3448,277,3725,1233,1991
12061,061,12,2018,157023,3403,155,3558,1275,2070
12061,061,12,2019,159739,3522,140,3662,1303,2231
12061,061,12,2020,162518,3815,119,3934,1277,2416
12063,063,12,2010,49651,-142,1,-141,122,98
12063,063,12,2011,49204,-391,21,-370,461,539
12063,063,12,2012,49111,-43,15,-28,488,551
12063,063,12,2013,48885,-225,36,-189,505,541
12063,063,12,2014,48737,-110,47,-63,499,577
12063,063,12,2015,48617,-80,39,-41,516,591
12063,063,12,2016,48325,-224,44,-180,526,637
12063,063,12,2017,48288,88,38,126,486,646
12063,063,12,2018,48089,-114,31,-83,540,654
12063,063,12,2019,46257,-1664,21,-1643,469,661
12063,063,12,2020,46085,7,20,27,468,668
12065,065,12,2010,14754,-23,0,-23,30,15
12065,065,12,2011,14527,-184,1,-183,129,173
12065,065,12,2012,14218,-288,-3,-291,125,151
12065,065,12,2013,14212,6,-1,5,145,158
12065,065,12,2014,14061,-128,1,-127,129,153
12065,065,12,2015,14121,77,7,84,128,153
12065,065,12,2016,13985,-122,36,-86,119,167
12065,065,12,2017,14226,248,38,286,131,179
12065,065,12,2018,14358,145,31,176,127,172
12065,065,12,2019,14280,-66,30,-36,115,157
12065,065,12,2020,14543,297,29,326,110,170
12067,067,12,2010,8809,-70,2,-68,23,22
12067,067,12,2011,8801,-21,16,-5,79,83
12067,067,12,2012,8791,-11,1,-10,81,81
12067,067,12,2013,8819,7,7,14,81,68
12067,067,12,2014,8860,7,29,36,79,71
12067,067,12,2015,8722,-195,52,-143,64,63
12067,067,12,2016,8760,-17,60,43,69,74
12067,067,12,2017,8603,-208,59,-149,64,76
12067,067,12,2018,8649,-5,87,82,61,96
12067,067,12,2019,8384,-252,-2,-254,59,71
12067,067,12,2020,8482,104,19,123,57,82
12069,069,12,2010,297724,630,123,753,733,813
12069,069,12,2011,300547,2595,616,3211,3017,3400
12069,069,12,2012,303806,2916,549,3465,3000,3253
12069,069,12,2013,308088,4091,678,4769,3095,3653
12069,069,12,2014,315493,6989,659,7648,3127,3575
12069,069,12,2015,325338,9664,864,10528,3159,3973
12069,069,12,2016,335209,9542,1087,10629,3195,3995
12069,069,12,2017,345848,10429,1101,11530,3281,4229
12069,069,12,2018,357086,11224,1142,12366,3310,4471
12069,069,12,2019,366941,10704,292,10996,3441,4550
12069,069,12,2020,375492,9677,445,10122,3456,4968
12071,071,12,2010,620481,1082,570,1652,1534,1464
12071,071,12,2011,631198,7912,2583,10495,6270,6064
12071,071,12,2012,644451,10321,2288,12609,6398,6049
12071,071,12,2013,660197,13002,2294,15296,6362,6181
12071,071,12,2014,677710,14602,2471,17073,6363,6344
12071,071,12,2015,700243,18836,3426,22262,6635,6628
12071,071,12,2016,723467,19245,4136,23381,6679,6926
12071,071,12,2017,741188,14043,4196,18239,6637,7216
12071,071,12,2018,755159,11251,3295,14546,6850,7440
12071,071,12,2019,772268,15669,2324,17993,6894,7724
12071,071,12,2020,790767,18519,1985,20504,6919,8819
12073,073,12,2010,275981,-24,152,128,749,349
12073,073,12,2011,278420,402,637,1039,3056,1656
12073,073,12,2012,283707,3159,664,3823,2988,1669
12073,073,12,2013,282006,-3617,637,-2980,3036,1864
12073,073,12,2014,283923,-33,682,649,3036,1703
12073,073,12,2015,286098,248,709,957,3077,1823
12073,073,12,2016,286960,-1201,775,-426,3041,1759
12073,073,12,2017,291125,2233,756,2989,3067,1903
12073,073,12,2018,291905,-795,528,-267,3030,1989
12073,073,12,2019,293866,683,383,1066,2933,2045
12073,073,12,2020,295460,484,342,826,2919,2175
12075,075,12,2010,40727,-55,12,-43,112,144
12075,075,12,2011,40165,-453,36,-417,391,536
12075,075,12,2012,39835,-235,22,-213,391,509
12075,075,12,2013,39449,-241,9,-232,372,524
12075,075,12,2014,39317,-45,11,-34,403,491
12075,075,12,2015,39630,437,28,465,402,558
12075,075,12,2016,39885,369,43,412,392,547
12075,075,12,2017,40339,603,44,647,369,564
12075,075,12,2018,40839,578,52,630,436,566
12075,075,12,2019,41620,871,8,879,438,534
12075,075,12,2020,42214,756,15,771,431,604
12077,077,12,2010,8352,-26,-1,-27,18,6
12077,077,12,2011,8266,-90,-4,-94,80,73
12077,077,12,2012,8304,31,-1,30,76,68
12077,077,12,2013,8360,44,-3,41,69,55
12077,077,12,2014,8419,28,-2,26,90,61
12077,077,12,2015,8412,-18,1,-17,86,76
12077,077,12,2016,8307,-119,-4,-123,80,62
12077,077,12,2017,8234,-95,-4,-99,83,59
12077,077,12,2018,8421,200,-3,197,71,82
12077,077,12,2019,8341,-65,-7,-72,64,72
12077,077,12,2020,8364,33,-5,28,66,71
12079,079,12,2010,19251,16,-1,15,35,25
12079,079,12,2011,19134,-128,6,-122,223,219
12079,079,12,2012,18973,-180,4,-176,219,205
12079,079,12,2013,18757,-197,11,-186,211,245
12079,079,12,2014,18607,-116,12,-104,198,240
12079,079,12,2015,18485,-119,32,-87,205,239
12079,079,12,2016,18342,-165,52,-113,210,240
12079,079,12,2017,18512,153,54,207,185,223
12079,079,12,2018,18623,98,41,139,177,205
12079,079,12,2019,18599,-1,29,28,194,246
12079,079,12,2020,18707,132,27,159,198,248
12081,081,12,2010,323442,421,219,640,780,848
12081,081,12,2011,327619,3288,1012,4300,3321,3445
12081,081,12,2012,333965,5300,962,6262,3438,3508
12081,081,12,2013,342024,6999,919,7918,3368,3391
12081,081,12,2014,351080,8043,890,8933,3416,3549
12081,081,12,2015,362821,10516,1330,11846,3578,3835
12081,081,12,2016,375538,11776,1347,13123,3479,3947
12081,081,12,2017,385458,9213,1266,10479,3462,4070
12081,081,12,2018,394043,8354,866,9220,3457,4112
12081,081,12,2019,402977,9286,607,9893,3467,4399
12081,081,12,2020,411219,9099,528,9627,3496,4839
12083,083,12,2010,331341,207,114,321,763,999
12083,083,12,2011,332325,1520,473,1993,3353,4348
12083,083,12,2012,333945,2200,445,2645,3389,4424
12083,083,12,2013,335196,2180,471,2651,3258,4650
12083,083,12,2014,338165,3731,515,4246,3381,4710
12083,083,12,2015,342388,4996,509,5505,3476,4791
12083,083,12,2016,347958,6119,758,6877,3596,4911
12083,083,12,2017,353953,6913,761,7674,3426,5120
12083,083,12,2018,359630,6578,857,7435,3467,5231
12083,083,12,2019,365997,8211,88,8299,3558,5460
12083,083,12,2020,373513,9397,250,9647,3532,5608
12085,085,12,2010,146912,182,50,232,297,452
12085,085,12,2011,147904,1225,245,1470,1202,1675
12085,085,12,2012,149032,1537,128,1665,1133,1682
12085,085,12,2013,151197,2595,135,2730,1195,1811
12085,085,12,2014,153218,2456,181,2637,1199,1863
12085,085,12,2015,155674,2892,202,3094,1258,1919
12085,085,12,2016,158425,3189,190,3379,1287,1920
12085,085,12,2017,159716,1829,166,1995,1246,1948
12085,085,12,2018,160661,1564,141,1705,1264,2014
12085,085,12,2019,161212,1266,12,1278,1241,1957
12085,085,12,2020,162088,1818,49,1867,1230,2210
12086,086,12,2010,2506986,-2176,8397,6221,7277,4325
12086,086,12,2011,2544511,-11693,36343,24650,31318,18417
12086,086,12,2012,2576473,-16068,35150,19082,31133,18170
12086,086,12,2013,2609570,-17028,38264,21236,30755,18788
12086,086,12,2014,2634056,-28178,39390,11212,31516,18528
12086,086,12,2015,2659549,-31639,44052,12413,32081,19237
12086,086,12,2016,2689890,-33636,50940,17304,32944,20000
12086,086,12,2017,2709126,-46547,53735,7188,32089,20247
12086,086,12,2018,2709711,-50977,40353,-10624,31573,20538
12086,086,12,2019,2711612,-44841,36756,-8085,30467,20440
12086,086,12,2020,2707303,-39667,28593,-11074,30086,23189
12087,087,12,2010,73226,28,87,115,154,127
12087,087,12,2011,73988,410,307,717,720,678
12087,087,12,2012,74596,165,368,533,717,635
12087,087,12,2013,75878,765,435,1200,706,658
12087,087,12,2014,76353,7,365,372,771,666
12087,087,12,2015,76758,-12,411,399,747,739
12087,087,12,2016,76968,-183,415,232,756,776
12087,087,12,2017,76556,-793,426,-367,714,756
12087,087,12,2018,74362,-2430,262,-2168,724,756
12087,087,12,2019,73897,-730,251,-479,684,666
12087,087,12,2020,73900,-113,210,97,675,771
12089,089,12,2010,73526,138,12,150,189,127
12089,089,12,2011,74166,532,37,569,778,707
12089,089,12,2012,74546,247,73,320,732,661
12089,089,12,2013,75428,833,2,835,766,732
12089,089,12,2014,76309,830,24,854,742,728
12089,089,12,2015,78022,1684,62,1746,745,797
12089,089,12,2016,80168,2020,55,2075,841,778
12089,089,12,2017,83024,2889,53,2942,779,880
12089,089,12,2018,85923,2929,54,2983,886,980
12089,089,12,2019,88583,2771,-6,2765,842,938
12089,089,12,2020,91113,2745,14,2759,859,1074
12091,091,12,2010,180725,-619,196,-423,611,315
12091,091,12,2011,183205,1168,211,1379,2609,1511
12091,091,12,2012,189957,4514,906,5420,2672,1501
12091,091,12,2013,192969,1504,512,2016,2594,1618
12091,091,12,2014,195074,445,504,949,2784,1600
12091,091,12,2015,198310,1442,707,2149,2880,1804
12091,091,12,2016,200912,1021,604,1625,2794,1817
12091,091,12,2017,204275,2028,405,2433,2719,1802
12091,091,12,2018,207731,2417,135,2552,2765,1869
12091,091,12,2019,211411,2810,147,2957,2676,1956
12091,091,12,2020,212820,594,158,752,2733,2085
12093,093,12,2010,40014,-20,7,-13,126,80
12093,093,12,2011,39854,-353,63,-290,548,419
12093,093,12,2012,39693,-369,60,-309,537,390
12093,093,12,2013,39464,-368,38,-330,502,405
12093,093,12,2014,39550,-94,43,-51,565,419
12093,093,12,2015,39833,106,95,201,514,427
12093,093,12,2016,40767,746,114,860,522,451
12093,093,12,2017,41248,338,105,443,516,479
12093,093,12,2018,41601,223,66,289,546,481
12093,093,12,2019,42141,430,56,486,525,470
12093,093,12,2020,42297,77,46,123,529,498
12095,095,12,2010,1148590,-1159,1729,570,3653,1553
12095,095,12,2011,1170699,4392,9476,13868,15063,6829
12095,095,12,2012,1202716,13472,9300,22772,15655,6837
12095,095,12,2013,1227761,6573,9886,16459,15787,7199
12095,095,12,2014,1257031,8221,12161,20382,16083,7246
12095,095,12,2015,1291844,11268,14575,25843,16383,7499
12095,095,12,2016,1327775,9759,17253,27012,16737,7846
12095,095,12,2017,1357720,3101,18208,21309,16738,8098
12095,095,12,2018,1383657,-731,18132,17401,16995,8443
12095,095,12,2019,1395371,-3981,7680,3699,16774,8800
12095,095,12,2020,1404396,-6553,8377,1824,16684,9545
12097,097,12,2010,269841,137,603,740,889,444
12097,097,12,2011,278669,3253,3504,6757,3752,1693
12097,097,12,2012,288932,4470,3644,8114,3785,1731
12097,097,12,2013,299322,4530,3772,8302,3878,1870
12097,097,12,2014,311150,4723,4871,9594,4080,1939
12097,097,12,2015,323860,5032,5503,10535,4173,2047
12097,097,12,2016,338182,6203,5936,12139,4266,2107
12097,097,12,2017,353306,6527,6453,12980,4356,2241
12097,097,12,2018,367359,3989,8082,12071,4467,2494
12097,097,12,2019,374170,3762,1203,4965,4407,2564
12097,097,12,2020,385315,6807,2594,9401,4493,2723
12099,099,12,2010,1323631,1982,1473,3455,3335,3264
12099,099,12,2011,1336875,5397,7293,12690,13662,13049
12099,099,12,2012,1355149,10234,6996,17230,14029,13064
12099,099,12,2013,1376782,13006,8073,21079,14021,13583
12099,099,12,2014,1399064,12866,8449,21315,14335,13491
12099,099,12,2015,1424772,15505,10042,25547,14565,14465
12099,099,12,2016,1451469,14292,11898,26190,15033,14511
12099,099,12,2017,1470583,6845,12004,18849,15014,14673
12099,099,12,2018,1482833,3335,8969,12304,15046,15006
12099,099,12,2019,1497800,7790,7544,15334,14907,15232
12099,099,12,2020,1507600,5715,5962,11677,14865,16781
12101,101,12,2010,465516,755,161,916,1121,1229
12101,101,12,2011,466529,968,842,1810,4774,5548
12101,101,12,2012,469755,3235,731,3966,4694,5437
12101,101,12,2013,474501,4896,697,5593,4799,5709
12101,101,12,2014,483590,8810,797,9607,4834,5566
12101,101,12,2015,495130,11386,994,12380,4944,5916
12101,101,12,2016,510319,14733,1260,15993,5147,6018
12101,101,12,2017,525533,14882,1257,16139,5054,6043
12101,101,12,2018,539129,13762,1023,14785,5181,6403
12101,101,12,2019,554032,16107,473,16580,5070,6698
12101,101,12,2020,570412,17889,495,18384,5194,7082
12103,103,12,2010,916428,139,392,531,1924,2683
12103,103,12,2011,918574,2923,2148,5071,8497,11390
12103,103,12,2012,921863,4065,2030,6095,8287,11029
12103,103,12,2013,928755,7651,2242,9893,8404,11524
12103,103,12,2014,936862,8314,2345,10659,8667,11363
12103,103,12,2015,947664,11404,2496,13900,8665,11874
12103,103,12,2016,960527,12919,2882,15801,8628,11608
12103,103,12,2017,968886,9159,2818,11977,8273,11926
12103,103,12,2018,973343,6459,1933,8392,8280,12215
12103,103,12,2019,975367,5391,1306,6697,7967,12615
12103,103,12,2020,976802,6206,1146,7352,7928,13821
12105,105,12,2010,603119,188,455,643,1753,1298
12105,105,12,2011,610026,3050,2651,5701,7174,5960
12105,105,12,2012,615581,1795,2419,4214,7249,5818
12105,105,12,2013,622808,4021,2143,6164,7241,6154
12105,105,12,2014,634624,7774,2533,10307,7486,6130
12105,105,12,2015,648823,10413,2756,13169,7523,6590
12105,105,12,2016,666271,13357,3109,16466,7701,6769
12105,105,12,2017,685790,15205,3259,18464,7812,6827
12105,105,12,2018,707095,16659,3795,20454,7880,7090
12105,105,12,2019,724967,16902,517,17419,8010,7516
12105,105,12,2020,744552,18329,1207,19536,8169,8009
12107,107,12,2010,74223,-115,7,-108,214,256
12107,107,12,2011,73657,-502,7,-495,902,972
12107,107,12,2012,72936,-687,14,-673,824,874
12107,107,12,2013,72380,-408,14,-394,794,948
12107,107,12,2014,71987,-264,16,-248,822,949
12107,107,12,2015,71961,101,24,125,834,976
12107,107,12,2016,72410,548,26,574,841,964
12107,107,12,2017,73418,1147,24,1171,856,1019
12107,107,12,2018,73968,740,28,768,815,1035
12107,107,12,2019,74309,614,-16,598,828,1084
12107,107,12,2020,74815,765,-5,760,814,1064
12109,109,12,2010,191268,1015,28,1043,430,310
12109,109,12,2011,196165,4433,105,4538,1850,1515
12109,109,12,2012,202164,5319,180,5499,1812,1478
12109,109,12,2013,209579,6729,252,6981,1970,1686
12109,109,12,2014,218009,7667,200,7867,2041,1697
12109,109,12,2015,226582,7863,273,8136,2164,1828
12109,109,12,2016,235192,7955,375,8330,2194,1943
12109,109,12,2017,244067,8426,344,8770,2072,1996
12109,109,12,2018,254007,9512,274,9786,2210,2065
12109,109,12,2019,265068,10926,63,10989,2222,2109
12109,109,12,2020,278715,13690,100,13790,2282,2330
12111,111,12,2010,278290,726,182,908,719,619
12111,111,12,2011,280481,1174,654,1828,3079,2704
12111,111,12,2012,283042,1728,630,2358,3049,2824
12111,111,12,2013,285437,1665,660,2325,2910,2827
12111,111,12,2014,290207,3813,819,4632,2991,2935
12111,111,12,2015,297471,6366,972,7338,2976,3129
12111,111,12,2016,305775,7172,1086,8258,3100,3085
12111,111,12,2017,313207,6586,1040,7626,3012,3226
12111,111,12,2018,320340,6580,786,7366,3103,3348
12111,111,12,2019,328063,7707,508,8215,3079,3544
12111,111,12,2020,337186,9494,438,9932,3152,3913
12113,113,12,2010,152924,1184,65,1249,451,277
12113,113,12,2011,155796,2243,56,2299,1793,1235
12113,113,12,2012,158285,1576,332,1908,1845,1288
12113,113,12,2013,160519,1463,151,1614,1855,1243
12113,113,12,2014,162840,1629,103,1732,1837,1255
12113,113,12,2015,166451,2887,212,3099,1823,1342
12113,113,12,2016,170224,3032,155,3187,1957,1379
12113,113,12,2017,174413,3716,68,3784,1895,1501
12113,113,12,2018,179573,4856,-39,4817,1980,1654
12113,113,12,2019,184587,4760,-12,4748,1938,1663
12113,113,12,2020,189139,4474,-6,4468,1967,1855
12115,115,12,2010,379942,868,148,1016,690,1186
12115,115,12,2011,382298,3766,718,4484,2833,4951
12115,115,12,2012,386585,5631,579,6210,2970,5014
12115,115,12,2013,390153,5220,663,5883,2806,5160
12115,115,12,2014,396636,7666,874,8540,2882,5132
12115,115,12,2015,405099,9748,1086,10834,2967,5448
12115,115,12,2016,413395,9501,1339,10840,2967,5534
12115,115,12,2017,420073,8280,1321,9601,2790,5721
12115,115,12,2018,426890,8873,853,9726,2873,5772
12115,115,12,2019,435006,10687,709,11396,2891,6112
12115,115,12,2020,443465,11804,561,12365,2895,6732
12117,117,12,2010,423072,-200,259,59,1077,772
12117,117,12,2011,426382,657,1039,1696,4464,2840
12117,117,12,2012,430626,1764,1054,2818,4388,2879
12117,117,12,2013,435640,2258,1370,3628,4468,3049
12117,117,12,2014,441583,2951,1704,4655,4446,3123
12117,117,12,2015,448535,3701,1999,5700,4578,3315
12117,117,12,2016,456266,3974,2406,6380,4695,3334
12117,117,12,2017,463052,3221,2482,5703,4654,3550
12117,117,12,2018,468195,1653,2406,4059,4736,3635
12117,117,12,2019,471791,1651,859,2510,4692,3613
12117,117,12,2020,474171,624,1053,1677,4654,3972
12119,119,12,2010,94286,982,-3,979,103,280
12119,119,12,2011,98011,4444,24,4468,440,1209
12119,119,12,2012,101727,4435,3,4438,438,1304
12119,119,12,2013,106980,6065,10,6075,454,1373
12119,119,12,2014,112354,6146,-2,6144,465,1434
12119,119,12,2015,117229,5838,31,5869,522,1601
12119,119,12,2016,122249,6222,71,6293,485,1788
12119,119,12,2017,125298,4388,66,4454,473,1888
12119,119,12,2018,129351,5527,66,5593,437,1979
12119,119,12,2019,133772,6073,-24,6049,482,2073
12119,119,12,2020,139018,7085,2,7087,469,2269
12121,121,12,2010,42329,620,16,636,121,69
12121,121,12,2011,43365,1032,40,1072,482,526
12121,121,12,2012,43533,194,28,222,476,533
12121,121,12,2013,43578,120,10,130,471,553
12121,121,12,2014,43777,283,2,285,462,547
12121,121,12,2015,43670,18,9,27,440,567
12121,121,12,2016,43849,239,13,252,479,551
12121,121,12,2017,44125,431,14,445,433,600
12121,121,12,2018,44206,194,11,205,454,574
12121,121,12,2019,44420,335,0,335,456,576
12121,121,12,2020,44851,592,0,592,458,617
12123,123,12,2010,22594,-3,4,1,59,35
12123,123,12,2011,22666,18,17,35,255,219
12123,123,12,2012,22760,53,17,70,251,230
12123,123,12,2013,22880,121,16,137,224,240
12123,123,12,2014,22591,-335,20,-315,239,222
12123,123,12,2015,22362,-174,9,-165,222,286
12123,123,12,2016,22098,-266,10,-256,243,253
12123,123,12,2017,21784,-301,12,-289,233,260
12123,123,12,2018,21525,-226,11,-215,229,274
12123,123,12,2019,21537,25,2,27,233,249
12123,123,12,2020,21600,87,4,91,234,262
12125,125,12,2010,15551,-10,3,-7,43,23
12125,125,12,2011,15308,-233,14,-219,172,197
12125,125,12,2012,15266,-59,12,-47,165,159
12125,125,12,2013,15165,-81,17,-64,182,217
12125,125,12,2014,15260,119,9,128,184,217
12125,125,12,2015,15268,106,6,112,144,249
12125,125,12,2016,15256,63,7,70,161,242
12125,125,12,2017,15455,294,5,299,132,233
12125,125,12,2018,15302,-60,5,-55,155,253
12125,125,12,2019,15213,-6,0,-6,160,244
12125,125,12,2020,15182,60,2,62,163,257
12127,127,12,2010,494462,153,168,321,1167,1552
12127,127,12,2011,494558,754,915,1669,4591,6136
12127,127,12,2012,496711,2784,893,3677,4685,6191
12127,127,12,2013,500702,4564,1088,5652,4681,6393
12127,127,12,2014,507050,6786,1237,8023,4757,6575
12127,127,12,2015,517144,10661,1303,11964,4842,6839
12127,127,12,2016,529100,12122,1613,13735,4997,6833
12127,127,12,2017,538755,10181,1702,11883,4957,7227
12127,127,12,2018,547117,9182,1747,10929,4938,7528
12127,127,12,2019,554065,9174,447,9621,4878,7529
12127,127,12,2020,561497,9776,672,10448,4836,7812
12129,129,12,2010,30824,47,1,48,69,76
12129,129,12,2011,30977,27,11,38,338,224
12129,129,12,2012,30860,-184,9,-175,308,255
12129,129,12,2013,31009,97,7,104,303,259
12129,129,12,2014,31418,304,17,321,328,245
12129,129,12,2015,31529,12,9,21,349,259
12129,129,12,2016,31894,275,13,288,347,267
12129,129,12,2017,32055,138,10,148,330,316
12129,129,12,2018,32369,263,17,280,312,276
12129,129,12,2019,33636,1216,-3,1213,328,274
12129,129,12,2020,34319,664,2,666,325,306
12131,131,12,2010,55214,159,12,171,136,151
12131,131,12,2011,55613,292,47,339,625,565
12131,131,12,2012,57215,1364,39,1403,661,511
12131,131,12,2013,59232,1769,46,1815,696,543
12131,131,12,2014,61244,1741,18,1759,764,574
12131,131,12,2015,63145,1652,49,1701,770,596
12131,131,12,2016,65488,2119,42,2161,763,596
12131,131,12,2017,68110,2439,33,2472,794,661
12131,131,12,2018,70874,2653,5,2658,784,691
12131,131,12,2019,74127,3169,6,3175,808,725
12131,131,12,2020,76648,2418,8,2426,850,740
12133,133,12,2010,24726,-151,3,-148,61,102
12133,133,12,2011,24516,-157,1,-156,221,276
12133,133,12,2012,24747,243,7,250,240,271
12133,133,12,2013,24506,-248,4,-244,247,247
12133,133,12,2014,24300,-154,8,-146,223,280
12133,133,12,2015,24556,265,9,274,240,260
12133,133,12,2016,24469,-15,23,8,236,330
12133,133,12,2017,24577,181,26,207,239,337
12133,133,12,2018,24845,332,16,348,248,328
12133,133,12,2019,25647,849,17,866,284,348
12133,133,12,2020,25932,356,11,367,276,357
13001,001,13,2010,18337,60,-3,57,63,28
13001,001,13,2011,18459,73,-16,57,260,194
13001,001,13,2012,18382,-177,-7,-184,275,174
13001,001,13,2013,18367,-82,-7,-89,262,188
13001,001,13,2014,18469,62,-8,54,254,203
13001,001,13,2015,18420,-93,7,-86,258,218
13001,001,13,2016,18443,-29,14,-15,263,225
13001,001,13,2017,18447,-38,8,-30,223,187
13001,001,13,2018,18538,69,7,76,230,214
13001,001,13,2019,18389,-160,6,-154,225,219
13001,001,13,2020,18325,-57,3,-54,213,224
13003,003,13,2010,8363,-37,0,-37,25,7
13003,003,13,2011,8359,-77,-1,-78,138,65
13003,003,13,2012,8254,-151,0,-151,124,81
13003,003,13,2013,8263,-38,4,-34,123,79
13003,003,13,2014,8211,-117,1,-116,138,75
13003,003,13,2015,8331,60,4,64,118,64
13003,003,13,2016,8293,-151,58,-93,140,85
13003,003,13,2017,8257,-96,38,-58,115,92
13003,003,13,2018,8344,21,33,54,111,79
13003,003,13,2019,8269,-168,30,-138,126,62
13003,003,13,2020,8393,44,26,70,134,81
13005,005,13,2010,11062,-13,0,-13,37,58
13005,005,13,2011,11150,89,-2,87,137,136
13005,005,13,2012,11152,-58,2,-56,169,113
13005,005,13,2013,11174,-7,8,1,140,117
13005,005,13,2014,11178,5,3,8,131,133
13005,005,13,2015,11225,18,-6,12,165,127
13005,005,13,2016,11268,31,-4,27,150,133
13005,005,13,2017,11204,-98,-4,-102,168,133
13005,005,13,2018,11096,-111,-4,-115,162,153
13005,005,13,2019,11098,-21,-5,-26,141,113
13005,005,13,2020,11036,-80,-4,-84,136,113
13007,007,13,2010,3431,-19,0,-19,4,2
13007,007,13,2011,3311,-131,2,-129,35,27
13007,007,13,2012,3370,38,2,40,35,16
13007,007,13,2013,3346,-33,3,-30,32,25
13007,007,13,2014,3287,-61,-1,-62,25,23
13007,007,13,2015,3192,-90,0,-90,37,44
13007,007,13,2016,3185,-6,0,-6,31,31
13007,007,13,2017,3158,-11,0,-11,27,44
13007,007,13,2018,3089,-81,0,-81,39,26
13007,007,13,2019,3047,-50,0,-50,29,21
13007,007,13,2020,2971,-74,0,-74,24,25
13009,009,13,2010,45703,-140,7,-133,119,129
13009,009,13,2011,45178,-681,22,-659,500,370
13009,009,13,2012,46522,1188,32,1220,466,399
13009,009,13,2013,46191,-478,28,-450,485,372
13009,009,13,2014,45920,-340,19,-321,455,402
13009,009,13,2015,45566,-469,36,-433,488,414
13009,009,13,2016,45260,-345,55,-290,418,435
13009,009,13,2017,44993,-222,44,-178,404,492
13009,009,13,2018,45001,27,44,71,434,494
13009,009,13,2019,45006,52,32,84,401,482
13009,009,13,2020,45099,180,30,210,390,510
13011,011,13,2010,18404,2,1,3,50,21
13011,011,13,2011,18245,-206,-3,-209,183,135
13011,011,13,2012,18128,-131,2,-129,184,171
13011,011,13,2013,18216,62,2,64,159,133
13011,011,13,2014,18220,-70,4,-66,211,141
13011,011,13,2015,18375,86,23,109,236,187
13011,011,13,2016,18292,-101,21,-80,173,175
13011,011,13,2017,18607,259,5,264,208,158
13011,011,13,2018,18918,300,4,304,201,193
13011,011,13,2019,19175,216,5,221,209,173
13011,011,13,2020,19352,148,4,152,200,173
13013,013,13,2010,69670,168,15,183,263,140
13013,013,13,2011,69835,-443,49,-394,1073,514
13013,013,13,2012,70128,-299,15,-284,1077,493
13013,013,13,2013,71233,526,21,547,1062,509
13013,013,13,2014,72843,1140,23,1163,987,565
13013,013,13,2015,74979,1529,84,1613,1038,539
13013,013,13,2016,77108,1454,200,1654,1067,600
13013,013,13,2017,79086,1395,137,1532,1026,588
13013,013,13,2018,81105,1576,116,1692,1015,696
13013,013,13,2019,83581,1943,124,2067,1052,641
13013,013,13,2020,85588,1543,101,1644,1094,725
13015,015,13,2010,100041,-166,3,-163,353,236
13015,015,13,2011,100110,-389,19,-370,1278,837
13015,015,13,2012,100241,-358,13,-345,1240,760
13015,015,13,2013,100923,263,-3,260,1277,844
13015,015,13,2014,101251,-117,-4,-121,1319,846
13015,015,13,2015,102063,285,39,324,1345,847
13015,015,13,2016,103418,825,109,934,1335,917
13015,015,13,2017,105190,1179,53,1232,1375,835
13015,015,13,2018,106488,967,45,1012,1237,956
13015,015,13,2019,107757,1005,40,1045,1239,1017
13015,015,13,2020,109426,1500,27,1527,1236,1091
13017,017,13,2010,17649,-9,0,-9,61,63
13017,017,13,2011,17595,-106,-3,-109,262,207
13017,017,13,2012,17608,-42,-3,-45,264,207
13017,017,13,2013,17461,-122,-3,-125,193,213
13017,017,13,2014,17462,-15,0,-15,226,208
13017,017,13,2015,17368,-135,4,-131,248,211
13017,017,13,2016,17267,-110,21,-89,228,239
13017,017,13,2017,17059,-213,9,-204,214,219
13017,017,13,2018,16794,-235,8,-227,189,228
13017,017,13,2019,16711,-97,7,-90,237,231
13017,017,13,2020,16614,-71,9,-62,214,250
13019,019,13,2010,19361,34,0,34,57,21
13019,019,13,2011,19380,-9,6,-3,224,204
13019,019,13,2012,19160,-295,35,-260,217,183
13019,019,13,2013,19059,-135,28,-107,212,208
13019,019,13,2014,18813,-315,13,-302,237,186
13019,019,13,2015,18989,93,34,127,268,217
13019,019,13,2016,18968,-47,6,-41,242,222
13019,019,13,2017,19071,108,3,111,217,224
13019,019,13,2018,19207,150,4,154,220,238
13019,019,13,2019,19377,141,1,142,235,207
13019,019,13,2020,19408,36,1,37,252,260
13021,021,13,2010,155878,-161,36,-125,563,389
13021,021,13,2011,156297,-387,124,-263,2294,1607
13021,021,13,2012,156701,-554,207,-347,2323,1543
13021,021,13,2013,155138,-2325,235,-2090,2169,1691
13021,021,13,2014,154447,-1566,172,-1394,2211,1524
13021,021,13,2015,154068,-1129,208,-921,2225,1675
13021,021,13,2016,153212,-1503,213,-1290,2052,1619
13021,021,13,2017,152920,-875,142,-733,2103,1658
13021,021,13,2018,153069,-335,121,-214,2025,1658
13021,021,13,2019,153191,-177,125,-52,1922,1749
13021,021,13,2020,152737,-650,91,-559,1993,1891
13023,023,13,2010,13033,-3,1,-2,28,53
13023,023,13,2011,13077,46,10,56,142,154
13023,023,13,2012,12888,-208,10,-198,133,133
13023,023,13,2013,12742,-147,18,-129,121,140
13023,023,13,2014,12706,-18,7,-11,135,157
13023,023,13,2015,12710,-14,11,-3,142,136
13023,023,13,2016,12868,150,14,164,136,143
13023,023,13,2017,12769,-93,12,-81,135,153
13023,023,13,2018,12833,62,11,73,134,142
13023,023,13,2019,12923,59,10,69,127,108
13023,023,13,2020,12955,9,9,18,135,121
13025,025,13,2010,18462,22,0,22,51,20
13025,025,13,2011,18549,87,-7,80,193,185
13025,025,13,2012,18522,-22,-11,-33,188,182
13025,025,13,2013,18253,-296,-15,-311,226,190
13025,025,13,2014,18368,99,-9,90,200,172
13025,025,13,2015,18443,41,-3,38,217,178
13025,025,13,2016,18425,-61,12,-49,230,200
13025,025,13,2017,18848,372,6,378,226,182
13025,025,13,2018,19021,136,5,141,246,213
13025,025,13,2019,19124,108,5,113,210,219
13025,025,13,2020,19202,98,4,102,215,241
13027,027,13,2010,16246,-51,-2,-53,45,61
13027,027,13,2011,15982,-286,2,-284,195,177
13027,027,13,2012,15616,-450,7,-443,221,156
13027,027,13,2013,15648,-2,13,11,224,205
13027,027,13,2014,15524,-158,17,-141,214,198
13027,027,13,2015,15672,130,22,152,193,200
13027,027,13,2016,15732,39,38,77,181,197
13027,027,13,2017,15641,-79,24,-55,189,226
13027,027,13,2018,15491,-134,21,-113,164,199
13027,027,13,2019,15518,44,20,64,183,221
13027,027,13,2020,15357,-120,19,-101,155,215
13029,029,13,2010,30404,84,3,87,111,32
13029,029,13,2011,31300,688,14,702,428,238
13029,029,13,2012,32293,563,118,681,517,219
13029,029,13,2013,33082,458,71,529,490,237
13029,029,13,2014,33726,338,46,384,499,237
13029,029,13,2015,34860,747,73,820,540,232
13029,029,13,2016,35916,748,60,808,503,254
13029,029,13,2017,37091,921,9,930,517,274
13029,029,13,2018,38151,827,-19,808,537,286
13029,029,13,2019,39692,1281,2,1283,533,268
13029,029,13,2020,40755,781,5,786,565,283
13031,031,13,2010,70560,233,22,255,186,145
13031,031,13,2011,72642,1627,90,1717,842,494
13031,031,13,2012,73114,4,139,143,811,468
13031,031,13,2013,71830,-1852,132,-1720,858,488
13031,031,13,2014,72667,353,113,466,836,465
13031,031,13,2015,73137,-48,111,63,929,514
13031,031,13,2016,74660,1004,169,1173,872,530
13031,031,13,2017,76046,922,124,1046,901,565
13031,031,13,2018,77332,762,117,879,939,537
13031,031,13,2019,79718,1975,91,2066,887,572
13031,031,13,2020,80839,775,86,861,893,636
13033,033,13,2010,23343,20,-1,19,80,89
13033,033,13,2011,23513,90,-4,86,324,239
13033,033,13,2012,23054,-563,-2,-565,316,228
13033,033,13,2013,22832,-320,0,-320,309,217
13033,033,13,2014,22629,-267,0,-267,325,265
13033,033,13,2015,22644,-75,3,-72,322,232
13033,033,13,2016,22638,-95,6,-89,346,264
13033,033,13,2017,22553,-145,-2,-147,302,240
13033,033,13,2018,22501,-138,-2,-140,340,252
13033,033,13,2019,22497,-40,-6,-46,271,229
13033,033,13,2020,22648,113,-2,111,288,248
13035,035,13,2010,23776,54,-1,53,72,40
13035,035,13,2011,23603,-204,1,-203,278,248
13035,035,13,2012,23431,-240,0,-240,278,213
13035,035,13,2013,23216,-225,0,-225,286,276
13035,035,13,2014,23337,104,1,105,283,262
13035,035,13,2015,23516,194,3,197,225,246
13035,035,13,2016,23738,222,5,227,250,255
13035,035,13,2017,24064,324,-1,323,269,268
13035,035,13,2018,24172,136,-2,134,268,295
13035,035,13,2019,24917,743,-2,741,259,255
13035,035,13,2020,25426,497,-3,494,303,286
13037,037,13,2010,6697,-12,2,-10,12,3
13037,037,13,2011,6625,-87,1,-86,70,56
13037,037,13,2012,6568,-54,8,-46,58,69
13037,037,13,2013,6598,24,6,30,68,70
13037,037,13,2014,6513,-53,-1,-54,44,75
13037,037,13,2015,6536,23,3,26,55,58
13037,037,13,2016,6359,-163,8,-155,44,66
13037,037,13,2017,6393,46,3,49,53,69
13037,037,13,2018,6340,-38,1,-37,50,67
13037,037,13,2019,6184,-164,2,-162,49,42
13037,037,13,2020,6231,45,2,47,49,49
13039,039,13,2010,50680,-45,54,9,194,46
13039,039,13,2011,50344,-839,-19,-858,786,270
13039,039,13,2012,51402,319,259,578,798,320
13039,039,13,2013,51478,-615,127,-488,864,313
13039,039,13,2014,52000,-36,97,61,798,332
13039,039,13,2015,52549,-19,147,128,752,333
13039,039,13,2016,52602,-572,137,-435,836,353
13039,039,13,2017,53211,181,39,220,756,367
13039,039,13,2018,53816,231,-16,215,789,397
13039,039,13,2019,54784,600,18,618,736,387
13039,039,13,2020,55388,272,22,294,733,425
13043,043,13,2010,11013,3,-2,1,39,14
13043,043,13,2011,11199,163,0,163,151,128
13043,043,13,2012,11090,-133,-3,-136,158,133
13043,043,13,2013,10950,-195,11,-184,152,113
13043,043,13,2014,10853,-115,7,-108,145,134
13043,043,13,2015,10864,11,15,26,129,142
13043,043,13,2016,10837,-9,11,2,128,156
13043,043,13,2017,10698,-138,1,-137,136,137
13043,043,13,2018,10813,127,1,128,128,141
13043,043,13,2019,10835,-5,-1,-6,136,108
13043,043,13,2020,10985,151,1,152,128,128
13045,045,13,2010,110655,-138,29,-109,386,186
13045,045,13,2011,110733,-496,62,-434,1497,987
13045,045,13,2012,111428,-36,98,62,1518,861
13045,045,13,2013,112290,255,177,432,1403,964
13045,045,13,2014,113970,1093,96,1189,1446,982
13045,045,13,2015,114501,35,124,159,1463,1079
13045,045,13,2016,116180,973,141,1114,1563,998
13045,045,13,2017,117437,826,105,931,1476,1149
13045,045,13,2018,118094,140,101,241,1494,1075
13045,045,13,2019,120115,1564,60,1624,1516,1120
13045,045,13,2020,121633,1093,64,1157,1545,1186
13047,047,13,2010,64073,35,9,44,190,85
13047,047,13,2011,64771,465,22,487,707,496
13047,047,13,2012,64893,-147,31,-116,777,537
13047,047,13,2013,65258,117,28,145,755,525
13047,047,13,2014,65516,68,9,77,744,551
13047,047,13,2015,65841,230,13,243,724,635
13047,047,13,2016,66350,419,27,446,736,671
13047,047,13,2017,66570,227,8,235,696,706
13047,047,13,2018,67402,860,1,861,687,713
13047,047,13,2019,67585,203,2,205,643,664
13047,047,13,2020,67996,516,2,518,616,722
13049,049,13,2010,12850,569,-4,565,39,5
13049,049,13,2011,13452,579,-19,560,130,95
13049,049,13,2012,13350,-124,-8,-132,146,122
13049,049,13,2013,13103,-272,7,-265,130,118
13049,049,13,2014,13046,-130,79,-51,106,114
13049,049,13,2015,13238,83,101,184,111,104
13049,049,13,2016,12850,-553,137,-416,122,99
13049,049,13,2017,12779,-151,64,-87,110,96
13049,049,13,2018,12826,15,65,80,104,136
13049,049,13,2019,13277,401,50,451,106,107
13049,049,13,2020,13430,106,45,151,107,106
13051,051,13,2010,265799,172,141,313,867,498
13051,051,13,2011,271665,3877,390,4267,3813,2245
13051,051,13,2012,276243,1751,888,2639,4006,2128
13051,051,13,2013,277790,-944,836,-108,3950,2270
13051,051,13,2014,282396,2380,575,2955,3907,2321
13051,051,13,2015,286239,1264,888,2152,4079,2397
13051,051,13,2016,289055,108,1018,1126,4089,2391
13051,051,13,2017,289771,-1196,640,-556,3756,2458
13051,051,13,2018,289771,-1688,532,-1156,3616,2438
13051,051,13,2019,290185,-981,412,-569,3522,2534
13051,051,13,2020,289463,-1789,377,-1412,3528,2836
13053,053,13,2010,11185,-218,74,-144,50,1
13053,053,13,2011,11270,-191,92,-99,222,38
13053,053,13,2012,12293,232,514,746,308,32
13053,053,13,2013,12271,-514,252,-262,266,34
13053,053,13,2014,11738,-914,182,-732,218,34
13053,053,13,2015,11075,-1137,261,-876,232,37
13053,053,13,2016,10065,-1315,126,-1189,210,39
13053,053,13,2017,10197,-46,35,-11,183,40
13053,053,13,2018,10548,177,-20,157,227,35
13053,053,13,2019,10991,241,24,265,205,28
13053,053,13,2020,10551,-626,25,-601,198,32
13055,055,13,2010,25958,-16,3,-13,48,96
13055,055,13,2011,25689,-315,7,-308,303,266
13055,055,13,2012,25635,-27,2,-25,292,316
13055,055,13,2013,25062,-514,5,-509,251,331
13055,055,13,2014,24871,-174,6,-168,297,323
13055,055,13,2015,24918,75,7,82,300,331
13055,055,13,2016,24847,-76,8,-68,300,303
13055,055,13,2017,24757,-76,9,-67,314,336
13055,055,13,2018,24836,132,6,138,279,337
13055,055,13,2019,24846,27,6,33,300,322
13055,055,13,2020,24843,-6,6,0,307,312
13057,057,13,2010,215226,368,47,415,663,261
13057,057,13,2011,217769,823,91,914,2848,1213
13057,057,13,2012,220690,1276,97,1373,2783,1224
13057,057,13,2013,224372,2113,92,2205,2735,1268
13057,057,13,2014,230239,4066,113,4179,2866,1279
13057,057,13,2015,235424,3470,342,3812,2810,1466
13057,057,13,2016,241929,4604,488,5092,2849,1456
13057,057,13,2017,247944,4456,321,4777,2842,1622
13057,057,13,2018,254277,4914,274,5188,2781,1648
13057,057,13,2019,259475,3852,276,4128,2774,1700
13057,057,13,2020,265274,4740,228,4968,2695,1855
13059,059,13,2010,117389,416,77,493,363,201
13059,059,13,2011,118229,-218,238,20,1454,635
13059,059,13,2012,119915,526,330,856,1437,629
13059,059,13,2013,120927,-144,458,314,1399,686
13059,059,13,2014,120437,-1477,330,-1147,1370,740
13059,059,13,2015,123621,2029,512,2541,1350,750
13059,059,13,2016,124873,25,585,610,1364,720
13059,059,13,2017,126674,913,355,1268,1314,792
13059,059,13,2018,127179,-354,308,-46,1349,792
13059,059,13,2019,128238,261,257,518,1294,756
13059,059,13,2020,127795,-1128,221,-907,1298,834
13061,061,13,2010,3176,-11,0,-11,4,3
13061,061,13,2011,3163,-3,-1,-4,33,42
13061,061,13,2012,3107,-59,-2,-61,42,38
13061,061,13,2013,3017,-81,-2,-83,39,48
13061,061,13,2014,3074,71,-3,68,27,40
13061,061,13,2015,3080,2,0,2,41,37
13061,061,13,2016,3015,-63,8,-55,31,40
13061,061,13,2017,2971,-31,2,-29,29,45
13061,061,13,2018,2901,-39,2,-37,13,46
13061,061,13,2019,2901,-12,2,-10,34,25
13061,061,13,2020,2866,-23,2,-21,31,44
13063,063,13,2010,259899,-567,117,-450,1081,387
13063,063,13,2011,262081,-1117,363,-754,4370,1437
13063,063,13,2012,265371,-62,622,560,4176,1396
13063,063,13,2013,264133,-4740,725,-4015,4146,1526
13063,063,13,2014,266757,-491,541,50,4126,1511
13063,063,13,2015,272874,2557,788,3345,4404,1645
13063,063,13,2016,279346,2780,967,3747,4294,1573
13063,063,13,2017,284175,1794,571,2365,4338,1879
13063,063,13,2018,289229,2140,488,2628,4304,1882
13063,063,13,2019,292404,395,345,740,4314,1896
13063,063,13,2020,292646,-2132,302,-1830,4046,1982
13065,065,13,2010,6764,-16,0,-16,17,29
13065,065,13,2011,6719,-73,3,-70,109,84
13065,065,13,2012,6688,-75,9,-66,96,63
13065,065,13,2013,6756,21,14,35,98,65
13065,065,13,2014,6780,-23,15,-8,104,73
13065,065,13,2015,6828,12,13,25,97,72
13065,065,13,2016,6762,-105,24,-81,106,91
13065,065,13,2017,6658,-110,13,-97,84,92
13065,065,13,2018,6601,-58,10,-48,85,93
13065,065,13,2019,6637,-10,12,2,90,55
13065,065,13,2020,6582,-78,10,-68,91,78
13067,067,13,2010,689542,-357,469,112,2321,933
13067,067,13,2011,696629,-38,1405,1367,9482,3744
13067,067,13,2012,706517,2091,2085,4176,9486,3664
13067,067,13,2013,716265,1815,2639,4454,9232,3842
13067,067,13,2014,727847,4549,1720,6269,9305,3977
13067,067,13,2015,739428,3417,2613,6030,9750,4161
13067,067,13,2016,748767,191,3878,4069,9445,4142
13067,067,13,2017,753361,-2973,2430,-543,9357,4209
13067,067,13,2018,757133,-2827,2005,-822,9108,4507
13067,067,13,2019,761060,-2088,1937,-151,8669,4617
13067,067,13,2020,762944,-3199,1474,-1725,8769,5210
13069,069,13,2010,42729,256,5,261,124,40
13069,069,13,2011,42998,49,22,71,593,395
13069,069,13,2012,43131,-139,43,-96,593,365
13069,069,13,2013,43084,-272,34,-238,579,390
13069,069,13,2014,42893,-480,1,-479,642,359
13069,069,13,2015,42998,-86,18,-68,573,396
13069,069,13,2016,42924,-250,2,-248,596,422
13069,069,13,2017,42871,-199,4,-195,594,451
13069,069,13,2018,43060,37,0,37,597,445
13069,069,13,2019,43278,81,0,81,565,430
13069,069,13,2020,43218,-164,1,-163,555,453
13071,071,13,2010,45638,23,7,30,189,72
13071,071,13,2011,45778,-182,7,-175,763,448
13071,071,13,2012,46029,-42,34,-8,723,459
13071,071,13,2013,46139,-111,38,-73,692,500
13071,071,13,2014,45880,-443,21,-422,625,464
13071,071,13,2015,45486,-641,39,-602,658,455
13071,071,13,2016,45471,-227,47,-180,656,491
13071,071,13,2017,45501,-92,2,-90,597,475
13071,071,13,2018,45467,-122,-6,-128,645,550
13071,071,13,2019,45569,20,-18,2,583,482
13071,071,13,2020,45542,-99,-12,-111,586,504
13073,073,13,2010,124951,556,81,637,405,137
13073,073,13,2011,128832,2867,153,3020,1616,772
13073,073,13,2012,132601,2432,335,2767,1718,776
13073,073,13,2013,136232,2713,226,2939,1494,857
13073,073,13,2014,139223,1861,203,2064,1723,818
13073,073,13,2015,143991,3575,327,3902,1719,891
13073,073,13,2016,147622,2228,375,2603,1908,884
13073,073,13,2017,151757,3095,159,3254,1837,961
13073,073,13,2018,154399,1767,69,1836,1815,1003
13073,073,13,2019,157129,1871,107,1978,1799,1043
13073,073,13,2020,160377,2514,95,2609,1789,1138
13075,075,13,2010,17184,0,1,1,56,78
13075,075,13,2011,17036,-213,5,-208,238,178
13075,075,13,2012,16906,-190,2,-188,208,158
13075,075,13,2013,17055,103,2,105,228,186
13075,075,13,2014,17307,201,-1,200,235,185
13075,075,13,2015,17076,-257,0,-257,222,197
13075,075,13,2016,17175,71,0,71,219,189
13075,075,13,2017,17217,55,-1,54,186,197
13075,075,13,2018,17161,-95,-1,-96,227,186
13075,075,13,2019,17241,74,-1,73,209,203
13075,075,13,2020,17291,50,0,50,211,211
13077,077,13,2010,127939,311,13,324,396,170
13077,077,13,2011,129390,676,17,693,1633,875
13077,077,13,2012,130614,403,77,480,1586,816
13077,077,13,2013,132980,1470,143,1613,1673,939
13077,077,13,2014,135191,1360,105,1465,1683,961
13077,077,13,2015,138217,2082,251,2333,1640,966
13077,077,13,2016,140561,1456,285,1741,1627,1026
13077,077,13,2017,143218,1875,203,2078,1657,1082
13077,077,13,2018,146063,2032,186,2218,1688,1063
13077,077,13,2019,148504,1829,120,1949,1617,1125
13077,077,13,2020,150849,1817,108,1925,1630,1211
13079,079,13,2010,12577,-29,0,-29,51,38
13079,079,13,2011,12576,-41,4,-37,136,100
13079,079,13,2012,12567,-43,7,-36,143,117
13079,079,13,2013,12474,-131,17,-114,125,105
13079,079,13,2014,12395,-88,12,-76,128,133
13079,079,13,2015,12351,-86,16,-70,143,117
13079,079,13,2016,12250,-100,-1,-101,114,113
13079,079,13,2017,12236,38,0,38,119,170
13079,079,13,2018,12273,43,-1,42,121,127
13079,079,13,2019,12345,99,-1,98,116,141
13079,079,13,2020,12231,-58,-1,-59,104,159
13081,081,13,2010,23436,-54,0,-54,81,29
13081,081,13,2011,23753,224,8,232,336,254
13081,081,13,2012,23593,-240,10,-230,294,228
13081,081,13,2013,23304,-344,18,-326,296,267
13081,081,13,2014,23064,-279,12,-267,272,254
13081,081,13,2015,22961,-206,25,-181,318,238
13081,081,13,2016,22882,-133,2,-131,304,252
13081,081,13,2017,22675,-250,0,-250,277,232
13081,081,13,2018,22572,-102,-1,-103,283,284
13081,081,13,2019,22382,-177,-1,-178,243,253
13081,081,13,2020,22034,-266,-1,-267,237,317
13083,083,13,2010,16632,-4,0,-4,23,29
13083,083,13,2011,16605,-37,7,-30,146,143
13083,083,13,2012,16528,-127,0,-127,203,156
13083,083,13,2013,16466,-30,-6,-36,155,181
13083,083,13,2014,16299,-153,-5,-158,171,179
13083,083,13,2015,16176,-79,-7,-86,163,201
13083,083,13,2016,16249,94,-3,91,173,189
13083,083,13,2017,16270,60,-5,55,147,180
13083,083,13,2018,16238,8,-5,3,158,192
13083,083,13,2019,16103,-82,-5,-87,149,196
13083,083,13,2020,16057,9,-3,6,145,198
13085,085,13,2010,22325,-78,-3,-81,55,31
13085,085,13,2011,22334,-59,-8,-67,244,166
13085,085,13,2012,22511,137,-4,133,222,175
13085,085,13,2013,22730,166,3,169,232,183
13085,085,13,2014,23024,194,6,200,249,158
13085,085,13,2015,23371,310,30,340,216,212
13085,085,13,2016,23664,234,30,264,229,200
13085,085,13,2017,24410,684,7,691,274,221
13085,085,13,2018,25106,712,4,716,237,258
13085,085,13,2019,26091,948,3,951,291,256
13085,085,13,2020,27113,988,0,988,291,252
13087,087,13,2010,27815,-58,-4,-62,90,56
13087,087,13,2011,27655,-212,-7,-219,372,314
13087,087,13,2012,27449,-252,-11,-263,372,319
13087,087,13,2013,27401,-131,-5,-136,363,275
13087,087,13,2014,27183,-267,-4,-271,366,316
13087,087,13,2015,27063,-150,-6,-156,345,307
13087,087,13,2016,26682,-437,5,-432,364,316
13087,087,13,2017,26727,-40,0,-40,393,306
13087,087,13,2018,26613,-99,0,-99,364,379
13087,087,13,2019,26496,-165,-3,-168,375,324
13087,087,13,2020,26457,-48,2,-46,349,342
13089,089,13,2010,692536,-2138,879,-1259,2668,984
13089,089,13,2011,698496,-3974,3095,-879,11046,4214
13089,089,13,2012,710783,1075,4346,5421,11008,4148
13089,089,13,2013,718026,-4277,4896,619,10891,4259
13089,089,13,2014,725247,-3337,4071,734,11016,4399
13089,089,13,2015,734846,-2026,4978,2952,11111,4380
13089,089,13,2016,747299,-1194,7051,5857,11129,4514
13089,089,13,2017,751680,-6660,4723,-1937,10986,4637
13089,089,13,2018,755514,-6310,3943,-2367,11028,4799
13089,089,13,2019,759932,-5207,3975,-1232,10579,4912
13089,089,13,2020,762009,-6022,3081,-2941,10514,5495
13091,091,13,2010,21756,-75,0,-75,61,24
13091,091,13,2011,21606,-152,-3,-155,251,246
13091,091,13,2012,21511,-96,0,-96,242,240
13091,091,13,2013,21424,-142,5,-137,278,227
13091,091,13,2014,21167,-288,2,-286,223,198
13091,091,13,2015,21133,-51,8,-43,240,228
13091,091,13,2016,20866,-280,24,-256,222,234
13091,091,13,2017,20777,-75,20,-55,205,238
13091,091,13,2018,20858,51,15,66,228,212
13091,091,13,2019,20672,-181,19,-162,206,228
13091,091,13,2020,20452,-143,12,-131,206,295
13093,093,13,2010,14850,-63,4,-59,32,46
13093,093,13,2011,14610,-279,17,-262,135,115
13093,093,13,2012,14414,-220,26,-194,122,130
13093,093,13,2013,14373,-33,6,-27,110,123
13093,093,13,2014,14248,-119,-4,-123,107,110
13093,093,13,2015,14033,-184,-2,-186,100,130
13093,093,13,2016,13870,-148,1,-147,123,139
13093,093,13,2017,13694,-156,-1,-157,92,114
13093,093,13,2018,13718,47,-1,46,90,112
13093,093,13,2019,13400,-295,-1,-296,110,130
13093,093,13,2020,13174,-203,1,-202,110,133
13095,095,13,2010,94521,-165,16,-149,382,269
13095,095,13,2011,95080,-317,61,-256,1572,755
13095,095,13,2012,94716,-973,106,-867,1384,890
13095,095,13,2013,93441,-1917,114,-1803,1404,917
13095,095,13,2014,92775,-1179,74,-1105,1273,848
13095,095,13,2015,91556,-1732,96,-1636,1279,879
13095,095,13,2016,90365,-1494,90,-1404,1184,975
13095,095,13,2017,89537,-1206,56,-1150,1248,929
13095,095,13,2018,89247,-584,55,-529,1194,949
13095,095,13,2019,87854,-1631,40,-1591,1189,988
13095,095,13,2020,86477,-1522,29,-1493,1169,1046
13097,097,13,2010,132575,-33,52,19,433,153
13097,097,13,2011,133128,-472,101,-371,1751,830
13097,097,13,2012,133597,-580,115,-465,1762,843
13097,097,13,2013,136081,1406,157,1563,1744,836
13097,097,13,2014,138082,1084,101,1185,1714,895
13097,097,13,2015,140264,1271,129,1400,1748,960
13097,097,13,2016,141824,562,181,743,1794,972
13097,097,13,2017,143563,942,112,1054,1669,976
13097,097,13,2018,145260,892,90,982,1724,1002
13097,097,13,2019,146680,688,93,781,1661,1020
13097,097,13,2020,147988,720,83,803,1669,1167
13099,099,13,2010,10983,-54,0,-54,40,12
13099,099,13,2011,10791,-235,2,-233,160,121
13099,099,13,2012,10641,-188,1,-187,155,124
13099,099,13,2013,10543,-72,0,-72,143,170
13099,099,13,2014,10451,-76,3,-73,118,137
13099,099,13,2015,10459,9,5,14,130,135
13099,099,13,2016,10310,-162,6,-156,139,133
13099,099,13,2017,10313,15,1,16,125,136
13099,099,13,2018,10255,-31,1,-30,122,149
13099,099,13,2019,10176,-84,0,-84,141,136
13099,099,13,2020,10037,-108,4,-104,124,159
13101,101,13,2010,4014,-9,-3,-12,13,10
13101,101,13,2011,4063,15,2,17,64,32
13101,101,13,2012,3965,-160,3,-157,78,23
13101,101,13,2013,3992,-16,1,-15,76,33
13101,101,13,2014,4027,-11,5,-6,72,30
13101,101,13,2015,4024,-40,7,-33,58,29
13101,101,13,2016,3934,-106,-1,-107,50,33
13101,101,13,2017,3888,-65,-3,-68,50,29
13101,101,13,2018,3933,31,-3,28,40,23
13101,101,13,2019,3963,-17,-3,-20,65,15
13101,101,13,2020,4002,30,-2,28,36,24
13103,103,13,2010,52469,119,4,123,141,53
13103,103,13,2011,52709,-116,21,-95,661,326
13103,103,13,2012,53360,283,25,308,700,349
13103,103,13,2013,54456,716,26,742,739,397
13103,103,13,2014,55452,580,35,615,778,403
13103,103,13,2015,57125,1262,62,1324,757,423
13103,103,13,2016,58705,1170,70,1240,763,427
13103,103,13,2017,60121,1061,45,1106,762,453
13103,103,13,2018,62274,1808,38,1846,815,513
13103,103,13,2019,64342,1736,24,1760,809,498
13103,103,13,2020,65765,1124,23,1147,806,525
13105,105,13,2010,20101,-59,0,-59,57,65
13105,105,13,2011,19822,-264,-5,-269,251,262
13105,105,13,2012,19577,-252,-5,-257,229,223
13105,105,13,2013,19492,-63,5,-58,241,265
13105,105,13,2014,19391,-53,4,-49,222,270
13105,105,13,2015,19303,-69,0,-69,218,235
13105,105,13,2016,19122,-127,2,-125,207,262
13105,105,13,2017,19104,1,0,1,241,258
13105,105,13,2018,19053,38,-2,36,187,272
13105,105,13,2019,19205,190,-3,187,223,257
13105,105,13,2020,19335,200,-1,199,214,282
13107,107,13,2010,22602,14,-2,12,85,86
13107,107,13,2011,22489,-165,-2,-167,334,279
13107,107,13,2012,22727,172,-5,167,319,254
13107,107,13,2013,22626,-115,-6,-121,303,286
13107,107,13,2014,22476,-203,0,-203,338,286
13107,107,13,2015,22465,-52,2,-50,319,277
13107,107,13,2016,22405,-87,2,-85,299,272
13107,107,13,2017,22528,118,-3,115,313,305
13107,107,13,2018,22582,103,-4,99,280,326
13107,107,13,2019,22600,17,-4,13,301,296
13107,107,13,2020,22507,-76,-4,-80,288,303
13109,109,13,2010,11028,-23,0,-23,48,5
13109,109,13,2011,10983,-80,-9,-89,148,105
13109,109,13,2012,10678,-379,-11,-390,177,109
13109,109,13,2013,10792,72,-5,67,168,123
13109,109,13,2014,10808,-28,-3,-31,162,114
13109,109,13,2015,10690,-145,-1,-146,161,133
13109,109,13,2016,10633,-71,-1,-72,131,117
13109,109,13,2017,10747,72,6,78,143,106
13109,109,13,2018,10677,-72,4,-68,130,132
13109,109,13,2019,10661,-55,5,-50,125,90
13109,109,13,2020,10638,-36,7,-29,130,125
13111,111,13,2010,23684,-10,0,-10,49,56
13111,111,13,2011,23647,37,-5,32,197,265
13111,111,13,2012,23617,86,-5,81,184,292
13111,111,13,2013,23835,365,-12,353,198,341
13111,111,13,2014,23869,146,1,147,201,314
13111,111,13,2015,24455,670,2,672,226,320
13111,111,13,2016,25051,722,-1,721,201,329
13111,111,13,2017,25348,457,-3,454,191,350
13111,111,13,2018,25995,785,-4,781,216,352
13111,111,13,2019,26068,228,-4,224,198,346
13111,111,13,2020,26521,653,-5,648,199,390
13113,113,13,2010,106938,367,48,415,197,227
13113,113,13,2011,107171,93,121,214,780,765
13113,113,13,2012,107343,-200,192,-8,809,669
13113,113,13,2013,108103,549,213,762,816,818
13113,113,13,2014,109259,959,178,1137,827,797
13113,113,13,2015,110215,648,222,870,925,835
13113,113,13,2016,111294,783,331,1114,865,892
13113,113,13,2017,112626,1059,201,1260,899,813
13113,113,13,2018,113333,637,162,799,826,909
13113,113,13,2019,114645,1219,165,1384,859,914
13113,113,13,2020,115821,1192,119,1311,868,990
13115,115,13,2010,96436,-13,17,4,325,202
13115,115,13,2011,96174,-629,50,-579,1302,984
13115,115,13,2012,95944,-440,99,-341,1128,1012
13115,115,13,2013,95901,-289,106,-183,1187,1040
13115,115,13,2014,95894,-219,118,-101,1137,1025
13115,115,13,2015,96209,23,178,201,1168,1046
13115,115,13,2016,96730,97,260,357,1283,1114
13115,115,13,2017,97459,475,171,646,1165,1079
13115,115,13,2018,97907,265,153,418,1155,1119
13115,115,13,2019,98325,390,139,529,1106,1218
13115,115,13,2020,98604,320,119,439,1088,1252
13117,117,13,2010,176736,725,90,815,600,223
13117,117,13,2011,181828,3503,170,3673,2227,826
13117,117,13,2012,186848,3436,222,3658,2191,908
13117,117,13,2013,193875,5446,311,5757,2097,946
13117,117,13,2014,202697,6931,367,7298,2302,972
13117,117,13,2015,211368,6739,624,7363,2351,1130
13117,117,13,2016,220856,7046,1137,8183,2437,1162
13117,117,13,2017,229367,6515,651,7166,2463,1138
13117,117,13,2018,237330,6255,520,6775,2374,1195
13117,117,13,2019,244624,5606,498,6104,2470,1263
13117,117,13,2020,250847,4994,410,5404,2366,1522
13119,119,13,2010,22082,0,-1,-1,77,90
13119,119,13,2011,21982,-121,1,-120,272,252
13119,119,13,2012,21927,-78,2,-76,274,250
13119,119,13,2013,22056,130,25,155,262,290
13119,119,13,2014,22187,152,18,170,246,284
13119,119,13,2015,22281,97,26,123,278,305
13119,119,13,2016,22333,6,52,58,271,276
13119,119,13,2017,22876,516,31,547,286,293
13119,119,13,2018,23039,192,26,218,262,318
13119,119,13,2019,23322,296,27,323,271,310
13119,119,13,2020,23504,188,23,211,280,308
13121,121,13,2010,925622,2532,709,3241,3158,1350
13121,121,13,2011,947582,11955,2488,14443,13032,5608
13121,121,13,2012,973464,14576,3499,18075,12685,5483
13121,121,13,2013,981844,-2195,4076,1881,12442,5939
13121,121,13,2014,992321,1190,3000,4190,12492,6035
13121,121,13,2015,1005752,2793,4270,7063,12793,6372
13121,121,13,2016,1023816,5461,6382,11843,12464,6268
13121,121,13,2017,1039996,6266,4008,10274,12208,6363
13121,121,13,2018,1051516,2614,3185,5799,12139,6444
13121,121,13,2019,1065019,5527,3149,8676,11602,6831
13121,121,13,2020,1077402,5728,2455,8183,12264,8114
13123,123,13,2010,28343,-5,7,2,90,46
13123,123,13,2011,28329,-163,18,-145,318,188
13123,123,13,2012,28291,-173,56,-117,298,217
13123,123,13,2013,28721,338,71,409,310,296
13123,123,13,2014,28999,177,38,215,289,225
13123,123,13,2015,29512,478,19,497,341,330
13123,123,13,2016,29897,356,36,392,318,327
13123,123,13,2017,30470,558,17,575,319,326
13123,123,13,2018,31011,564,16,580,339,378
13123,123,13,2019,31575,608,11,619,334,388
13123,123,13,2020,31978,482,8,490,326,411
13125,125,13,2010,3079,-5,0,-5,10,13
13125,125,13,2011,3103,20,5,25,31,32
13125,125,13,2012,3107,27,2,29,25,49
13125,125,13,2013,3060,-38,1,-37,27,38
13125,125,13,2014,3008,-47,1,-46,35,41
13125,125,13,2015,3020,34,0,34,21,43
13125,125,13,2016,2976,-31,0,-31,26,40
13125,125,13,2017,3031,73,0,73,27,44
13125,125,13,2018,2968,-54,0,-54,30,40
13125,125,13,2019,2959,-4,0,-4,24,28
13125,125,13,2020,2984,31,0,31,26,31
13127,127,13,2010,79750,71,8,79,261,217
13127,127,13,2011,80123,81,49,130,1020,772
13127,127,13,2012,80889,399,121,520,975,731
13127,127,13,2013,81533,336,147,483,1008,836
13127,127,13,2014,82212,395,115,510,985,810
13127,127,13,2015,83368,946,71,1017,979,848
13127,127,13,2016,84211,632,113,745,962,863
13127,127,13,2017,84836,497,72,569,932,874
13127,127,13,2018,85099,241,61,302,921,957
13127,127,13,2019,85326,164,46,210,921,904
13127,127,13,2020,85568,298,51,349,898,1007
13129,129,13,2010,55256,-94,24,-70,182,79
13129,129,13,2011,55522,18,22,40,728,499
13129,129,13,2012,55691,-88,19,-69,725,477
13129,129,13,2013,55767,-207,48,-159,685,447
13129,129,13,2014,55848,-77,24,-53,648,509
13129,129,13,2015,56330,262,33,295,704,515
13129,129,13,2016,57015,353,97,450,744,506
13129,129,13,2017,57204,32,54,86,653,549
13129,129,13,2018,57737,359,37,396,667,528
13129,129,13,2019,58046,236,37,273,670,633
13129,129,13,2020,58780,652,39,691,684,641
13131,131,13,2010,25027,-7,-1,-8,93,75
13131,131,13,2011,25103,-105,-12,-117,383,191
13131,131,13,2012,25283,72,-16,56,375,249
13131,131,13,2013,25120,-230,5,-225,324,264
13131,131,13,2014,25236,6,17,23,354,259
13131,131,13,2015,25106,-240,52,-188,316,259
13131,131,13,2016,24895,-364,43,-321,361,251
13131,131,13,2017,24762,-182,7,-175,318,277
13131,131,13,2018,24730,-85,3,-82,319,267
13131,131,13,2019,24588,-173,2,-171,302,272
13131,131,13,2020,24491,-103,0,-103,289,285
13133,133,13,2010,15977,20,-4,16,42,78
13133,133,13,2011,16049,68,9,77,165,169
13133,133,13,2012,16116,52,17,69,183,184
13133,133,13,2013,16241,131,25,156,156,189
13133,133,13,2014,16418,179,20,199,169,195
13133,133,13,2015,16620,217,21,238,163,200
13133,133,13,2016,16892,214,60,274,173,175
13133,133,13,2017,17225,346,44,390,159,216
13133,133,13,2018,17730,521,39,560,167,225
13133,133,13,2019,18356,601,39,640,179,191
13133,133,13,2020,18837,529,29,558,178,252
13135,135,13,2010,807979,170,616,786,2901,910
13135,135,13,2011,822407,4231,1956,6187,11717,3476
13135,135,13,2012,836854,3678,2877,6555,11459,3426
13135,135,13,2013,853496,6268,3027,9295,11148,3788
13135,135,13,2014,871052,7451,2284,9735,11622,3772
13135,135,13,2015,888597,6198,3710,9908,11759,4076
13135,135,13,2016,905291,3446,5621,9067,11918,4245
13135,135,13,2017,918681,2108,3701,5809,11899,4271
13135,135,13,2018,928072,-972,3254,2282,11465,4360
13135,135,13,2019,937399,-54,2665,2611,11446,4748
13135,135,13,2020,942627,-2942,2175,-767,11123,5160
13137,137,13,2010,43058,2,-6,-4,117,79
13137,137,13,2011,43041,-107,-25,-132,519,402
13137,137,13,2012,43373,243,-12,231,492,400
13137,137,13,2013,43146,-313,11,-302,520,450
13137,137,13,2014,43553,306,8,314,480,389
13137,137,13,2015,43775,135,48,183,461,419
13137,137,13,2016,44166,256,99,355,522,485
13137,137,13,2017,44687,327,121,448,563,489
13137,137,13,2018,45580,753,106,859,505,474
13137,137,13,2019,45542,-180,101,-79,487,447
13137,137,13,2020,46047,461,78,539,473,506
13139,139,13,2010,180070,-97,-1,-98,633,220
13139,139,13,2011,182299,815,-2,813,2612,1193
13139,139,13,2012,184136,530,50,580,2549,1253
13139,139,13,2013,186459,1090,97,1187,2472,1323
13139,139,13,2014,189156,1449,176,1625,2431,1373
13139,139,13,2015,192249,1648,302,1950,2615,1480
13139,139,13,2016,196176,2288,361,2649,2740,1466
13139,139,13,2017,198854,1544,156,1700,2528,1553
13139,139,13,2018,201396,1415,84,1499,2610,1566
13139,139,13,2019,204310,1937,21,1958,2539,1587
13139,139,13,2020,206591,1459,40,1499,2546,1773
13141,141,13,2010,9433,9,0,9,25,4
13141,141,13,2011,9394,-46,1,-45,96,89
13141,141,13,2012,9078,-331,4,-327,90,93
13141,141,13,2013,8952,-130,9,-121,79,87
13141,141,13,2014,8571,-379,6,-373,62,85
13141,141,13,2015,8579,42,4,46,66,105
13141,141,13,2016,8644,94,11,105,72,112
13141,141,13,2017,8545,-55,7,-48,50,101
13141,141,13,2018,8344,-134,7,-127,56,130
13141,141,13,2019,8475,161,5,166,52,88
13141,141,13,2020,8494,98,5,103,53,136
13143,143,13,2010,28763,-1,0,-1,87,101
13143,143,13,2011,28474,-280,0,-280,376,385
13143,143,13,2012,28325,-163,2,-161,337,327
13143,143,13,2013,28357,13,-1,12,338,315
13143,143,13,2014,28513,144,1,145,330,318
13143,143,13,2015,28733,225,-2,223,354,358
13143,143,13,2016,28860,178,6,184,335,391
13143,143,13,2017,29286,436,1,437,332,343
13143,143,13,2018,29626,373,1,374,364,398
13143,143,13,2019,29884,236,-6,230,361,333
13143,143,13,2020,30383,504,0,504,360,361
13145,145,13,2010,32147,109,0,109,73,33
13145,145,13,2011,32303,73,4,77,312,233
13145,145,13,2012,32564,160,18,178,297,207
13145,145,13,2013,32532,-59,9,-50,274,257
13145,145,13,2014,32730,164,2,166,278,240
13145,145,13,2015,33147,380,4,384,293,258
13145,145,13,2016,33615,452,14,466,277,273
13145,145,13,2017,33945,314,6,320,300,290
13145,145,13,2018,34552,584,-1,583,321,295
13145,145,13,2019,35188,642,4,646,315,320
13145,145,13,2020,36080,973,-1,972,314,385
13147,147,13,2010,25237,1,1,2,71,38
13147,147,13,2011,25414,177,2,179,283,285
13147,147,13,2012,25512,134,5,139,249,290
13147,147,13,2013,25458,-76,11,-65,286,275
13147,147,13,2014,25367,-103,8,-95,292,284
13147,147,13,2015,25415,71,5,76,257,283
13147,147,13,2016,25459,113,-1,112,273,339
13147,147,13,2017,25708,257,-3,254,288,293
13147,147,13,2018,26078,407,-4,403,278,312
13147,147,13,2019,26255,206,-4,202,256,280
13147,147,13,2020,26406,257,-3,254,246,349
13149,149,13,2010,11838,16,0,16,33,39
13149,149,13,2011,11729,-113,-1,-114,130,125
13149,149,13,2012,11652,-92,-1,-93,131,118
13149,149,13,2013,11564,-108,0,-108,130,110
13149,149,13,2014,11622,36,0,36,140,116
13149,149,13,2015,11557,-47,0,-47,108,124
13149,149,13,2016,11578,44,-2,42,129,150
13149,149,13,2017,11748,173,-3,170,145,146
13149,149,13,2018,11801,62,-3,59,114,118
13149,149,13,2019,11825,14,-3,11,141,129
13149,149,13,2020,11973,168,-1,167,117,135
13151,151,13,2010,205042,788,79,867,574,211
13151,151,13,2011,206934,436,180,616,2446,1168
13151,151,13,2012,208047,-227,205,-22,2419,1305
13151,151,13,2013,210089,878,185,1063,2355,1350
13151,151,13,2014,213059,1643,178,1821,2451,1272
13151,151,13,2015,216548,2355,200,2555,2358,1418
13151,151,13,2016,221040,3328,179,3507,2428,1439
13151,151,13,2017,225246,3221,127,3348,2337,1475
13151,151,13,2018,229873,3558,135,3693,2501,1560
13151,151,13,2019,234671,3992,16,4008,2492,1688
13151,151,13,2020,239139,3612,46,3658,2657,1824
13153,153,13,2010,140414,487,79,566,500,253
13153,153,13,2011,143557,1910,158,2068,2089,1024
13153,153,13,2012,145630,522,460,982,2105,994
13153,153,13,2013,147352,324,396,720,2029,1000
13153,153,13,2014,148429,-163,288,125,1999,1031
13153,153,13,2015,149197,-566,436,-130,2024,1127
13153,153,13,2016,151287,1017,234,1251,2016,1170
13153,153,13,2017,152757,562,98,660,2025,1207
13153,153,13,2018,155004,1525,35,1560,1970,1280
13153,153,13,2019,157427,1647,60,1707,2026,1308
13153,153,13,2020,160110,2057,54,2111,1995,1415
13155,155,13,2010,9577,50,0,50,25,18
13155,155,13,2011,9677,90,1,91,113,103
13155,155,13,2012,9598,-93,1,-92,101,89
13155,155,13,2013,9345,-264,2,-262,105,103
13155,155,13,2014,9077,-268,0,-268,93,102
13155,155,13,2015,9137,77,0,77,98,117
13155,155,13,2016,9307,178,0,178,101,110
13155,155,13,2017,9362,64,8,72,96,113
13155,155,13,2018,9395,51,7,58,102,126
13155,155,13,2019,9442,31,0,31,113,98
13155,155,13,2020,9387,-46,2,-44,105,116
13157,157,13,2010,60706,123,2,125,200,91
13157,157,13,2011,60985,-47,18,-29,802,492
13157,157,13,2012,60860,-380,-1,-381,784,532
13157,157,13,2013,61286,309,-4,305,702,577
13157,157,13,2014,62125,525,31,556,785,507
13157,157,13,2015,63439,1040,40,1080,797,572
13157,157,13,2016,65091,1360,62,1422,821,594
13157,157,13,2017,67681,2289,42,2331,838,590
13157,157,13,2018,70347,2379,36,2415,890,651
13157,157,13,2019,73015,2366,30,2396,879,600
13157,157,13,2020,76199,2972,26,2998,889,683
13159,159,13,2010,13888,1,1,2,40,46
13159,159,13,2011,13832,-136,4,-132,197,122
13159,159,13,2012,13638,-248,3,-245,177,132
13159,159,13,2013,13594,-98,6,-92,172,125
13159,159,13,2014,13530,-102,0,-102,173,137
13159,159,13,2015,13679,132,2,134,155,140
13159,159,13,2016,13776,52,1,53,176,132
13159,159,13,2017,13881,97,1,98,143,135
13159,159,13,2018,14024,152,1,153,166,176
13159,159,13,2019,14207,165,1,166,147,131
13159,159,13,2020,14483,272,1,273,140,134
13161,161,13,2010,15112,-10,-2,-12,64,12
13161,161,13,2011,15161,14,-7,7,185,144
13161,161,13,2012,15194,-44,-2,-46,227,146
13161,161,13,2013,15041,-178,-4,-182,198,169
13161,161,13,2014,14927,-159,-4,-163,219,175
13161,161,13,2015,15012,33,8,41,202,156
13161,161,13,2016,14954,-89,14,-75,210,192
13161,161,13,2017,15033,7,9,16,228,163
13161,161,13,2018,15015,-23,7,-16,178,180
13161,161,13,2019,15101,18,6,24,199,136
13161,161,13,2020,15213,79,4,83,194,165
13163,163,13,2010,16872,-17,0,-17,50,75
13163,163,13,2011,16772,-134,-4,-138,237,199
13163,163,13,2012,16351,-441,1,-440,220,217
13163,163,13,2013,16245,-102,6,-96,215,224
13163,163,13,2014,16127,-86,5,-81,184,223
13163,163,13,2015,15926,-191,10,-181,206,226
13163,163,13,2016,15773,-164,9,-155,221,219
13163,163,13,2017,15638,-138,8,-130,198,204
13163,163,13,2018,15423,-169,2,-167,183,230
13163,163,13,2019,15344,-24,2,-22,190,247
13163,163,13,2020,15267,-31,2,-29,188,237
13165,165,13,2010,8320,-8,-1,-9,34,40
13165,165,13,2011,8124,-202,-8,-210,104,91
13165,165,13,2012,9114,962,-4,958,102,131
13165,165,13,2013,9196,78,-6,72,100,92
13165,165,13,2014,9040,-145,-4,-149,99,109
13165,165,13,2015,8906,-177,28,-149,103,89
13165,165,13,2016,8823,-101,39,-62,82,103
13165,165,13,2017,8844,3,23,26,102,106
13165,165,13,2018,8790,-79,18,-61,112,105
13165,165,13,2019,8734,-83,17,-66,92,83
13165,165,13,2020,8746,10,14,24,98,111
13167,167,13,2010,9991,-14,0,-14,35,7
13167,167,13,2011,10003,14,0,14,85,86
13167,167,13,2012,10008,20,0,20,89,102
13167,167,13,2013,9909,-88,0,-88,99,112
13167,167,13,2014,9813,-70,-2,-72,59,83
13167,167,13,2015,9717,-93,-2,-95,85,86
13167,167,13,2016,9679,-36,-2,-38,106,105
13167,167,13,2017,9750,66,-2,64,110,104
13167,167,13,2018,9767,16,-2,14,107,104
13167,167,13,2019,9724,-36,-2,-38,106,110
13167,167,13,2020,9667,-16,-2,-18,105,144
13169,169,13,2010,28628,-29,1,-28,83,76
13169,169,13,2011,28724,-4,8,4,326,234
13169,169,13,2012,28610,-183,9,-174,317,262
13169,169,13,2013,28563,-103,0,-103,310,254
13169,169,13,2014,28641,8,-1,7,290,215
13169,169,13,2015,28432,-248,0,-248,308,271
13169,169,13,2016,28572,87,1,88,312,258
13169,169,13,2017,28459,-124,0,-124,272,261
13169,169,13,2018,28603,174,0,174,257,284
13169,169,13,2019,28689,86,0,86,293,293
13169,169,13,2020,28787,191,0,191,231,322
13171,171,13,2010,18260,-55,1,-54,46,41
13171,171,13,2011,18153,-122,5,-117,202,193
13171,171,13,2012,18026,-151,12,-139,193,190
13171,171,13,2013,17926,-132,32,-100,185,186
13171,171,13,2014,18187,264,28,292,184,225
13171,171,13,2015,18229,13,28,41,219,214
13171,171,13,2016,18462,193,37,230,202,201
13171,171,13,2017,18582,106,22,128,211,218
13171,171,13,2018,18866,277,20,297,201,216
13171,171,13,2019,19001,112,20,132,223,220
13171,171,13,2020,19261,267,12,279,216,235
13173,173,13,2010,10103,30,2,32,28,34
13173,173,13,2011,10481,312,4,316,132,75
13173,173,13,2012,10462,-93,31,-62,123,78
13173,173,13,2013,10405,-105,9,-96,131,95
13173,173,13,2014,10362,-114,7,-107,141,79
13173,173,13,2015,10264,-158,11,-147,147,98
13173,173,13,2016,10444,86,19,105,149,75
13173,173,13,2017,10456,-56,15,-41,152,98
13173,173,13,2018,10450,-67,10,-57,140,88
13173,173,13,2019,10581,85,14,99,135,102
13173,173,13,2020,10737,141,11,152,127,123
13175,175,13,2010,48388,-62,1,-61,178,164
13175,175,13,2011,47841,-671,6,-665,628,512
13175,175,13,2012,47819,-178,12,-166,699,552
13175,175,13,2013,47727,-195,4,-191,661,558
13175,175,13,2014,47553,-268,11,-257,630,546
13175,175,13,2015,47491,-187,18,-169,631,524
13175,175,13,2016,47287,-316,26,-290,633,546
13175,175,13,2017,47362,2,8,10,657,590
13175,175,13,2018,47293,-106,8,-98,597,567
13175,175,13,2019,47567,223,7,230,642,597
13175,175,13,2020,47512,-49,6,-43,620,634
13177,177,13,2010,28417,104,3,107,76,68
13177,177,13,2011,28585,-50,6,-44,362,149
13177,177,13,2012,28718,-105,24,-81,377,170
13177,177,13,2013,29055,147,28,175,364,201
13177,177,13,2014,29139,-101,19,-82,365,204
13177,177,13,2015,29191,-130,19,-111,369,209
13177,177,13,2016,29203,-145,29,-116,331,204
13177,177,13,2017,29429,108,9,117,324,214
13177,177,13,2018,29764,231,10,241,350,254
13177,177,13,2019,30045,183,5,188,345,251
13177,177,13,2020,30234,127,5,132,334,277
13179,179,13,2010,62772,-1238,90,-1148,354,113
13179,179,13,2011,65210,1404,104,1508,1220,302
13179,179,13,2012,64482,-3082,866,-2216,1690,303
13179,179,13,2013,62438,-3627,362,-3265,1424,312
13179,179,13,2014,64217,332,342,674,1363,303
13179,179,13,2015,61762,-4150,464,-3686,1524,350
13179,179,13,2016,61672,-1431,279,-1152,1420,360
13179,179,13,2017,61819,-939,85,-854,1390,381
13179,179,13,2018,60887,-1990,1,-1989,1444,394
13179,179,13,2019,62813,955,5,960,1353,388
13179,179,13,2020,63004,-880,37,-843,1429,390
13181,181,13,2010,7970,-28,0,-28,10,9
13181,181,13,2011,7872,-78,0,-78,60,81
13181,181,13,2012,7764,-107,7,-100,74,83
13181,181,13,2013,7734,-5,6,1,70,100
13181,181,13,2014,7644,-79,5,-74,66,84
13181,181,13,2015,7720,76,3,79,86,88
13181,181,13,2016,7859,126,5,131,88,80
13181,181,13,2017,7859,18,3,21,85,106
13181,181,13,2018,7927,100,3,103,68,102
13181,181,13,2019,7969,35,3,38,79,75
13181,181,13,2020,8031,92,3,95,78,110
13183,183,13,2010,14575,169,7,176,48,5
13183,183,13,2011,15097,433,9,442,152,75
13183,183,13,2012,16013,648,81,729,250,92
13183,183,13,2013,16510,275,63,338,241,89
13183,183,13,2014,17058,345,27,372,261,96
13183,183,13,2015,17695,375,54,429,306,105
13183,183,13,2016,18392,487,41,528,273,105
13183,183,13,2017,18822,223,9,232,284,87
13183,183,13,2018,19148,134,-10,124,299,98
13183,183,13,2019,19647,282,7,289,299,90
13183,183,13,2020,20171,379,2,381,261,116
13185,185,13,2010,109704,193,58,251,416,237
13185,185,13,2011,111519,769,101,870,1775,835
13185,185,13,2012,114141,1244,380,1624,1658,735
13185,185,13,2013,112985,-2286,285,-2001,1643,862
13185,185,13,2014,113630,-389,208,-181,1595,767
13185,185,13,2015,113501,-1220,311,-909,1629,863
13185,185,13,2016,114457,-47,268,221,1555,817
13185,185,13,2017,115495,287,124,411,1586,953
13185,185,13,2018,116361,208,56,264,1551,945
13185,185,13,2019,117600,445,105,550,1651,964
13185,185,13,2020,118268,-9,73,64,1639,1046
13187,187,13,2010,30281,242,8,250,85,37
13187,187,13,2011,30453,75,13,88,308,225
13187,187,13,2012,30684,85,11,96,357,220
13187,187,13,2013,30872,118,6,124,298,237
13187,187,13,2014,31122,170,6,176,314,240
13187,187,13,2015,31292,183,-1,182,260,274
13187,187,13,2016,31422,126,-1,125,286,281
13187,187,13,2017,32812,1363,-4,1359,314,297
13187,187,13,2018,32934,169,-5,164,279,322
13187,187,13,2019,33692,779,-10,769,290,302
13187,187,13,2020,34186,541,-3,538,286,328
13189,189,13,2010,21803,-32,0,-32,84,113
13189,189,13,2011,21614,-250,-3,-253,304,241
13189,189,13,2012,21630,-86,-9,-95,301,190
13189,189,13,2013,21506,-170,-8,-178,299,247
13189,189,13,2014,21529,-62,-8,-70,307,210
13189,189,13,2015,21470,-77,-8,-85,267,240
13189,189,13,2016,21481,-72,-13,-85,310,214
13189,189,13,2017,21517,16,-14,2,281,246
13189,189,13,2018,21545,47,-16,31,280,282
13189,189,13,2019,21317,-220,-18,-238,261,250
13189,189,13,2020,21162,-124,-13,-137,270,288
13191,191,13,2010,14312,-33,0,-33,25,11
13191,191,13,2011,14226,-97,0,-97,135,124
13191,191,13,2012,13887,-356,0,-356,109,105
13191,191,13,2013,14030,119,0,119,137,117
13191,191,13,2014,14067,33,0,33,125,121
13191,191,13,2015,14033,2,-1,1,114,146
13191,191,13,2016,14068,49,5,54,112,131
13191,191,13,2017,14092,45,3,48,121,145
13191,191,13,2018,14243,176,3,179,105,132
13191,191,13,2019,14294,66,3,69,107,126
13191,191,13,2020,14387,131,2,133,103,143
13193,193,13,2010,14644,-93,7,-86,34,52
13193,193,13,2011,14452,-218,20,-198,155,151
13193,193,13,2012,14297,-190,19,-171,154,142
13193,193,13,2013,13973,-326,4,-322,126,134
13193,193,13,2014,13822,-128,5,-123,121,153
13193,193,13,2015,13689,-125,7,-118,142,156
13193,193,13,2016,13483,-207,8,-199,140,149
13193,193,13,2017,13255,-201,1,-200,146,174
13193,193,13,2018,13153,-60,0,-60,120,162
13193,193,13,2019,12934,-198,0,-198,133,154
13193,193,13,2020,12712,-174,0,-174,131,180
13195,195,13,2010,28221,-1,2,1,91,42
13195,195,13,2011,28186,-91,15,-76,325,285
13195,195,13,2012,28081,-157,17,-140,318,284
13195,195,13,2013,28213,62,30,92,334,289
13195,195,13,2014,28376,114,16,130,346,309
13195,195,13,2015,28431,-29,30,1,352,295
13195,195,13,2016,28833,325,13,338,332,268
13195,195,13,2017,29253,363,5,368,345,294
13195,195,13,2018,29653,346,3,349,339,287
13195,195,13,2019,29925,258,5,263,333,324
13195,195,13,2020,30457,498,2,500,355,320
13197,197,13,2010,8741,8,4,12,24,32
13197,197,13,2011,8699,-90,20,-70,103,75
13197,197,13,2012,8672,-62,21,-41,99,88
13197,197,13,2013,8581,-112,-1,-113,82,60
13197,197,13,2014,8636,40,-3,37,94,77
13197,197,13,2015,8561,-82,4,-78,86,84
13197,197,13,2016,8490,-99,17,-82,88,77
13197,197,13,2017,8438,-67,13,-54,87,86
13197,197,13,2018,8392,-50,18,-32,81,95
13197,197,13,2019,8413,3,-5,-2,91,68
13197,197,13,2020,8516,126,3,129,83,108
13199,199,13,2010,21817,-142,1,-141,60,86
13199,199,13,2011,21596,-214,2,-212,243,252
13199,199,13,2012,21331,-323,2,-321,282,230
13199,199,13,2013,21214,-84,0,-84,209,242
13199,199,13,2014,21201,-10,1,-9,258,257
13199,199,13,2015,21167,-52,2,-50,280,262
13199,199,13,2016,21052,-69,2,-67,242,289
13199,199,13,2017,21011,0,-1,-1,261,298
13199,199,13,2018,21061,62,-1,61,254,264
13199,199,13,2019,21112,100,-2,98,234,282
13199,199,13,2020,21164,127,-1,126,234,307
13201,201,13,2010,6133,6,1,7,10,10
13201,201,13,2011,6072,-63,1,-62,90,89
13201,201,13,2012,6004,-76,4,-72,73,71
13201,201,13,2013,5900,-87,0,-87,67,86
13201,201,13,2014,5943,42,0,42,67,64
13201,201,13,2015,5847,-72,0,-72,64,89
13201,201,13,2016,5875,56,0,56,62,89
13201,201,13,2017,5816,-22,0,-22,59,96
13201,201,13,2018,5646,-158,0,-158,72,85
13201,201,13,2019,5667,30,0,30,70,79
13201,201,13,2020,5622,-19,0,-19,66,91
13205,205,13,2010,23502,1,0,1,77,74
13205,205,13,2011,23399,-162,-7,-169,300,234
13205,205,13,2012,23086,-396,-1,-397,294,222
13205,205,13,2013,22990,-152,3,-149,289,236
13205,205,13,2014,22712,-316,6,-310,244,218
13205,205,13,2015,22449,-313,28,-285,280,262
13205,205,13,2016,22443,-48,26,-22,260,242
13205,205,13,2017,22313,-154,16,-138,262,254
13205,205,13,2018,22156,-128,13,-115,244,286
13205,205,13,2019,21846,-279,11,-268,241,283
13205,205,13,2020,21602,-208,10,-198,215,259
13207,207,13,2010,26133,27,1,28,73,86
13207,207,13,2011,26301,129,5,134,272,237
13207,207,13,2012,26336,-39,6,-33,298,229
13207,207,13,2013,26585,244,-3,241,263,254
13207,207,13,2014,26637,22,8,30,278,251
13207,207,13,2015,26683,49,-4,45,261,256
13207,207,13,2016,26880,202,5,207,270,278
13207,207,13,2017,27153,294,4,298,276,301
13207,207,13,2018,27523,426,2,428,256,312
13207,207,13,2019,27677,192,1,193,274,314
13207,207,13,2020,28042,466,4,470,245,346
13209,209,13,2010,9140,-38,0,-38,33,34
13209,209,13,2011,9027,-139,-1,-140,112,86
13209,209,13,2012,8883,-183,4,-179,103,75
13209,209,13,2013,8954,40,11,51,110,91
13209,209,13,2014,8978,-7,3,-4,95,65
13209,209,13,2015,8939,-14,4,-10,79,108
13209,209,13,2016,8996,34,12,46,93,80
13209,209,13,2017,9032,28,7,35,86,85
13209,209,13,2018,9157,107,7,114,105,96
13209,209,13,2019,9148,-29,7,-22,98,85
13209,209,13,2020,9012,-140,5,-135,98,98
13211,211,13,2010,17897,-1,-1,-2,57,24
13211,211,13,2011,17906,7,-2,5,198,193
13211,211,13,2012,17807,-110,-3,-113,183,170
13211,211,13,2013,17681,-90,-1,-91,151,186
13211,211,13,2014,17894,179,-1,178,207,175
13211,211,13,2015,17947,54,0,54,188,189
13211,211,13,2016,18097,150,2,152,189,190
13211,211,13,2017,18374,243,3,246,223,192
13211,211,13,2018,18808,430,1,431,197,191
13211,211,13,2019,19239,394,0,394,211,173
13211,211,13,2020,19636,353,3,356,210,168
13213,213,13,2010,39532,-125,-1,-126,110,85
13213,213,13,2011,39363,-321,-3,-324,500,345
13213,213,13,2012,39311,-214,1,-213,487,326
13213,213,13,2013,39173,-300,10,-290,518,370
13213,213,13,2014,39212,-109,4,-105,520,368
13213,213,13,2015,39426,11,70,81,498,361
13213,213,13,2016,39322,-249,39,-210,484,378
13213,213,13,2017,39761,315,9,324,513,397
13213,213,13,2018,39836,-25,3,-22,480,382
13213,213,13,2019,39996,58,0,58,491,390
13213,213,13,2020,40032,22,2,24,465,455
13215,215,13,2010,191122,-29,164,135,831,390
13215,215,13,2011,195340,2658,272,2930,3025,1760
13215,215,13,2012,199077,890,1243,2133,3336,1746
13215,215,13,2013,203370,2075,747,2822,3177,1795
13215,215,13,2014,200746,-4607,560,-4047,3115,1840
13215,215,13,2015,198925,-3900,816,-3084,3013,1804
13215,215,13,2016,196354,-4138,529,-3609,2994,1974
13215,215,13,2017,193858,-3623,240,-3383,2832,1964
13215,215,13,2018,194362,-481,130,-351,2830,1972
13215,215,13,2019,196074,853,161,1014,2741,2050
13215,215,13,2020,196442,-481,145,-336,2794,2102
13217,217,13,2010,100128,54,3,57,341,225
13217,217,13,2011,100446,-355,24,-331,1377,730
13217,217,13,2012,100965,-103,58,-45,1299,718
13217,217,13,2013,102060,557,62,619,1313,825
13217,217,13,2014,103470,832,59,891,1345,824
13217,217,13,2015,104920,933,77,1010,1304,865
13217,217,13,2016,106529,989,108,1097,1339,825
13217,217,13,2017,107903,768,67,835,1393,850
13217,217,13,2018,109556,1177,54,1231,1313,892
13217,217,13,2019,111894,1890,47,1937,1383,976
13217,217,13,2020,113295,1006,45,1051,1401,1049
13219,219,13,2010,32935,62,7,69,98,72
13219,219,13,2011,33269,217,23,240,307,211
13219,219,13,2012,33521,113,15,128,314,195
13219,219,13,2013,34084,434,8,442,341,222
13219,219,13,2014,35077,857,6,863,315,194
13219,219,13,2015,35861,654,13,667,341,224
13219,219,13,2016,36928,904,75,979,349,260
13219,219,13,2017,38122,1000,73,1073,367,243
13219,219,13,2018,39500,1185,106,1291,359,269
13219,219,13,2019,40296,739,-2,737,355,289
13219,219,13,2020,41124,755,28,783,345,293
13221,221,13,2010,14891,17,1,18,39,38
13221,221,13,2011,14700,-229,8,-221,156,127
13221,221,13,2012,14500,-248,20,-228,146,123
13221,221,13,2013,14415,-122,5,-117,141,110
13221,221,13,2014,14532,93,2,95,169,143
13221,221,13,2015,14722,179,5,184,157,151
13221,221,13,2016,14710,-36,-2,-38,175,149
13221,221,13,2017,14851,160,-1,159,136,155
13221,221,13,2018,15034,159,1,160,183,159
13221,221,13,2019,15222,173,0,173,160,145
13221,221,13,2020,15383,205,0,205,146,189
13223,223,13,2010,142826,126,20,146,508,214
13223,223,13,2011,143606,-429,40,-389,1866,700
13223,223,13,2012,144750,-123,107,-16,1885,713
13223,223,13,2013,146775,902,90,992,1850,812
13223,223,13,2014,148562,669,54,723,1856,774
13223,223,13,2015,151691,2079,64,2143,1851,882
13223,223,13,2016,155415,2510,136,2646,1958,888
13223,223,13,2017,159642,3160,93,3253,1909,946
13223,223,13,2018,164482,3834,93,3927,1918,1012
13223,223,13,2019,169302,3922,32,3954,1976,1101
13223,223,13,2020,173359,3378,42,3420,1887,1235
13225,225,13,2010,28104,1,0,1,81,29
13225,225,13,2011,28031,-162,8,-154,317,236
13225,225,13,2012,28012,-128,31,-97,314,234
13225,225,13,2013,27411,-707,26,-681,292,238
13225,225,13,2014,27391,-105,19,-86,298,229
13225,225,13,2015,27216,-274,32,-242,305,243
13225,225,13,2016,27111,-135,25,-110,287,282
13225,225,13,2017,27179,73,4,77,274,282
13225,225,13,2018,27574,358,0,358,313,279
13225,225,13,2019,27697,116,-3,113,308,297
13225,225,13,2020,27950,221,1,222,333,302
13227,227,13,2010,29434,6,3,9,77,51
13227,227,13,2011,29390,-73,16,-57,308,294
13227,227,13,2012,29258,-141,15,-126,287,293
13227,227,13,2013,29389,122,16,138,300,310
13227,227,13,2014,29807,448,-1,447,293,335
13227,227,13,2015,30139,294,3,297,318,285
13227,227,13,2016,30654,538,3,541,306,332
13227,227,13,2017,31542,930,0,930,311,358
13227,227,13,2018,32039,524,-1,523,315,342
13227,227,13,2019,32648,666,-2,664,293,348
13227,227,13,2020,33127,581,-1,580,301,398
13229,229,13,2010,18813,33,1,34,55,37
13229,229,13,2011,18769,-91,2,-89,241,196
13229,229,13,2012,18902,77,10,87,226,179
13229,229,13,2013,19015,57,0,57,259,202
13229,229,13,2014,19004,-2,-6,-8,212,211
13229,229,13,2015,19089,59,-8,51,235,198
13229,229,13,2016,19116,-33,-3,-36,263,200
13229,229,13,2017,19200,62,-4,58,242,214
13229,229,13,2018,19398,142,-4,138,255,197
13229,229,13,2019,19443,40,-5,35,246,235
13229,229,13,2020,19522,84,-4,80,250,253
13231,231,13,2010,17929,30,0,30,41,19
13231,231,13,2011,17792,-156,0,-156,167,148
13231,231,13,2012,17780,1,3,4,155,169
13231,231,13,2013,17784,4,2,6,175,178
13231,231,13,2014,17774,6,0,6,145,156
13231,231,13,2015,17935,184,3,187,151,177
13231,231,13,2016,17916,-18,3,-15,167,168
13231,231,13,2017,18213,290,2,292,191,186
13231,231,13,2018,18622,424,2,426,168,184
13231,231,13,2019,18953,307,2,309,212,188
13231,231,13,2020,19121,176,1,177,209,217
13233,233,13,2010,41537,-21,14,-7,148,86
13233,233,13,2011,41277,-444,42,-402,601,461
13233,233,13,2012,41097,-342,47,-295,562,451
13233,233,13,2013,40972,-266,62,-204,546,467
13233,233,13,2014,40876,-182,16,-166,561,484
13233,233,13,2015,41209,255,-5,250,542,457
13233,233,13,2016,41584,266,17,283,574,483
13233,233,13,2017,41842,211,8,219,565,527
13233,233,13,2018,42373,449,5,454,556,479
13233,233,13,2019,42616,207,4,211,549,518
13233,233,13,2020,42840,199,7,206,574,557
13235,235,13,2010,11989,-46,0,-46,29,10
13235,235,13,2011,11855,-103,-2,-105,87,117
13235,235,13,2012,11716,-139,-3,-142,97,97
13235,235,13,2013,11578,-117,-4,-121,94,114
13235,235,13,2014,11520,-24,-4,-28,79,105
13235,235,13,2015,11409,-95,-2,-97,102,117
13235,235,13,2016,11296,-73,-1,-74,79,118
13235,235,13,2017,11197,-62,0,-62,87,125
13235,235,13,2018,11079,-114,0,-114,96,100
13235,235,13,2019,11161,84,0,84,88,90
13235,235,13,2020,11191,72,0,72,102,145
13237,237,13,2010,21192,4,-2,2,48,73
13237,237,13,2011,21242,5,-2,3,267,218
13237,237,13,2012,21135,-158,0,-158,259,211
13237,237,13,2013,21280,154,2,156,231,244
13237,237,13,2014,21142,-146,6,-140,229,228
13237,237,13,2015,21310,161,11,172,234,238
13237,237,13,2016,21502,213,4,217,230,255
13237,237,13,2017,21676,195,1,196,215,235
13237,237,13,2018,21749,103,-1,102,224,253
13237,237,13,2019,22083,336,1,337,232,236
13237,237,13,2020,22520,515,2,517,230,307
13239,239,13,2010,2512,7,0,7,8,13
13239,239,13,2011,2454,-62,0,-62,26,21
13239,239,13,2012,2407,-33,0,-33,26,41
13239,239,13,2013,2368,-39,0,-39,23,24
13239,239,13,2014,2287,-63,0,-63,19,39
13239,239,13,2015,2277,-2,0,-2,21,28
13239,239,13,2016,2323,42,0,42,30,26
13239,239,13,2017,2334,14,0,14,20,24
13239,239,13,2018,2254,-65,0,-65,31,45
13239,239,13,2019,2300,60,0,60,17,30
13239,239,13,2020,2271,-7,0,-7,18,39
13241,241,13,2010,16276,-5,-1,-6,44,33
13241,241,13,2011,16257,12,2,14,137,169
13241,241,13,2012,16303,61,7,68,157,177
13241,241,13,2013,16184,-53,12,-41,129,204
13241,241,13,2014,16159,27,7,34,151,206
13241,241,13,2015,16224,117,10,127,148,211
13241,241,13,2016,16493,312,17,329,171,231
13241,241,13,2017,16560,119,8,127,155,213
13241,241,13,2018,16853,337,6,343,147,197
13241,241,13,2019,17116,330,4,334,144,214
13241,241,13,2020,17273,253,4,257,154,254
13243,243,13,2010,7668,-32,0,-32,18,41
13243,243,13,2011,7570,-120,1,-119,106,85
13243,243,13,2012,7310,-253,-1,-254,81,96
13243,243,13,2013,7202,-117,0,-117,95,88
13243,243,13,2014,7315,118,0,118,80,91
13243,243,13,2015,7153,-153,0,-153,80,90
13243,243,13,2016,7150,21,0,21,67,90
13243,243,13,2017,6974,-158,0,-158,80,97
13243,243,13,2018,6826,-132,0,-132,70,87
13243,243,13,2019,6806,2,0,2,61,83
13243,243,13,2020,6682,-97,0,-97,58,83
13245,245,13,2010,201122,180,142,322,689,467
13245,245,13,2011,200618,-1815,190,-1625,3016,1901
13245,245,13,2012,201827,-627,692,65,3024,1850
13245,245,13,2013,201457,-1985,465,-1520,3017,1890
13245,245,13,2014,201448,-1293,301,-992,2964,1947
13245,245,13,2015,201639,-1304,456,-848,2936,1884
13245,245,13,2016,202179,-739,373,-366,2919,2003
13245,245,13,2017,201965,-1317,227,-1090,2821,1940
13245,245,13,2018,202027,-967,143,-824,2902,2009
13245,245,13,2019,202639,-216,123,-93,2808,2109
13245,245,13,2020,202079,-1250,125,-1125,2817,2254
13247,247,13,2010,85359,38,12,50,233,96
13247,247,13,2011,85423,-447,27,-420,1065,583
13247,247,13,2012,85453,-493,73,-420,995,573
13247,247,13,2013,86522,685,126,811,938,678
13247,247,13,2014,87222,328,38,366,990,637
13247,247,13,2015,88424,750,88,838,1001,631
13247,247,13,2016,88995,208,43,251,1023,698
13247,247,13,2017,89800,544,20,564,961,712
13247,247,13,2018,90402,369,7,376,977,745
13247,247,13,2019,90639,111,-3,108,954,827
13247,247,13,2020,90939,141,6,147,954,805
13249,249,13,2010,5020,-3,0,-3,12,1
13249,249,13,2011,5043,-9,-1,-10,62,30
13249,249,13,2012,5023,-29,0,-29,48,40
13249,249,13,2013,5095,67,0,67,48,42
13249,249,13,2014,5189,74,0,74,49,31
13249,249,13,2015,5208,11,15,26,41,48
13249,249,13,2016,5179,-69,19,-50,56,33
13249,249,13,2017,5236,34,12,46,54,43
13249,249,13,2018,5212,-46,12,-34,46,36
13249,249,13,2019,5254,5,12,17,52,27
13249,249,13,2020,5196,-75,10,-65,50,45
13251,251,13,2010,14499,-90,0,-90,50,56
13251,251,13,2011,14403,-132,3,-129,216,183
13251,251,13,2012,14170,-267,3,-264,196,175
13251,251,13,2013,14145,-42,4,-38,179,162
13251,251,13,2014,14001,-137,3,-134,184,197
13251,251,13,2015,14060,61,3,64,161,167
13251,251,13,2016,14015,-59,2,-57,181,167
13251,251,13,2017,13953,-81,1,-80,171,153
13251,251,13,2018,13960,-31,1,-30,201,164
13251,251,13,2019,13945,-10,1,-9,172,176
13251,251,13,2020,14012,79,1,80,175,190
13253,253,13,2010,8727,-6,0,-6,19,14
13253,253,13,2011,8766,36,0,36,119,116
13253,253,13,2012,8869,104,-1,103,103,105
13253,253,13,2013,8844,0,-1,-1,98,121
13253,253,13,2014,8596,-241,0,-241,106,117
13253,253,13,2015,8559,4,0,4,91,133
13253,253,13,2016,8424,-89,0,-89,88,132
13253,253,13,2017,8249,-127,0,-127,94,143
13253,253,13,2018,8266,56,0,56,94,133
13253,253,13,2019,8090,-147,0,-147,86,114
13253,253,13,2020,8060,0,0,0,86,115
13255,255,13,2010,64096,-58,10,-48,228,190
13255,255,13,2011,64045,-304,22,-282,909,678
13255,255,13,2012,63693,-548,34,-514,830,677
13255,255,13,2013,63521,-298,21,-277,813,706
13255,255,13,2014,63703,75,8,83,832,718
13255,255,13,2015,63826,42,9,51,829,749
13255,255,13,2016,64523,655,4,659,792,759
13255,255,13,2017,65348,777,-1,776,798,752
13255,255,13,2018,66092,723,-7,716,866,836
13255,255,13,2019,66835,637,-6,631,869,757
13255,255,13,2020,67414,607,-4,603,848,872
13257,257,13,2010,26124,-11,4,-7,65,92
13257,257,13,2011,25763,-357,10,-347,307,324
13257,257,13,2012,25721,9,-8,1,311,349
13257,257,13,2013,25571,-91,4,-87,311,373
13257,257,13,2014,25429,-153,-1,-154,305,292
13257,257,13,2015,25475,78,3,81,304,337
13257,257,13,2016,25680,226,18,244,327,365
13257,257,13,2017,25785,160,6,166,285,346
13257,257,13,2018,26083,333,1,334,336,372
13257,257,13,2019,26017,22,1,23,295,384
13257,257,13,2020,26107,162,3,165,311,385
13259,259,13,2010,6099,44,2,46,11,25
13259,259,13,2011,6065,-50,18,-32,64,66
13259,259,13,2012,6106,24,40,64,45,69
13259,259,13,2013,5555,-649,95,-554,41,65
13259,259,13,2014,5882,233,111,344,46,76
13259,259,13,2015,5969,-84,187,103,52,69
13259,259,13,2016,6129,-85,275,190,35,66
13259,259,13,2017,6329,24,192,216,46,61
13259,259,13,2018,6434,-28,174,146,33,73
13259,259,13,2019,6649,47,178,225,35,45
13259,259,13,2020,6689,-72,141,69,40,70
13261,261,13,2010,32608,-131,0,-131,115,124
13261,261,13,2011,31993,-710,3,-707,420,335
13261,261,13,2012,31509,-614,10,-604,460,356
13261,261,13,2013,31265,-329,6,-323,384,305
13261,261,13,2014,31089,-252,6,-246,376,311
13261,261,13,2015,30625,-530,29,-501,372,341
13261,261,13,2016,30334,-359,61,-298,377,372
13261,261,13,2017,29838,-536,34,-502,391,385
13261,261,13,2018,29713,-115,23,-92,382,414
13261,261,13,2019,29401,-325,22,-303,345,354
13261,261,13,2020,29282,-113,18,-95,338,363
13263,263,13,2010,6883,-15,0,-15,12,6
13263,263,13,2011,6854,-28,0,-28,70,71
13263,263,13,2012,6643,-209,0,-209,68,78
13263,263,13,2013,6556,-51,0,-51,46,81
13263,263,13,2014,6535,-6,0,-6,61,75
13263,263,13,2015,6499,7,0,7,50,91
13263,263,13,2016,6361,-98,0,-98,39,79
13263,263,13,2017,6254,-80,0,-80,62,90
13263,263,13,2018,6281,57,0,57,50,79
13263,263,13,2019,6188,-72,0,-72,58,81
13263,263,13,2020,6143,2,0,2,56,101
13265,265,13,2010,1703,-15,0,-15,3,2
13265,265,13,2011,1705,15,0,15,16,29
13265,265,13,2012,1673,-19,0,-19,11,24
13265,265,13,2013,1687,12,3,15,21,21
13265,265,13,2014,1691,11,0,11,16,23
13265,265,13,2015,1641,-39,1,-38,13,26
13265,265,13,2016,1616,-18,2,-16,20,29
13265,265,13,2017,1612,4,1,5,6,16
13265,265,13,2018,1610,5,1,6,16,24
13265,265,13,2019,1549,-53,0,-53,13,20
13265,265,13,2020,1562,29,1,30,13,30
13267,267,13,2010,25470,-51,2,-49,81,71
13267,267,13,2011,25435,-153,7,-146,341,230
13267,267,13,2012,25457,-108,12,-96,350,232
13267,267,13,2013,25632,56,6,62,315,204
13267,267,13,2014,25319,-353,-1,-354,252,221
13267,267,13,2015,25394,35,49,84,258,265
13267,267,13,2016,25352,-151,86,-65,265,242
13267,267,13,2017,25420,-1,75,74,255,259
13267,267,13,2018,25508,6,92,98,241,251
13267,267,13,2019,25317,-244,36,-208,243,227
13267,267,13,2020,25365,39,40,79,247,280
13269,269,13,2010,8853,-115,0,-115,22,48
13269,269,13,2011,8513,-325,-1,-326,82,100
13269,269,13,2012,8434,-92,0,-92,94,82
13269,269,13,2013,8456,27,1,28,87,95
13269,269,13,2014,8453,6,0,6,94,104
13269,269,13,2015,8316,-126,0,-126,87,100
13269,269,13,2016,8256,-34,0,-34,75,100
13269,269,13,2017,8181,-57,-3,-60,94,109
13269,269,13,2018,8067,-78,-2,-80,73,108
13269,269,13,2019,8051,-23,-2,-25,94,85
13269,269,13,2020,8074,29,0,29,84,88
13271,271,13,2010,16519,4,5,9,35,16
13271,271,13,2011,16242,-293,0,-293,158,144
13271,271,13,2012,16364,117,36,153,117,154
13271,271,13,2013,16624,231,39,270,128,147
13271,271,13,2014,16448,-173,15,-158,134,154
13271,271,13,2015,16448,-49,67,18,133,151
13271,271,13,2016,15960,-573,89,-484,132,141
13271,271,13,2017,15912,-64,55,-9,129,166
13271,271,13,2018,15888,-43,49,6,137,166
13271,271,13,2019,15813,-138,50,-88,125,112
13271,271,13,2020,15781,-19,39,20,124,178
13273,273,13,2010,9525,-3,0,-3,29,7
13273,273,13,2011,9390,-160,0,-160,127,104
13273,273,13,2012,9225,-211,0,-211,139,99
13273,273,13,2013,9167,-93,0,-93,143,108
13273,273,13,2014,9081,-103,0,-103,121,105
13273,273,13,2015,9016,-64,0,-64,105,105
13273,273,13,2016,8873,-147,0,-147,116,113
13273,273,13,2017,8698,-164,0,-164,93,104
13273,273,13,2018,8601,-67,0,-67,98,129
13273,273,13,2019,8573,-21,0,-21,107,114
13273,273,13,2020,8523,-48,0,-48,107,109
13275,275,13,2010,44744,13,4,17,159,145
13275,275,13,2011,44591,-215,8,-207,554,500
13275,275,13,2012,44535,-164,14,-150,592,495
13275,275,13,2013,44783,125,24,149,597,496
13275,275,13,2014,44784,-158,40,-118,611,484
13275,275,13,2015,44819,-73,31,-42,569,487
13275,275,13,2016,44967,82,29,111,550,509
13275,275,13,2017,44623,-398,12,-386,577,535
13275,275,13,2018,44336,-288,6,-282,515,521
13275,275,13,2019,44427,133,8,141,509,558
13275,275,13,2020,44372,-7,6,-1,521,577
13277,277,13,2010,40250,48,-3,45,128,57
13277,277,13,2011,41160,737,-4,733,559,389
13277,277,13,2012,40947,-410,2,-408,565,378
13277,277,13,2013,40180,-996,3,-993,567,376
13277,277,13,2014,40456,110,1,111,570,406
13277,277,13,2015,40538,-124,11,-113,604,407
13277,277,13,2016,40562,-159,27,-132,570,411
13277,277,13,2017,40455,-250,16,-234,548,421
13277,277,13,2018,40562,18,11,29,551,471
13277,277,13,2019,40653,-6,-3,-9,544,445
13277,277,13,2020,40719,-12,5,-7,537,466
13279,279,13,2010,27248,18,5,23,94,40
13279,279,13,2011,27198,-177,-9,-186,410,276
13279,279,13,2012,27170,-108,-7,-115,409,325
13279,279,13,2013,27184,-87,2,-85,393,291
13279,279,13,2014,27131,-124,-8,-132,395,312
13279,279,13,2015,27151,-62,-4,-66,417,327
13279,279,13,2016,27141,-114,-1,-115,408,302
13279,279,13,2017,26868,-259,-4,-263,333,342
13279,279,13,2018,26910,-35,-1,-36,387,308
13279,279,13,2019,26844,-97,-16,-113,361,313
13279,279,13,2020,26973,124,-9,115,364,350
13281,281,13,2010,10531,58,0,58,20,25
13281,281,13,2011,10577,141,-1,140,76,171
13281,281,13,2012,10560,65,3,68,75,163
13281,281,13,2013,10784,293,2,295,83,160
13281,281,13,2014,11081,358,2,360,84,161
13281,281,13,2015,11208,195,6,201,77,153
13281,281,13,2016,11416,279,12,291,90,174
13281,281,13,2017,11557,240,8,248,105,213
13281,281,13,2018,11844,385,7,392,86,193
13281,281,13,2019,12009,237,7,244,94,170
13281,281,13,2020,12247,325,6,331,100,193
13283,283,13,2010,6892,-8,0,-8,23,5
13283,283,13,2011,6823,-49,0,-49,70,90
13283,283,13,2012,6787,-61,3,-58,78,56
13283,283,13,2013,6686,-99,5,-94,72,80
13283,283,13,2014,6813,103,7,110,79,63
13283,283,13,2015,6807,-26,9,-17,83,72
13283,283,13,2016,6720,-115,15,-100,77,65
13283,283,13,2017,6751,35,6,41,78,87
13283,283,13,2018,6780,46,4,50,71,92
13283,283,13,2019,6860,58,3,61,73,53
13283,283,13,2020,6822,-25,0,-25,69,82
13285,285,13,2010,67060,33,10,43,185,203
13285,285,13,2011,67651,258,21,279,942,629
13285,285,13,2012,68324,366,40,406,893,617
13285,285,13,2013,68859,266,84,350,867,683
13285,285,13,2014,69341,152,85,237,895,639
13285,285,13,2015,69666,-100,125,25,995,687
13285,285,13,2016,69990,-13,166,153,901,726
13285,285,13,2017,70123,-167,120,-47,859,677
13285,285,13,2018,70091,-285,101,-184,892,737
13285,285,13,2019,70059,-341,104,-237,939,737
13285,285,13,2020,70214,-33,85,52,910,810
13287,287,13,2010,8909,-12,0,-12,27,42
13287,287,13,2011,8941,30,0,30,121,118
13287,287,13,2012,8446,-530,-5,-535,102,86
13287,287,13,2013,8208,-269,-4,-273,113,91
13287,287,13,2014,8069,-139,-4,-143,121,118
13287,287,13,2015,7988,-37,0,-37,102,143
13287,287,13,2016,7970,-44,1,-43,135,111
13287,287,13,2017,7902,-34,0,-34,88,121
13287,287,13,2018,7917,-4,0,-4,125,105
13287,287,13,2019,7929,37,0,37,108,133
13287,287,13,2020,7882,-44,-1,-45,124,127
13289,289,13,2010,8983,-53,0,-53,14,17
13289,289,13,2011,8836,-140,5,-135,105,117
13289,289,13,2012,8560,-312,2,-310,107,82
13289,289,13,2013,8522,-14,1,-13,94,119
13289,289,13,2014,8399,-105,12,-93,87,118
13289,289,13,2015,8353,-45,17,-28,85,102
13289,289,13,2016,8263,-88,30,-58,98,129
13289,289,13,2017,8268,-18,20,2,90,87
13289,289,13,2018,8179,-54,14,-40,79,127
13289,289,13,2019,8164,5,16,21,73,108
13289,289,13,2020,8103,5,13,18,69,148
13291,291,13,2010,21384,22,2,24,40,48
13291,291,13,2011,21265,17,4,21,164,301
13291,291,13,2012,21342,188,4,192,167,282
13291,291,13,2013,21440,256,6,262,140,308
13291,291,13,2014,21782,483,9,492,155,314
13291,291,13,2015,22029,375,-5,370,181,308
13291,291,13,2016,22664,764,-1,763,171,301
13291,291,13,2017,23406,890,0,890,170,322
13291,291,13,2018,23961,732,-2,730,161,339
13291,291,13,2019,24606,791,0,791,178,321
13291,291,13,2020,25358,905,-1,904,169,316
13293,293,13,2010,27052,-63,3,-60,82,119
13293,293,13,2011,26919,-122,0,-122,341,350
13293,293,13,2012,26561,-356,-4,-360,306,314
13293,293,13,2013,26425,-90,-4,-94,333,372
13293,293,13,2014,26166,-208,-1,-209,309,359
13293,293,13,2015,26237,74,2,76,362,365
13293,293,13,2016,26243,44,3,47,309,349
13293,293,13,2017,26223,3,7,10,346,375
13293,293,13,2018,26249,107,7,114,302,387
13293,293,13,2019,26402,275,7,282,309,437
13293,293,13,2020,26527,249,4,253,298,425
13295,295,13,2010,68876,76,5,81,180,124
13295,295,13,2011,68825,-147,-5,-152,722,619
13295,295,13,2012,68487,-377,-6,-383,737,692
13295,295,13,2013,68643,204,-11,193,728,757
13295,295,13,2014,68714,65,9,74,734,718
13295,295,13,2015,68604,-136,33,-103,778,776
13295,295,13,2016,68509,-60,67,7,728,828
13295,295,13,2017,69087,680,36,716,740,876
13295,295,13,2018,69507,424,26,450,765,791
13295,295,13,2019,69769,352,30,382,733,854
13295,295,13,2020,70116,478,24,502,731,887
13297,297,13,2010,83997,73,5,78,261,143
13297,297,13,2011,84647,340,-6,334,1085,766
13297,297,13,2012,84998,-77,34,-43,1088,689
13297,297,13,2013,86068,705,56,761,1045,736
13297,297,13,2014,87557,1098,49,1147,1057,722
13297,297,13,2015,88373,579,37,616,1038,833
13297,297,13,2016,89886,1200,62,1262,1063,813
13297,297,13,2017,91389,1263,18,1281,1023,802
13297,297,13,2018,93450,1865,8,1873,1086,900
13297,297,13,2019,94818,1246,7,1253,1052,934
13297,297,13,2020,96875,1878,14,1892,1157,985
13299,299,13,2010,36308,18,2,20,127,134
13299,299,13,2011,36279,-110,4,-106,513,433
13299,299,13,2012,35896,-478,15,-463,502,435
13299,299,13,2013,35745,-212,25,-187,479,440
13299,299,13,2014,35520,-256,5,-251,460,440
13299,299,13,2015,35337,-218,-1,-219,475,439
13299,299,13,2016,35675,271,18,289,506,456
13299,299,13,2017,35705,2,10,12,475,455
13299,299,13,2018,35703,-41,7,-34,509,477
13299,299,13,2019,35816,145,8,153,480,520
13299,299,13,2020,35826,-11,4,-7,503,488
13301,301,13,2010,5782,-33,0,-33,13,34
13301,301,13,2011,5679,-94,0,-94,69,79
13301,301,13,2012,5546,-143,1,-142,75,68
13301,301,13,2013,5520,-4,1,-3,57,81
13301,301,13,2014,5459,-34,1,-33,41,68
13301,301,13,2015,5375,-50,2,-48,55,90
13301,301,13,2016,5355,11,0,11,62,93
13301,301,13,2017,5263,-68,0,-68,56,80
13301,301,13,2018,5227,-34,0,-34,66,68
13301,301,13,2019,5220,-3,0,-3,58,61
13301,301,13,2020,5232,24,0,24,59,72
13303,303,13,2010,21096,-55,0,-55,53,87
13303,303,13,2011,20971,-152,0,-152,235,208
13303,303,13,2012,20791,-249,-1,-250,265,202
13303,303,13,2013,20575,-266,0,-266,221,180
13303,303,13,2014,20549,-72,0,-72,258,212
13303,303,13,2015,20734,178,2,180,231,228
13303,303,13,2016,20349,-378,7,-371,228,245
13303,303,13,2017,20313,-12,3,-9,210,237
13303,303,13,2018,20418,102,1,103,225,223
13303,303,13,2019,20352,-42,1,-41,228,253
13303,303,13,2020,20150,-168,1,-167,222,257
13305,305,13,2010,30080,-8,-2,-10,104,115
13305,305,13,2011,30301,79,-4,75,442,293
13305,305,13,2012,30331,-72,2,-70,394,288
13305,305,13,2013,30009,-445,20,-425,395,305
13305,305,13,2014,29916,-167,20,-147,381,327
13305,305,13,2015,29460,-579,37,-542,402,330
13305,305,13,2016,30038,460,33,493,428,347
13305,305,13,2017,29843,-231,21,-210,354,340
13305,305,13,2018,29874,41,18,59,370,398
13305,305,13,2019,30017,135,6,141,361,358
13305,305,13,2020,30023,11,7,18,348,362
13307,307,13,2010,2781,-14,0,-14,4,9
13307,307,13,2011,2764,-14,1,-13,14,18
13307,307,13,2012,2766,-4,-2,-6,25,16
13307,307,13,2013,2670,-102,0,-102,18,15
13307,307,13,2014,2612,-53,0,-53,16,22
13307,307,13,2015,2632,3,1,4,35,20
13307,307,13,2016,2607,-24,1,-23,18,19
13307,307,13,2017,2586,-13,-2,-15,27,32
13307,307,13,2018,2575,-3,-2,-5,20,26
13307,307,13,2019,2573,-6,-2,-8,30,25
13307,307,13,2020,2595,28,-2,26,20,24
13309,309,13,2010,7770,285,0,285,15,4
13309,309,13,2011,8078,292,0,292,65,53
13309,309,13,2012,7932,-135,0,-135,53,69
13309,309,13,2013,7934,-3,-1,-4,62,54
13309,309,13,2014,7984,54,0,54,61,66
13309,309,13,2015,7909,-70,0,-70,66,72
13309,309,13,2016,8012,102,0,102,62,61
13309,309,13,2017,7958,-73,0,-73,66,49
13309,309,13,2018,7891,-57,0,-57,70,81
13309,309,13,2019,7870,-39,0,-39,64,46
13309,309,13,2020,7751,-114,0,-114,63,67
13311,311,13,2010,27201,62,1,63,52,57
13311,311,13,2011,27401,178,3,181,259,239
13311,311,13,2012,27626,226,23,249,238,263
13311,311,13,2013,27831,156,24,180,276,251
13311,311,13,2014,28025,159,18,177,278,258
13311,311,13,2015,28389,368,19,387,266,290
13311,311,13,2016,28793,435,10,445,235,278
13311,311,13,2017,29429,605,5,610,305,282
13311,311,13,2018,29893,465,4,469,285,290
13311,311,13,2019,30601,749,3,752,276,319
13311,311,13,2020,31094,588,5,593,280,375
13313,313,13,2010,102740,-41,-48,-89,380,146
13313,313,13,2011,102909,-482,-87,-569,1471,730
13313,313,13,2012,102926,-611,-3,-614,1413,784
13313,313,13,2013,102691,-779,-14,-793,1357,800
13313,313,13,2014,103039,-167,-35,-202,1385,817
13313,313,13,2015,103621,-161,141,-20,1385,771
13313,313,13,2016,104314,-60,178,118,1443,864
13313,313,13,2017,104086,-785,48,-737,1364,856
13313,313,13,2018,104109,-512,7,-505,1340,811
13313,313,13,2019,104265,-152,2,-150,1237,935
13313,313,13,2020,103837,-736,-4,-740,1250,941
13315,315,13,2010,9313,91,0,91,21,55
13315,315,13,2011,9248,-62,1,-61,110,114
13315,315,13,2012,9069,-175,2,-173,80,94
13315,315,13,2013,9054,11,1,12,83,109
13315,315,13,2014,8929,-130,-1,-131,114,112
13315,315,13,2015,9015,110,1,111,76,102
13315,315,13,2016,8834,-160,2,-158,94,119
13315,315,13,2017,8780,-66,1,-65,95,85
13315,315,13,2018,8784,36,1,37,71,102
13315,315,13,2019,8607,-187,1,-186,78,70
13315,315,13,2020,8502,-72,1,-71,76,110
13317,317,13,2010,10389,-240,0,-240,28,19
13317,317,13,2011,10230,-143,2,-141,110,128
13317,317,13,2012,10093,-128,4,-124,135,152
13317,317,13,2013,9931,-114,12,-102,106,167
13317,317,13,2014,9960,31,13,44,100,114
13317,317,13,2015,9927,-32,35,3,115,153
13317,317,13,2016,9808,-99,24,-75,93,134
13317,317,13,2017,9868,88,9,97,101,137
13317,317,13,2018,9845,28,6,34,97,155
13317,317,13,2019,9769,-49,4,-45,102,132
13317,317,13,2020,9694,-11,3,-8,95,163
13319,319,13,2010,9528,-33,0,-33,33,42
13319,319,13,2011,9413,-134,-2,-136,133,112
13319,319,13,2012,9481,69,0,69,106,109
13319,319,13,2013,9361,-107,-2,-109,101,111
13319,319,13,2014,9283,-80,0,-80,122,119
13319,319,13,2015,9080,-179,0,-179,97,124
13319,319,13,2016,9021,-32,1,-31,98,124
13319,319,13,2017,8953,-51,0,-51,110,127
13319,319,13,2018,9005,92,0,92,88,128
13319,319,13,2019,8936,-71,0,-71,94,91
13319,319,13,2020,8812,-82,0,-82,96,138
13321,321,13,2010,21692,31,1,32,57,65
13321,321,13,2011,21516,-204,-5,-209,237,205
13321,321,13,2012,21356,-190,-1,-191,244,218
13321,321,13,2013,21058,-371,1,-370,271,208
13321,321,13,2014,21010,-86,-1,-87,274,233
13321,321,13,2015,20692,-345,2,-343,244,222
13321,321,13,2016,20732,-25,7,-18,266,207
13321,321,13,2017,20532,-178,4,-174,205,230
13321,321,13,2018,20307,-226,3,-223,246,249
13321,321,13,2019,20185,-53,2,-51,210,281
13321,321,13,2020,19972,-138,4,-134,196,275
15001,001,15,2010,185361,-101,173,72,588,354
15001,001,15,2011,187101,38,657,695,2456,1404
15001,001,15,2012,189199,456,731,1187,2470,1534
15001,001,15,2013,191521,929,479,1408,2388,1473
15001,001,15,2014,193812,1128,260,1388,2469,1572
15001,001,15,2015,196111,1063,495,1558,2374,1631
15001,001,15,2016,198583,930,911,1841,2385,1748
15001,001,15,2017,200400,758,512,1270,2290,1737
15001,001,15,2018,202263,877,562,1439,2288,1863
15001,001,15,2019,202165,-709,488,-221,2129,2002
15001,001,15,2020,203340,943,382,1325,2078,2227
15003,003,15,2010,956320,-65,1608,1543,3382,1754
15003,003,15,2011,967510,-1124,5644,4520,13775,7068
15003,003,15,2012,978295,-3676,8250,4574,13511,7133
15003,003,15,2013,986494,-2791,4632,1841,13760,7226
15003,003,15,2014,988002,-7779,3282,-4497,13549,7465
15003,003,15,2015,991755,-7457,5952,-1505,12995,7688
15003,003,15,2016,993044,-11678,7082,-4596,13269,7373
15003,003,15,2017,986973,-14476,3466,-11010,12770,7851
15003,003,15,2018,981076,-13403,3083,-10320,12324,7901
15003,003,15,2019,973491,-12857,1745,-11112,11996,8432
15003,003,15,2020,963826,-13530,1376,-12154,11793,9226
15005,005,15,2010,90,0,0,0,0,0
15005,005,15,2011,90,0,0,0,0,0
15005,005,15,2012,89,0,0,0,0,1
15005,005,15,2013,89,0,0,0,0,0
15005,005,15,2014,89,0,0,0,0,0
15005,005,15,2015,88,0,0,0,0,1
15005,005,15,2016,88,0,0,0,0,0
15005,005,15,2017,87,0,0,0,0,1
15005,005,15,2018,87,0,0,0,0,0
15005,005,15,2019,87,0,0,0,0,0
15005,005,15,2020,87,0,0,0,0,0
15007,007,15,2010,67208,5,88,93,196,165
15007,007,15,2011,67894,-47,420,373,891,575
15007,007,15,2012,68680,-24,438,414,881,495
15007,007,15,2013,69653,391,252,643,843,515
15007,007,15,2014,70316,204,137,341,909,582
15007,007,15,2015,71052,119,275,394,892,542
15007,007,15,2016,71574,-220,428,208,888,569
15007,007,15,2017,71838,-193,245,52,804,586
15007,007,15,2018,72292,-24,262,238,812,592
15007,007,15,2019,72190,-304,120,-184,755,673
15007,007,15,2020,71851,-426,91,-335,755,760
15009,009,15,2010,155025,-196,164,-32,477,258
15009,009,15,2011,156967,227,716,943,2032,1028
15009,009,15,2012,158936,187,865,1052,2032,1087
15009,009,15,2013,161065,708,510,1218,2038,1125
15009,009,15,2014,163116,739,392,1131,2029,1119
15009,009,15,2015,163993,-554,712,158,1950,1216
15009,009,15,2016,165596,-456,1371,915,1864,1165
15009,009,15,2017,166465,-505,591,86,1906,1113
15009,009,15,2018,167384,-378,630,252,1860,1184
15009,009,15,2019,167682,-593,425,-168,1815,1349
15009,009,15,2020,167902,-362,338,-24,1794,1555
16001,001,16,2010,393369,138,86,224,1307,485
16001,001,16,2011,401352,4420,898,5318,5149,2506
16001,001,16,2012,409032,4524,593,5117,5033,2553
16001,001,16,2013,416180,3942,713,4655,5043,2576
16001,001,16,2014,425774,6311,826,7137,4984,2659
16001,001,16,2015,433254,3829,1312,5141,5187,2856
16001,001,16,2016,444929,8309,1242,9551,5059,2978
16001,001,16,2017,456994,9522,603,10125,4947,3051
16001,001,16,2018,469161,10391,85,10476,4866,3208
16001,001,16,2019,481880,10889,164,11053,4834,3151
16001,001,16,2020,494399,10923,145,11068,4912,3426
16003,003,16,2010,3962,-22,0,-22,7,3
16003,003,16,2011,3981,40,0,40,18,38
16003,003,16,2012,3907,-80,0,-80,32,28
16003,003,16,2013,3865,-41,0,-41,35,36
16003,003,16,2014,3884,27,1,28,24,34
16003,003,16,2015,3891,17,1,18,28,38
16003,003,16,2016,3944,57,2,59,32,39
16003,003,16,2017,4128,192,1,193,37,46
16003,003,16,2018,4215,101,0,101,30,46
16003,003,16,2019,4265,58,0,58,25,32
16003,003,16,2020,4447,178,1,179,32,28
16005,005,16,2010,83026,-58,10,-48,356,118
16005,005,16,2011,83657,-233,99,-134,1424,655
16005,005,16,2012,83781,-611,105,-506,1289,656
16005,005,16,2013,83494,-1141,175,-966,1331,669
16005,005,16,2014,83587,-668,209,-459,1267,719
16005,005,16,2015,84263,-342,419,77,1296,691
16005,005,16,2016,84762,-403,378,-25,1229,703
16005,005,16,2017,85571,80,242,322,1213,720
16005,005,16,2018,86761,755,106,861,1124,796
16005,005,16,2019,87822,591,97,688,1110,738
16005,005,16,2020,88795,533,79,612,1092,734
16007,007,16,2010,5972,-23,0,-23,31,26
16007,007,16,2011,5961,-16,1,-15,66,62
16007,007,16,2012,5897,-77,1,-76,75,66
16007,007,16,2013,5953,30,3,33,100,76
16007,007,16,2014,5931,-38,1,-37,69,55
16007,007,16,2015,5883,-65,2,-63,81,66
16007,007,16,2016,5940,19,7,26,86,54
16007,007,16,2017,6029,64,3,67,80,57
16007,007,16,2018,6026,-10,1,-9,82,76
16007,007,16,2019,6131,76,3,79,73,46
16007,007,16,2020,6143,-3,4,1,73,62
16009,009,16,2010,9291,-12,0,-12,31,12
16009,009,16,2011,9176,-105,3,-102,104,118
16009,009,16,2012,9129,-47,1,-46,108,107
16009,009,16,2013,9033,-112,2,-110,121,109
16009,009,16,2014,9035,27,1,28,106,131
16009,009,16,2015,8999,-14,7,-7,111,139
16009,009,16,2016,9033,52,2,54,117,135
16009,009,16,2017,9167,168,6,174,93,134
16009,009,16,2018,9222,87,3,90,86,122
16009,009,16,2019,9303,84,3,87,104,110
16009,009,16,2020,9430,158,3,161,94,126
16011,011,16,2010,45764,1,-2,-1,222,62
16011,011,16,2011,45903,-250,-31,-281,744,323
16011,011,16,2012,45519,-787,-22,-809,743,338
16011,011,16,2013,45435,-567,9,-558,774,307
16011,011,16,2014,45226,-597,24,-573,702,352
16011,011,16,2015,45071,-564,55,-509,723,374
16011,011,16,2016,45313,-142,56,-86,691,361
16011,011,16,2017,45888,316,27,343,649,415
16011,011,16,2018,46054,-9,9,0,576,408
16011,011,16,2019,46772,474,12,486,612,377
16011,011,16,2020,47202,200,11,211,609,392
16013,013,16,2010,21296,-114,5,-109,60,39
16013,013,16,2011,21085,-398,49,-349,242,108
16013,013,16,2012,21131,-142,46,-96,223,84
16013,013,16,2013,21333,6,63,69,222,86
16013,013,16,2014,21471,-10,37,27,222,106
16013,013,16,2015,21659,-34,103,69,232,111
16013,013,16,2016,22069,89,233,322,201,113
16013,013,16,2017,22401,128,125,253,196,115
16013,013,16,2018,22736,132,121,253,193,110
16013,013,16,2019,23012,20,165,185,195,104
16013,013,16,2020,23426,238,126,364,186,136
16015,015,16,2010,7005,-10,0,-10,7,18
16015,015,16,2011,6986,-8,9,1,38,59
16015,015,16,2012,6792,-190,2,-188,32,44
16015,015,16,2013,6722,-66,4,-62,40,48
16015,015,16,2014,6780,71,0,71,41,57
16015,015,16,2015,6963,183,2,185,43,48
16015,015,16,2016,7099,133,16,149,43,56
16015,015,16,2017,7370,260,19,279,53,62
16015,015,16,2018,7689,305,10,315,52,50
16015,015,16,2019,7903,203,10,213,51,51
16015,015,16,2020,8065,175,9,184,47,66
16017,017,16,2010,40904,33,1,34,96,97
16017,017,16,2011,40795,-144,20,-124,393,378
16017,017,16,2012,40367,-396,7,-389,377,423
16017,017,16,2013,40553,176,-1,175,399,387
16017,017,16,2014,41330,764,5,769,410,418
16017,017,16,2015,41656,314,41,355,391,419
16017,017,16,2016,42423,781,23,804,419,458
16017,017,16,2017,43715,1261,9,1270,449,434
16017,017,16,2018,44709,1044,-5,1039,397,444
16017,017,16,2019,45774,1122,-2,1120,420,470
16017,017,16,2020,46817,1130,3,1133,418,502
16019,019,16,2010,104682,15,5,20,512,139
16019,019,16,2011,105833,-199,39,-160,2017,701
16019,019,16,2012,106788,-103,-24,-127,1891,793
16019,019,16,2013,107407,-557,32,-525,1943,803
16019,019,16,2014,108285,-131,31,-100,1808,815
16019,019,16,2015,109916,351,108,459,2012,829
16019,019,16,2016,112162,1073,81,1154,1926,834
16019,019,16,2017,114608,1382,77,1459,1885,900
16019,019,16,2018,116661,1144,14,1158,1833,940
16019,019,16,2019,119286,1714,31,1745,1808,925
16019,019,16,2020,122134,1927,25,1952,1841,936
16021,021,16,2010,10998,40,1,41,27,43
16021,021,16,2011,10822,-204,5,-199,117,96
16021,021,16,2012,10816,-44,11,-33,126,97
16021,021,16,2013,10856,3,13,16,129,104
16021,021,16,2014,10963,94,6,100,121,114
16021,021,16,2015,11310,292,25,317,140,114
16021,021,16,2016,11714,331,39,370,139,104
16021,021,16,2017,11995,234,22,256,143,120
16021,021,16,2018,12073,46,5,51,145,116
16021,021,16,2019,12340,229,8,237,144,113
16021,021,16,2020,12656,299,3,302,153,137
16023,023,16,2010,2914,7,0,7,14,0
16023,023,16,2011,2832,-82,-1,-83,27,27
16023,023,16,2012,2758,-78,-3,-81,31,25
16023,023,16,2013,2665,-90,-2,-92,25,30
16023,023,16,2014,2658,0,1,1,25,33
16023,023,16,2015,2565,-105,2,-103,33,24
16023,023,16,2016,2573,1,1,2,30,23
16023,023,16,2017,2582,14,0,14,24,29
16023,023,16,2018,2592,19,0,19,32,41
16023,023,16,2019,2620,29,0,29,23,23
16023,023,16,2020,2646,30,0,30,21,25
16025,025,16,2010,1115,-9,0,-9,6,0
16025,025,16,2011,1113,-7,-2,-9,13,6
16025,025,16,2012,1081,-36,-3,-39,9,3
16025,025,16,2013,1041,-45,-1,-46,14,11
16025,025,16,2014,1052,7,0,7,6,1
16025,025,16,2015,1068,11,0,11,9,5
16025,025,16,2016,1078,9,1,10,7,7
16025,025,16,2017,1092,13,0,13,11,10
16025,025,16,2018,1098,14,0,14,8,16
16025,025,16,2019,1091,-6,0,-6,7,9
16025,025,16,2020,1130,45,0,45,6,11
16027,027,16,2010,189365,-120,-7,-127,813,243
16027,027,16,2011,191392,102,33,135,3153,1252
16027,027,16,2012,193784,630,53,683,2987,1256
16027,027,16,2013,198661,3124,41,3165,3094,1436
16027,027,16,2014,202542,2089,-36,2053,3134,1336
16027,027,16,2015,206956,2551,79,2630,3189,1418
16027,027,16,2016,211573,2715,184,2899,3214,1501
16027,027,16,2017,217037,3865,42,3907,3068,1530
16027,027,16,2018,223518,5191,-67,5124,2943,1606
16027,027,16,2019,230270,5412,-33,5379,3002,1621
16027,027,16,2020,237053,5501,-24,5477,3007,1683
16029,029,16,2010,6971,-3,0,-3,25,10
16029,029,16,2011,6841,-179,7,-172,101,61
16029,029,16,2012,6770,-95,14,-81,85,76
16029,029,16,2013,6788,-19,14,-5,99,78
16029,029,16,2014,6793,-40,4,-36,89,49
16029,029,16,2015,6732,-79,5,-74,81,67
16029,029,16,2016,6870,96,15,111,85,57
16029,029,16,2017,6980,97,9,106,89,84
16029,029,16,2018,7019,-2,11,9,97,68
16029,029,16,2019,7149,70,15,85,95,50
16029,029,16,2020,7123,-61,11,-50,92,67
16031,031,16,2010,23080,77,2,79,103,70
16031,031,16,2011,23111,-158,0,-158,392,201
16031,031,16,2012,23265,-130,44,-86,416,176
16031,031,16,2013,23344,-126,32,-94,375,204
16031,031,16,2014,23503,-38,-3,-41,374,173
16031,031,16,2015,23497,-204,36,-168,366,206
16031,031,16,2016,23477,-208,33,-175,359,204
16031,031,16,2017,23661,-19,11,-8,384,191
16031,031,16,2018,23769,-69,8,-61,384,215
16031,031,16,2019,24052,73,15,88,394,197
16031,031,16,2020,24277,23,17,40,384,201
16033,033,16,2010,981,-2,1,-1,4,4
16033,033,16,2011,955,-36,6,-30,8,4
16033,033,16,2012,885,-91,17,-74,13,12
16033,033,16,2013,879,-11,5,-6,7,7
16033,033,16,2014,889,4,2,6,13,8
16033,033,16,2015,885,-5,1,-4,7,7
16033,033,16,2016,867,-24,2,-22,8,5
16033,033,16,2017,878,11,2,13,9,12
16033,033,16,2018,845,-42,1,-41,10,2
16033,033,16,2019,838,-13,1,-12,9,4
16033,033,16,2020,852,2,2,4,12,2
16035,035,16,2010,8726,-11,0,-11,16,40
16035,035,16,2011,8609,-49,4,-45,52,122
16035,035,16,2012,8579,-9,2,-7,72,94
16035,035,16,2013,8570,35,2,37,61,107
16035,035,16,2014,8564,18,2,20,71,98
16035,035,16,2015,8554,40,7,47,52,108
16035,035,16,2016,8660,141,6,147,70,111
16035,035,16,2017,8651,46,7,53,65,127
16035,035,16,2018,8759,139,4,143,72,106
16035,035,16,2019,8761,26,3,29,68,95
16035,035,16,2020,8846,119,2,121,64,99
16037,037,16,2010,4357,0,0,0,6,14
16037,037,16,2011,4325,-35,2,-33,46,44
16037,037,16,2012,4327,5,2,7,35,40
16037,037,16,2013,4226,-107,2,-105,38,37
16037,037,16,2014,4134,-93,1,-92,37,38
16037,037,16,2015,4061,-69,1,-68,35,41
16037,037,16,2016,4089,39,2,41,41,54
16037,037,16,2017,4138,51,0,51,42,43
16037,037,16,2018,4216,101,0,101,31,54
16037,037,16,2019,4273,60,0,60,32,35
16037,037,16,2020,4249,-12,0,-12,27,38
16039,039,16,2010,27125,-78,49,-29,133,22
16039,039,16,2011,26237,-1261,71,-1190,465,171
16039,039,16,2012,26314,-494,261,-233,476,176
16039,039,16,2013,26296,-454,158,-296,445,175
16039,039,16,2014,26257,-501,137,-364,498,185
16039,039,16,2015,25861,-917,224,-693,462,179
16039,039,16,2016,26178,-93,152,59,459,199
16039,039,16,2017,26907,402,64,466,457,196
16039,039,16,2018,27309,177,-12,165,447,211
16039,039,16,2019,27373,-197,36,-161,426,201
16039,039,16,2020,27448,-163,30,-133,419,211
16041,041,16,2010,12782,-31,0,-31,60,35
16041,041,16,2011,12813,-101,-2,-103,221,87
16041,041,16,2012,12801,-119,-2,-121,199,93
16041,041,16,2013,12809,-77,0,-77,185,101
16041,041,16,2014,12924,60,-8,52,178,112
16041,041,16,2015,12974,-52,-9,-61,206,96
16041,041,16,2016,13345,263,-8,255,200,82
16041,041,16,2017,13501,95,-11,84,191,120
16041,041,16,2018,13718,152,-10,142,194,118
16041,041,16,2019,13898,85,-10,75,210,104
16041,041,16,2020,14215,220,-7,213,203,98
16043,043,16,2010,13232,-32,1,-31,60,41
16043,043,16,2011,13116,-212,-1,-213,203,107
16043,043,16,2012,12973,-260,14,-246,208,110
16043,043,16,2013,12881,-188,5,-183,179,91
16043,043,16,2014,12815,-156,2,-154,179,95
16043,043,16,2015,12824,-101,15,-86,203,108
16043,043,16,2016,12932,27,21,48,178,118
16043,043,16,2017,13140,131,4,135,177,104
16043,043,16,2018,13162,-51,0,-51,179,106
16043,043,16,2019,13105,-131,4,-127,178,106
16043,043,16,2020,13218,27,2,29,180,97
16045,045,16,2010,16686,-47,3,-44,40,32
16045,045,16,2011,16696,14,24,38,179,206
16045,045,16,2012,16638,-117,14,-103,216,175
16045,045,16,2013,16582,-70,7,-63,205,198
16045,045,16,2014,16665,99,8,107,188,210
16045,045,16,2015,16706,26,23,49,188,193
16045,045,16,2016,17005,269,23,292,225,217
16045,045,16,2017,17351,361,12,373,191,220
16045,045,16,2018,17622,291,5,296,202,228
16045,045,16,2019,18174,552,7,559,192,197
16045,045,16,2020,18703,549,4,553,190,211
16047,047,16,2010,15470,-8,2,-6,58,52
16047,047,16,2011,15352,-217,29,-188,230,161
16047,047,16,2012,15246,-212,42,-170,196,137
16047,047,16,2013,15162,-166,20,-146,204,145
16047,047,16,2014,15080,-129,-9,-138,204,150
16047,047,16,2015,15181,45,-7,38,196,132
16047,047,16,2016,15150,-144,30,-114,218,135
16047,047,16,2017,15155,-56,19,-37,206,162
16047,047,16,2018,15187,-62,33,-29,199,139
16047,047,16,2019,15290,10,38,48,181,125
16047,047,16,2020,15618,219,40,259,188,119
16049,049,16,2010,16311,27,0,27,38,21
16049,049,16,2011,16465,158,-1,157,166,169
16049,049,16,2012,16448,-6,0,-6,154,163
16049,049,16,2013,16256,-176,2,-174,160,177
16049,049,16,2014,16285,70,4,74,157,199
16049,049,16,2015,16312,72,12,84,148,202
16049,049,16,2016,16247,-25,9,-16,152,200
16049,049,16,2017,16392,153,7,160,164,177
16049,049,16,2018,16469,134,2,136,144,201
16049,049,16,2019,16623,184,2,186,152,183
16049,049,16,2020,16823,239,2,241,152,192
16051,051,16,2010,26222,-14,-1,-15,135,41
16051,051,16,2011,26315,-265,3,-262,498,143
16051,051,16,2012,26642,-42,9,-33,500,141
16051,051,16,2013,26809,-184,11,-173,481,141
16051,051,16,2014,26948,-199,5,-194,473,145
16051,051,16,2015,27133,-121,11,-110,467,171
16051,051,16,2016,27827,394,24,418,455,178
16051,051,16,2017,28448,313,8,321,452,152
16051,051,16,2018,29418,666,0,666,485,181
16051,051,16,2019,29918,200,5,205,454,159
16051,051,16,2020,30581,384,5,389,439,163
16053,053,16,2010,22438,-14,5,-9,114,22
16053,053,16,2011,22516,-192,25,-167,397,152
16053,053,16,2012,22572,-292,80,-212,397,136
16053,053,16,2013,22759,-189,128,-61,414,166
16053,053,16,2014,22918,-68,14,-54,390,174
16053,053,16,2015,22960,-242,58,-184,398,175
16053,053,16,2016,23438,56,185,241,415,178
16053,053,16,2017,23791,41,105,146,379,172
16053,053,16,2018,24078,-34,121,87,372,170
16053,053,16,2019,24486,111,94,205,350,147
16053,053,16,2020,24578,-185,90,-95,356,170
16055,055,16,2010,138860,237,-8,229,416,253
16055,055,16,2011,140986,1590,30,1620,1735,1235
16055,055,16,2012,142173,743,5,748,1683,1227
16055,055,16,2013,144019,1399,-25,1374,1712,1242
16055,055,16,2014,146687,2142,-33,2109,1792,1270
16055,055,16,2015,149566,2407,-11,2396,1805,1342
16055,055,16,2016,153221,3255,-55,3200,1782,1338
16055,055,16,2017,157594,4016,-58,3958,1851,1452
16055,055,16,2018,161279,3534,-75,3459,1758,1539
16055,055,16,2019,165656,4225,-74,4151,1762,1523
16055,055,16,2020,170628,4945,-55,4890,1785,1675
16057,057,16,2010,37258,-7,3,-4,104,82
16057,057,16,2011,37872,232,118,350,480,216
16057,057,16,2012,38127,-24,69,45,433,217
16057,057,16,2013,38262,-228,143,-85,454,231
16057,057,16,2014,38570,0,136,136,429,248
16057,057,16,2015,38860,-246,281,35,462,207
16057,057,16,2016,39157,-247,339,92,426,224
16057,057,16,2017,39903,288,211,499,462,216
16057,057,16,2018,39996,-149,76,-73,398,235
16057,057,16,2019,40372,60,91,151,413,188
16057,057,16,2020,40830,215,75,290,394,229
16059,059,16,2010,7952,22,0,22,30,37
16059,059,16,2011,7985,39,2,41,78,86
16059,059,16,2012,7769,-196,1,-195,69,95
16059,059,16,2013,7718,-20,2,-18,53,85
16059,059,16,2014,7728,45,1,46,67,101
16059,059,16,2015,7744,54,-2,52,67,104
16059,059,16,2016,7715,-1,-3,-4,82,107
16059,059,16,2017,7837,149,-3,146,78,102
16059,059,16,2018,7974,166,-3,163,76,101
16059,059,16,2019,8067,122,-3,119,79,106
16059,059,16,2020,8054,20,-3,17,75,103
16061,061,16,2010,3820,-9,0,-9,10,2
16061,061,16,2011,3805,-15,-1,-16,40,41
16061,061,16,2012,3820,13,-2,11,42,36
16061,061,16,2013,3805,-11,0,-11,40,44
16061,061,16,2014,3813,6,5,11,39,41
16061,061,16,2015,3792,-36,11,-25,41,38
16061,061,16,2016,3850,49,11,60,45,46
16061,061,16,2017,3883,35,6,41,34,42
16061,061,16,2018,3835,-32,3,-29,34,52
16061,061,16,2019,3845,11,4,15,34,39
16061,061,16,2020,3838,-1,2,1,34,41
16063,063,16,2010,5208,-4,-1,-5,21,15
16063,063,16,2011,5135,-118,-1,-119,92,46
16063,063,16,2012,5267,69,19,88,77,34
16063,063,16,2013,5333,-3,28,25,74,33
16063,063,16,2014,5336,-25,6,-19,73,52
16063,063,16,2015,5312,-75,14,-61,67,30
16063,063,16,2016,5304,-68,30,-38,74,45
16063,063,16,2017,5361,4,10,14,69,25
16063,063,16,2018,5360,-37,14,-23,65,42
16063,063,16,2019,5325,-78,19,-59,58,34
16063,063,16,2020,5358,-8,15,7,63,37
16065,065,16,2010,37588,-168,-9,-177,256,40
16065,065,16,2011,37937,-607,64,-543,1017,127
16065,065,16,2012,37712,-1192,1,-1191,1079,145
16065,065,16,2013,37607,-1132,23,-1109,1104,125
16065,065,16,2014,38005,-603,27,-576,1097,124
16065,065,16,2015,38120,-1059,136,-923,1155,127
16065,065,16,2016,39111,-76,122,46,1066,123
16065,065,16,2017,39540,-631,86,-545,1115,137
16065,065,16,2018,39451,-1050,21,-1029,1093,152
16065,065,16,2019,40205,-242,35,-207,1121,155
16065,065,16,2020,40318,-891,29,-862,1131,150
16067,067,16,2010,20084,-47,2,-45,99,27
16067,067,16,2011,20208,-60,40,-20,321,176
16067,067,16,2012,20156,-263,82,-181,321,200
16067,067,16,2013,20399,8,79,87,332,170
16067,067,16,2014,20340,-214,-2,-216,334,185
16067,067,16,2015,20431,-49,1,-48,308,166
16067,067,16,2016,20609,6,4,10,322,153
16067,067,16,2017,20683,-39,-24,-63,306,169
16067,067,16,2018,20667,-110,-24,-134,320,200
16067,067,16,2019,20910,180,-19,161,286,204
16067,067,16,2020,21216,221,-11,210,306,209
16069,069,16,2010,39317,28,2,30,116,96
16069,069,16,2011,39444,141,30,171,448,490
16069,069,16,2012,39512,78,12,90,480,500
16069,069,16,2013,39819,298,28,326,504,519
16069,069,16,2014,39873,68,25,93,498,529
16069,069,16,2015,40039,129,19,148,476,454
16069,069,16,2016,40200,165,14,179,490,508
16069,069,16,2017,40376,274,12,286,468,578
16069,069,16,2018,40408,36,-4,32,476,474
16069,069,16,2019,40601,265,1,266,441,511
16069,069,16,2020,40755,199,-1,198,444,489
16071,071,16,2010,4290,-1,0,-1,17,12
16071,071,16,2011,4232,-81,6,-75,53,37
16071,071,16,2012,4224,-30,11,-19,47,36
16071,071,16,2013,4256,13,6,19,51,38
16071,071,16,2014,4177,-90,5,-85,44,42
16071,071,16,2015,4249,65,4,69,43,40
16071,071,16,2016,4302,38,0,38,56,41
16071,071,16,2017,4393,72,-1,71,54,33
16071,071,16,2018,4429,40,-1,39,55,58
16071,071,16,2019,4500,45,-1,44,56,28
16071,071,16,2020,4520,4,-1,3,56,38
16073,073,16,2010,11474,-61,1,-60,36,32
16073,073,16,2011,11378,-130,2,-128,130,97
16073,073,16,2012,11411,-31,4,-27,147,87
16073,073,16,2013,11396,-87,25,-62,142,96
16073,073,16,2014,11292,-157,-2,-159,133,80
16073,073,16,2015,11294,-43,8,-35,142,103
16073,073,16,2016,11368,16,8,24,137,86
16073,073,16,2017,11632,210,-1,209,151,95
16073,073,16,2018,11664,14,-5,9,134,112
16073,073,16,2019,11823,109,-3,106,140,88
16073,073,16,2020,12133,280,-2,278,145,109
16075,075,16,2010,22640,-44,0,-44,89,28
16075,075,16,2011,22561,-193,-7,-200,323,202
16075,075,16,2012,22697,27,-4,23,304,186
16075,075,16,2013,22581,-205,-12,-217,297,198
16075,075,16,2014,22790,136,-23,113,304,203
16075,075,16,2015,22833,-31,-20,-51,316,219
16075,075,16,2016,22927,71,-26,45,282,232
16075,075,16,2017,23218,221,-27,194,293,195
16075,075,16,2018,23560,307,-28,279,308,245
16075,075,16,2019,24051,463,-28,435,307,250
16075,075,16,2020,24771,688,-21,667,304,248
16077,077,16,2010,7873,25,-2,23,34,3
16077,077,16,2011,7783,-178,6,-172,134,53
16077,077,16,2012,7833,-55,36,-19,128,61
16077,077,16,2013,7794,-158,37,-121,134,56
16077,077,16,2014,7734,-152,15,-137,145,71
16077,077,16,2015,7690,-119,6,-113,145,77
16077,077,16,2016,7653,-67,-9,-76,108,69
16077,077,16,2017,7587,-143,-14,-157,139,49
16077,077,16,2018,7654,48,-16,32,95,60
16077,077,16,2019,7636,-55,-15,-70,111,60
16077,077,16,2020,7643,-26,-10,-36,110,67
16079,079,16,2010,12750,-31,0,-31,34,53
16079,079,16,2011,12664,-30,5,-25,125,187
16079,079,16,2012,12703,116,3,119,111,192
16079,079,16,2013,12675,40,0,40,126,194
16079,079,16,2014,12380,-278,10,-268,141,176
16079,079,16,2015,12446,60,19,79,147,158
16079,079,16,2016,12428,0,13,13,167,197
16079,079,16,2017,12511,142,7,149,145,212
16079,079,16,2018,12781,292,1,293,149,171
16079,079,16,2019,12868,115,2,117,139,170
16079,079,16,2020,12911,89,3,92,141,189
16081,081,16,2010,10149,-47,1,-46,46,18
16081,081,16,2011,10161,-121,8,-113,158,35
16081,081,16,2012,10128,-206,49,-157,151,33
16081,081,16,2013,10410,128,35,163,160,44
16081,081,16,2014,10450,-87,9,-78,151,31
16081,081,16,2015,10744,157,30,187,149,47
16081,081,16,2016,11179,275,53,328,146,40
16081,081,16,2017,11463,153,25,178,148,43
16081,081,16,2018,11640,71,15,86,132,42
16081,081,16,2019,12096,353,20,373,129,46
16081,081,16,2020,12501,329,17,346,128,67
16083,083,16,2010,77547,80,37,117,339,143
16083,083,16,2011,78108,-127,230,103,1176,715
16083,083,16,2012,78564,-281,212,-69,1197,666
16083,083,16,2013,79919,638,245,883,1207,733
16083,083,16,2014,81019,462,155,617,1209,720
16083,083,16,2015,82289,531,276,807,1236,765
16083,083,16,2016,83847,801,367,1168,1171,780
16083,083,16,2017,85439,870,195,1065,1275,746
16083,083,16,2018,86166,264,60,324,1165,760
16083,083,16,2019,87127,520,77,597,1165,801
16083,083,16,2020,88411,908,70,978,1155,850
16085,085,16,2010,9788,-85,0,-85,19,6
16085,085,16,2011,9639,-165,-3,-168,89,70
16085,085,16,2012,9544,-116,-2,-118,81,58
16085,085,16,2013,9585,18,-7,11,92,61
16085,085,16,2014,9805,181,-5,176,95,59
16085,085,16,2015,10058,264,-5,259,82,91
16085,085,16,2016,10438,365,-1,364,83,70
16085,085,16,2017,10700,260,-4,256,100,93
16085,085,16,2018,11054,329,-5,324,101,73
16085,085,16,2019,11443,367,-5,362,94,66
16085,085,16,2020,11792,354,-4,350,96,94
16087,087,16,2010,10177,1,0,1,26,46
16087,087,16,2011,10135,-36,-5,-41,111,112
16087,087,16,2012,10028,-74,-4,-78,92,122
16087,087,16,2013,9916,-93,-5,-98,108,123
16087,087,16,2014,9956,63,-5,58,119,135
16087,087,16,2015,9894,-55,-6,-61,104,104
16087,087,16,2016,10030,153,-8,145,106,115
16087,087,16,2017,10055,29,-11,18,121,113
16087,087,16,2018,10070,68,-11,57,94,137
16087,087,16,2019,10126,81,-11,70,100,113
16087,087,16,2020,10360,262,-8,254,92,110
17001,001,17,2010,67158,19,5,24,201,153
17001,001,17,2011,67214,-4,21,17,811,770
17001,001,17,2012,67149,-85,19,-66,806,799
17001,001,17,2013,67005,-192,31,-161,805,784
17001,001,17,2014,66983,-160,49,-111,851,758
17001,001,17,2015,66850,-161,30,-131,828,826
17001,001,17,2016,66490,-415,23,-392,843,809
17001,001,17,2017,66073,-491,25,-466,839,789
17001,001,17,2018,65603,-398,17,-381,791,879
17001,001,17,2019,65402,-146,13,-133,753,821
17001,001,17,2020,64783,-472,17,-455,737,900
17003,003,17,2010,8205,-26,1,-25,29,38
17003,003,17,2011,7993,-209,2,-207,106,111
17003,003,17,2012,7721,-304,1,-303,102,82
17003,003,17,2013,7242,-501,2,-499,97,97
17003,003,17,2014,7084,-154,0,-154,110,116
17003,003,17,2015,6763,-321,0,-321,99,103
17003,003,17,2016,6448,-284,-1,-285,69,101
17003,003,17,2017,6276,-166,-1,-167,92,97
17003,003,17,2018,6043,-192,-1,-193,53,92
17003,003,17,2019,5791,-239,-1,-240,52,63
17003,003,17,2020,5497,-251,0,-251,43,84
17005,005,17,2010,17789,9,3,12,43,33
17005,005,17,2011,17727,-89,20,-69,175,169
17005,005,17,2012,17538,-210,10,-200,174,168
17005,005,17,2013,17332,-215,10,-205,163,169
17005,005,17,2014,17076,-257,9,-248,146,160
17005,005,17,2015,16688,-378,9,-369,163,187
17005,005,17,2016,16553,-106,8,-98,147,185
17005,005,17,2017,16654,113,10,123,140,162
17005,005,17,2018,16668,33,7,40,152,176
17005,005,17,2019,16458,-196,7,-189,148,170
17005,005,17,2020,16262,-171,5,-166,147,177
17007,007,17,2010,54094,-91,-7,-98,146,115
17007,007,17,2011,54123,-207,-30,-237,610,344
17007,007,17,2012,53729,-603,-57,-660,614,366
17007,007,17,2013,53737,-83,-33,-116,526,401
17007,007,17,2014,53702,-223,-3,-226,585,396
17007,007,17,2015,53571,-361,19,-342,606,398
17007,007,17,2016,53559,-189,-2,-191,579,399
17007,007,17,2017,53481,-257,4,-253,599,427
17007,007,17,2018,53368,-194,-14,-208,557,461
17007,007,17,2019,53281,-147,-13,-160,505,431
17007,007,17,2020,52777,-580,-9,-589,501,414
17009,009,17,2010,6919,-19,0,-19,10,9
17009,009,17,2011,6883,-26,2,-24,43,56
17009,009,17,2012,6893,-10,4,-6,64,48
17009,009,17,2013,6867,-34,3,-31,51,45
17009,009,17,2014,6836,-15,-1,-16,55,68
17009,009,17,2015,6755,-95,5,-90,55,49
17009,009,17,2016,6636,-143,6,-137,59,42
17009,009,17,2017,6614,-22,9,-13,66,76
17009,009,17,2018,6580,-39,8,-31,59,61
17009,009,17,2019,6619,24,3,27,63,53
17009,009,17,2020,6546,-80,5,-75,64,61
17011,011,17,2010,34959,-55,2,-53,95,64
17011,011,17,2011,34631,-280,16,-264,330,394
17011,011,17,2012,34350,-256,15,-241,330,375
17011,011,17,2013,34112,-229,16,-213,355,381
17011,011,17,2014,33858,-217,20,-197,327,385
17011,011,17,2015,33494,-371,24,-347,365,385
17011,011,17,2016,33393,-60,15,-45,354,408
17011,011,17,2017,33134,-191,17,-174,341,426
17011,011,17,2018,32938,-143,12,-131,334,399
17011,011,17,2019,32621,-265,11,-254,295,359
17011,011,17,2020,32303,-220,10,-210,298,406
17013,013,17,2010,5093,-1,0,-1,11,4
17013,013,17,2011,5047,-58,2,-56,59,50
17013,013,17,2012,4983,-59,2,-57,51,59
17013,013,17,2013,5006,34,3,37,39,53
17013,013,17,2014,4923,-91,0,-91,56,51
17013,013,17,2015,4858,-63,1,-62,49,53
17013,013,17,2016,4872,7,1,8,52,45
17013,013,17,2017,4847,-8,1,-7,41,58
17013,013,17,2018,4834,-16,1,-15,43,41
17013,013,17,2019,4740,-64,0,-64,35,64
17013,013,17,2020,4616,-92,0,-92,36,68
17015,015,17,2010,15395,-11,0,-11,51,39
17015,015,17,2011,15229,-129,8,-121,137,181
17015,015,17,2012,15121,-68,8,-60,146,193
17015,015,17,2013,14969,-94,3,-91,135,194
17015,015,17,2014,14783,-128,0,-128,132,191
17015,015,17,2015,14638,-118,3,-115,161,190
17015,015,17,2016,14601,-11,2,-9,152,179
17015,015,17,2017,14473,-67,3,-64,117,181
17015,015,17,2018,14337,-94,2,-92,152,196
17015,015,17,2019,14338,69,0,69,118,184
17015,015,17,2020,14241,-26,2,-24,129,201
17017,017,17,2010,13632,-23,7,-16,43,36
17017,017,17,2011,13625,-80,33,-47,179,139
17017,017,17,2012,13427,-284,42,-242,188,153
17017,017,17,2013,13293,-204,39,-165,161,134
17017,017,17,2014,13079,-277,45,-232,154,142
17017,017,17,2015,12843,-309,44,-265,185,160
17017,017,17,2016,12677,-237,62,-175,167,159
17017,017,17,2017,12525,-268,74,-194,183,143
17017,017,17,2018,12353,-287,80,-207,173,137
17017,017,17,2019,12141,-274,38,-236,172,148
17017,017,17,2020,11925,-263,35,-228,159,145
17019,019,17,2010,201558,-234,387,153,603,282
17019,019,17,2011,203239,-1521,2097,576,2337,1243
17019,019,17,2012,204697,-1680,1839,159,2422,1146
17019,019,17,2013,206527,-1233,1965,732,2350,1262
17019,019,17,2014,208068,-1559,1882,323,2447,1236
17019,019,17,2015,209534,-1784,2089,305,2429,1278
17019,019,17,2016,210388,-2084,1837,-247,2405,1313
17019,019,17,2017,210630,-2911,2155,-756,2347,1378
17019,019,17,2018,210206,-3071,1683,-1388,2280,1336
17019,019,17,2019,209612,-2709,1299,-1410,2212,1404
17019,019,17,2020,209192,-2126,1030,-1096,2200,1528
17021,021,17,2010,34767,-10,3,-7,92,111
17021,021,17,2011,34705,-14,19,5,350,416
17021,021,17,2012,34522,-162,13,-149,379,414
17021,021,17,2013,34155,-319,3,-316,362,415
17021,021,17,2014,33824,-264,2,-262,324,396
17021,021,17,2015,33480,-270,5,-265,341,421
17021,021,17,2016,33268,-153,13,-140,360,429
17021,021,17,2017,33045,-142,12,-130,332,425
17021,021,17,2018,32709,-244,8,-236,323,423
17021,021,17,2019,32427,-254,6,-248,349,383
17021,021,17,2020,32075,-298,3,-295,340,395
17023,023,17,2010,16291,-27,0,-27,53,69
17023,023,17,2011,16205,-80,1,-79,200,207
17023,023,17,2012,16265,63,-2,61,201,199
17023,023,17,2013,16105,-137,1,-136,182,207
17023,023,17,2014,16060,-40,3,-37,203,210
17023,023,17,2015,15881,-156,-1,-157,177,199
17023,023,17,2016,15860,14,-3,11,174,204
17023,023,17,2017,15824,-48,-2,-50,190,176
17023,023,17,2018,15594,-200,-2,-202,170,198
17023,023,17,2019,15465,-110,-3,-113,187,202
17023,023,17,2020,15268,-167,0,-167,185,214
17025,025,17,2010,13822,-1,3,2,40,30
17025,025,17,2011,13721,-80,17,-63,145,182
17025,025,17,2012,13710,-40,1,-39,177,150
17025,025,17,2013,13550,-131,-2,-133,167,195
17025,025,17,2014,13441,-93,-1,-94,143,157
17025,025,17,2015,13395,-45,0,-45,163,164
17025,025,17,2016,13309,-60,0,-60,163,187
17025,025,17,2017,13259,-24,0,-24,150,177
17025,025,17,2018,13260,11,0,11,169,178
17025,025,17,2019,13177,-52,-1,-53,135,164
17025,025,17,2020,13079,-59,-1,-60,153,192
17027,027,17,2010,37833,40,1,41,102,59
17027,027,17,2011,38024,81,4,85,400,292
17027,027,17,2012,37908,-209,-1,-210,431,337
17027,027,17,2013,37725,-249,1,-248,413,349
17027,027,17,2014,37637,-151,6,-145,392,333
17027,027,17,2015,37657,-47,5,-42,452,388
17027,027,17,2016,37594,-169,5,-164,430,328
17027,027,17,2017,37649,-17,13,-4,419,358
17027,027,17,2018,37666,-30,5,-25,409,366
17027,027,17,2019,37440,-241,3,-238,402,390
17027,027,17,2020,37398,-15,5,-10,388,422
17029,029,17,2010,53865,22,7,29,113,147
17029,029,17,2011,53632,-263,36,-227,504,512
17029,029,17,2012,53333,-358,34,-324,509,486
17029,029,17,2013,53075,-299,62,-237,500,525
17029,029,17,2014,52552,-630,82,-548,492,482
17029,029,17,2015,52217,-434,104,-330,530,539
17029,029,17,2016,51820,-463,66,-397,521,524
17029,029,17,2017,51403,-529,78,-451,515,485
17029,029,17,2018,50946,-499,58,-441,488,506
17029,029,17,2019,50774,-183,43,-140,459,493
17029,029,17,2020,50383,-364,30,-334,461,518
17031,031,17,2010,5198977,-7928,2792,-5136,18572,9365
17031,031,17,2011,5219636,-31108,18949,-12159,71847,39052
17031,031,17,2012,5239105,-27382,15627,-11755,70561,38870
17031,031,17,2013,5252513,-32194,16511,-15683,69283,39867
17031,031,17,2014,5254108,-45650,16989,-28661,69243,39030
17031,031,17,2015,5243371,-57268,17539,-39729,69505,40751
17031,031,17,2016,5223386,-62033,14309,-47724,67930,40294
17031,031,17,2017,5199582,-65793,17706,-48087,65460,41281
17031,031,17,2018,5171007,-63312,12369,-50943,63529,41234
17031,031,17,2019,5145326,-51875,7659,-44216,60725,42167
17031,031,17,2020,5108284,-57179,6356,-50823,60224,46387
17033,033,17,2010,19801,6,1,7,53,74
17033,033,17,2011,19779,-16,11,-5,216,234
17033,033,17,2012,19594,-210,8,-202,209,196
17033,033,17,2013,19441,-123,5,-118,211,245
17033,033,17,2014,19290,-127,4,-123,200,227
17033,033,17,2015,19262,13,-2,11,218,256
17033,033,17,2016,19139,-101,-1,-102,216,237
17033,033,17,2017,18979,-148,-1,-149,218,229
17033,033,17,2018,18849,-101,-1,-102,197,225
17033,033,17,2019,18686,-129,-1,-130,199,232
17033,033,17,2020,18512,-117,-1,-118,190,247
17035,035,17,2010,11053,-5,4,-1,31,19
17035,035,17,2011,11084,20,16,36,121,125
17035,035,17,2012,10955,-155,16,-139,117,111
17035,035,17,2013,10911,-59,9,-50,126,120
17035,035,17,2014,10931,-18,2,-16,133,96
17035,035,17,2015,10869,-55,2,-53,115,123
17035,035,17,2016,10884,-6,1,-5,131,109
17035,035,17,2017,10887,-18,0,-18,136,114
17035,035,17,2018,10782,-85,0,-85,110,131
17035,035,17,2019,10733,-61,0,-61,120,109
17035,035,17,2020,10649,-68,0,-68,105,121
17037,037,17,2010,105151,-221,47,-174,348,194
17037,037,17,2011,104466,-1450,157,-1293,1270,675
17037,037,17,2012,104385,-833,222,-611,1197,686
17037,037,17,2013,104226,-868,221,-647,1165,695
17037,037,17,2014,104593,-324,201,-123,1179,685
17037,037,17,2015,104238,-1117,249,-868,1220,719
17037,037,17,2016,104219,-798,302,-496,1172,698
17037,037,17,2017,104513,-419,359,-60,1101,750
17037,037,17,2018,104587,-542,265,-277,1100,756
17037,037,17,2019,105131,-43,202,159,1114,729
17037,037,17,2020,104491,-1106,156,-950,1084,776
17039,039,17,2010,16589,6,0,6,43,17
17039,039,17,2011,16549,-39,0,-39,185,186
17039,039,17,2012,16490,-92,0,-92,196,161
17039,039,17,2013,16372,-116,1,-115,168,173
17039,039,17,2014,16216,-143,2,-141,173,188
17039,039,17,2015,16185,-9,1,-8,179,199
17039,039,17,2016,16152,-32,0,-32,196,196
17039,039,17,2017,15910,-202,1,-201,147,188
17039,039,17,2018,15768,-86,-1,-87,160,215
17039,039,17,2019,15624,-125,-2,-127,176,194
17039,039,17,2020,15368,-195,-1,-196,169,228
17041,041,17,2010,19977,-39,7,-32,64,26
17041,041,17,2011,19863,-208,27,-181,259,192
17041,041,17,2012,19881,-54,21,-33,244,192
17041,041,17,2013,19853,-105,6,-99,268,196
17041,041,17,2014,19898,15,-1,14,258,222
17041,041,17,2015,19827,-129,1,-128,253,197
17041,041,17,2016,19732,-197,-1,-198,288,185
17041,041,17,2017,19616,-146,-2,-148,240,209
17041,041,17,2018,19449,-216,-2,-218,270,221
17041,041,17,2019,19450,-49,-3,-52,230,176
17041,041,17,2020,19510,17,-1,16,230,186
17043,043,17,2010,917996,-597,434,-163,2803,1368
17043,043,17,2011,924866,-1074,3101,2027,10731,5872
17043,043,17,2012,928719,-3736,2728,-1008,10717,5863
17043,043,17,2013,932301,-3461,2564,-897,10411,5937
17043,043,17,2014,933480,-6546,2857,-3689,10683,5889
17043,043,17,2015,933669,-7738,3114,-4624,10935,6171
17043,043,17,2016,931408,-9542,2594,-6948,10849,6202
17043,043,17,2017,930569,-8360,3213,-5147,10530,6282
17043,043,17,2018,927808,-9106,2219,-6887,10479,6406
17043,043,17,2019,922761,-9972,1481,-8491,10081,6664
17043,043,17,2020,917481,-9244,1189,-8055,9987,7223
17045,045,17,2010,18509,-32,0,-32,48,81
17045,045,17,2011,18397,-74,0,-74,186,225
17045,045,17,2012,18170,-202,5,-197,186,219
17045,045,17,2013,17959,-155,2,-153,205,265
17045,045,17,2014,17827,-68,4,-64,179,245
17045,045,17,2015,17625,-140,7,-133,165,234
17045,045,17,2016,17538,-16,5,-11,175,250
17045,045,17,2017,17415,-82,12,-70,185,239
17045,045,17,2018,17379,-7,11,4,186,224
17045,045,17,2019,17169,-153,7,-146,155,219
17045,045,17,2020,16858,-233,2,-231,165,242
17047,047,17,2010,6739,14,0,14,14,15
17047,047,17,2011,6674,-77,1,-76,74,64
17047,047,17,2012,6725,48,1,49,85,80
17047,047,17,2013,6691,-28,0,-28,74,80
17047,047,17,2014,6631,-69,0,-69,84,76
17047,047,17,2015,6514,-111,0,-111,71,77
17047,047,17,2016,6546,12,1,13,82,64
17047,047,17,2017,6455,-71,2,-69,65,87
17047,047,17,2018,6393,-80,1,-79,87,69
17047,047,17,2019,6405,-8,0,-8,88,67
17047,047,17,2020,6356,-72,1,-71,92,70
17049,049,17,2010,34222,-56,-1,-57,131,97
17049,049,17,2011,34268,-53,13,-40,437,349
17049,049,17,2012,34270,-99,5,-94,444,349
17049,049,17,2013,34213,-134,20,-114,431,372
17049,049,17,2014,34115,-220,24,-196,442,344
17049,049,17,2015,34200,5,16,21,447,380
17049,049,17,2016,34184,-146,30,-116,462,359
17049,049,17,2017,34165,-201,40,-161,481,340
17049,049,17,2018,34233,-34,31,-3,462,390
17049,049,17,2019,34109,-259,20,-239,451,337
17049,049,17,2020,34065,-142,18,-124,435,355
17051,051,17,2010,22140,-3,5,2,66,79
17051,051,17,2011,22385,166,24,190,234,179
17051,051,17,2012,22167,-252,19,-233,254,247
17051,051,17,2013,22201,16,0,16,227,204
17051,051,17,2014,22088,-164,6,-158,249,204
17051,051,17,2015,22048,-60,2,-58,256,236
17051,051,17,2016,21579,-483,3,-480,246,238
17051,051,17,2017,21537,-72,8,-64,245,222
17051,051,17,2018,21380,-173,4,-169,238,227
17051,051,17,2019,21332,-60,3,-57,224,217
17051,051,17,2020,21264,-68,2,-66,220,223
17053,053,17,2010,14076,-9,2,-7,40,30
17053,053,17,2011,13875,-114,1,-113,131,219
17053,053,17,2012,13877,37,1,38,146,183
17053,053,17,2013,13670,-147,1,-146,134,198
17053,053,17,2014,13539,-85,1,-84,160,207
17053,053,17,2015,13527,50,2,52,140,203
17053,053,17,2016,13346,-134,1,-133,146,194
17053,053,17,2017,13291,0,1,1,160,215
17053,053,17,2018,13215,-20,1,-19,152,210
17053,053,17,2019,12972,-193,0,-193,131,181
17053,053,17,2020,12949,16,0,16,141,180
17055,055,17,2010,40035,35,0,35,117,109
17055,055,17,2011,40038,78,19,97,445,537
17055,055,17,2012,39872,-95,16,-79,465,547
17055,055,17,2013,39561,-225,23,-202,471,577
17055,055,17,2014,39456,-87,9,-78,492,513
17055,055,17,2015,39398,3,0,3,515,571
17055,055,17,2016,39090,-269,5,-264,471,513
17055,055,17,2017,39024,-24,7,-17,464,511
17055,055,17,2018,38737,-235,6,-229,462,518
17055,055,17,2019,38530,-175,5,-170,468,505
17055,055,17,2020,38060,-371,5,-366,455,557
17057,057,17,2010,37076,4,1,5,78,72
17057,057,17,2011,36909,-73,-1,-74,372,463
17057,057,17,2012,36585,-213,-2,-215,352,462
17057,057,17,2013,36322,-190,-1,-191,348,416
17057,057,17,2014,35996,-193,10,-183,333,473
17057,057,17,2015,35709,-191,17,-174,337,449
17057,057,17,2016,35498,-100,11,-89,373,494
17057,057,17,2017,35099,-292,8,-284,340,454
17057,057,17,2018,34743,-189,8,-181,325,501
17057,057,17,2019,34240,-375,5,-370,310,443
17057,057,17,2020,33690,-368,2,-366,297,479
17059,059,17,2010,5574,-2,0,-2,19,32
17059,059,17,2011,5490,-54,0,-54,57,88
17059,059,17,2012,5391,-80,0,-80,49,70
17059,059,17,2013,5387,20,0,20,60,83
17059,059,17,2014,5279,-80,0,-80,54,84
17059,059,17,2015,5224,-37,0,-37,66,84
17059,059,17,2016,5165,-55,0,-55,62,65
17059,059,17,2017,5073,-62,0,-62,46,76
17059,059,17,2018,5049,26,0,26,44,93
17059,059,17,2019,4833,-178,0,-178,33,70
17059,059,17,2020,4793,6,0,6,33,78
17061,061,17,2010,13890,-14,1,-13,39,22
17061,061,17,2011,13857,-56,7,-49,152,136
17061,061,17,2012,13657,-201,6,-195,148,158
17061,061,17,2013,13635,-30,1,-29,139,130
17061,061,17,2014,13416,-221,1,-220,143,148
17061,061,17,2015,13345,-31,2,-29,129,170
17061,061,17,2016,13111,-173,1,-172,121,183
17061,061,17,2017,13153,93,1,94,128,179
17061,061,17,2018,13051,-96,1,-95,144,151
17061,061,17,2019,12922,-100,1,-99,138,167
17061,061,17,2020,12702,-177,0,-177,133,177
17063,063,17,2010,50155,-33,-1,-34,179,68
17063,063,17,2011,50103,-311,0,-311,639,380
17063,063,17,2012,50161,-178,-10,-188,627,385
17063,063,17,2013,50183,-220,-6,-226,610,361
17063,063,17,2014,50281,-111,1,-110,600,389
17063,063,17,2015,50358,-135,6,-129,630,420
17063,063,17,2016,50325,-280,15,-265,618,387
17063,063,17,2017,50627,116,26,142,579,416
17063,063,17,2018,51012,189,17,206,589,407
17063,063,17,2019,51031,-117,10,-107,562,439
17063,063,17,2020,50993,-160,12,-148,560,451
17065,065,17,2010,8446,6,0,6,25,41
17065,065,17,2011,8425,0,0,0,91,111
17065,065,17,2012,8387,-19,1,-18,96,116
17065,065,17,2013,8347,-7,0,-7,79,109
17065,065,17,2014,8313,5,1,6,73,111
17065,065,17,2015,8247,-56,0,-56,90,99
17065,065,17,2016,8197,-51,6,-45,99,104
17065,065,17,2017,8192,5,6,11,85,100
17065,065,17,2018,8149,-4,5,1,79,123
17065,065,17,2019,8133,-17,4,-13,79,80
17065,065,17,2020,8084,-16,3,-13,81,117
17067,067,17,2010,19091,6,0,6,44,60
17067,067,17,2011,18999,-109,3,-106,184,171
17067,067,17,2012,18830,-153,4,-149,189,211
17067,067,17,2013,18545,-271,6,-265,188,211
17067,067,17,2014,18326,-213,4,-209,194,207
17067,067,17,2015,18217,-132,5,-127,217,198
17067,067,17,2016,18206,-6,2,-4,200,207
17067,067,17,2017,17959,-203,3,-200,171,217
17067,067,17,2018,17815,-113,3,-110,183,217
17067,067,17,2019,17700,-99,2,-97,184,202
17067,067,17,2020,17422,-237,1,-236,179,218
17069,069,17,2010,4316,-3,0,-3,11,10
17069,069,17,2011,4291,-7,0,-7,40,58
17069,069,17,2012,4278,-1,0,-1,41,52
17069,069,17,2013,4174,-70,0,-70,25,60
17069,069,17,2014,4146,7,0,7,35,70
17069,069,17,2015,4065,-39,0,-39,23,65
17069,069,17,2016,3997,-45,0,-45,43,65
17069,069,17,2017,3920,-27,0,-27,27,77
17069,069,17,2018,3876,5,0,5,25,72
17069,069,17,2019,3848,-11,0,-11,37,53
17069,069,17,2020,3808,-5,0,-5,33,68
17071,071,17,2010,7344,7,0,7,17,8
17071,071,17,2011,7221,-93,-2,-95,63,91
17071,071,17,2012,7048,-151,-1,-152,55,82
17071,071,17,2013,6969,-51,2,-49,58,92
17071,071,17,2014,7018,42,1,43,74,67
17071,071,17,2015,7001,3,2,5,72,92
17071,071,17,2016,6889,-93,2,-91,61,83
17071,071,17,2017,6824,-48,2,-46,67,85
17071,071,17,2018,6726,-61,2,-59,60,98
17071,071,17,2019,6709,2,1,3,61,82
17071,071,17,2020,6535,-144,1,-143,62,92
17073,073,17,2010,50459,-60,0,-60,139,107
17073,073,17,2011,50293,-196,3,-193,553,526
17073,073,17,2012,50263,-30,-1,-31,538,531
17073,073,17,2013,49932,-385,13,-372,549,515
17073,073,17,2014,49841,-103,9,-94,517,509
17073,073,17,2015,49654,-208,3,-205,578,558
17073,073,17,2016,49511,-159,-7,-166,564,540
17073,073,17,2017,49222,-233,-4,-237,488,540
17073,073,17,2018,49082,-85,-2,-87,504,554
17073,073,17,2019,48933,-83,-8,-91,479,537
17073,073,17,2020,48411,-384,-2,-386,479,614
17075,075,17,2010,29701,-35,3,-32,79,63
17075,075,17,2011,29501,-137,11,-126,313,386
17075,075,17,2012,29270,-175,12,-163,315,384
17075,075,17,2013,28943,-244,15,-229,281,381
17075,075,17,2014,28725,-196,10,-186,307,340
17075,075,17,2015,28529,-99,5,-94,302,403
17075,075,17,2016,28150,-275,-1,-276,297,401
17075,075,17,2017,27780,-310,-1,-311,339,398
17075,075,17,2018,27450,-228,-2,-230,297,397
17075,075,17,2019,27093,-306,-2,-308,300,349
17075,075,17,2020,26711,-331,0,-331,292,341
17077,077,17,2010,60371,29,56,85,163,74
17077,077,17,2011,60378,-423,251,-172,662,483
17077,077,17,2012,59081,-1838,265,-1573,675,482
17077,077,17,2013,59779,254,256,510,679,494
17077,077,17,2014,59386,-861,224,-637,695,477
17077,077,17,2015,59249,-610,204,-406,730,465
17077,077,17,2016,58768,-960,220,-740,684,433
17077,077,17,2017,57973,-1261,251,-1010,693,488
17077,077,17,2018,57327,-927,187,-740,593,505
17077,077,17,2019,56844,-794,150,-644,639,480
17077,077,17,2020,56675,-387,121,-266,605,509
17079,079,17,2010,9725,-3,0,-3,37,9
17079,079,17,2011,9755,11,2,13,125,108
17079,079,17,2012,9674,-87,9,-78,103,107
17079,079,17,2013,9608,-70,8,-62,112,118
17079,079,17,2014,9633,8,11,19,111,103
17079,079,17,2015,9630,-40,8,-32,125,95
17079,079,17,2016,9557,-65,2,-63,98,108
17079,079,17,2017,9504,-54,3,-51,110,113
17079,079,17,2018,9589,74,2,76,111,101
17079,079,17,2019,9618,-24,1,-23,133,82
17079,079,17,2020,9465,-172,2,-170,116,97
17081,081,17,2010,38757,-34,10,-24,104,144
17081,081,17,2011,38758,-39,38,-1,449,445
17081,081,17,2012,38672,-159,37,-122,458,419
17081,081,17,2013,38656,-77,55,-22,478,464
17081,081,17,2014,38390,-326,32,-294,492,466
17081,081,17,2015,38290,-210,24,-186,522,435
17081,081,17,2016,38236,-159,21,-138,508,421
17081,081,17,2017,38059,-236,22,-214,469,433
17081,081,17,2018,37704,-358,17,-341,469,482
17081,081,17,2019,37635,-58,5,-53,450,465
17081,081,17,2020,37235,-367,10,-357,423,467
17083,083,17,2010,22997,-36,3,-33,57,39
17083,083,17,2011,22885,-97,21,-76,207,244
17083,083,17,2012,22717,-168,23,-145,239,264
17083,083,17,2013,22610,-80,27,-53,213,268
17083,083,17,2014,22500,-106,19,-87,200,225
17083,083,17,2015,22268,-191,27,-164,189,258
17083,083,17,2016,21965,-289,6,-283,225,245
17083,083,17,2017,21892,-6,13,7,213,292
17083,083,17,2018,21738,-97,8,-89,217,282
17083,083,17,2019,21667,-47,5,-42,209,239
17083,083,17,2020,21616,-48,5,-43,211,220
17085,085,17,2010,22647,-5,4,-1,40,70
17085,085,17,2011,22638,32,18,50,185,242
17085,085,17,2012,22542,-90,8,-82,210,222
17085,085,17,2013,22398,-101,9,-92,184,234
17085,085,17,2014,22341,24,8,32,174,257
17085,085,17,2015,22068,-204,-7,-211,192,256
17085,085,17,2016,21826,-178,-4,-182,180,239
17085,085,17,2017,21509,-212,-4,-216,162,264
17085,085,17,2018,21349,-96,-6,-102,182,240
17085,085,17,2019,21224,-20,-6,-26,155,253
17085,085,17,2020,21239,130,-3,127,156,267
17087,087,17,2010,12598,22,0,22,23,17
17087,087,17,2011,12849,244,0,244,125,121
17087,087,17,2012,12851,12,0,12,109,118
17087,087,17,2013,12861,23,-1,22,115,126
17087,087,17,2014,12882,23,0,23,110,111
17087,087,17,2015,12768,-89,0,-89,103,128
17087,087,17,2016,12445,-316,1,-315,105,117
17087,087,17,2017,12394,-26,1,-25,105,130
17087,087,17,2018,12380,44,1,45,100,158
17087,087,17,2019,12380,28,-1,27,113,141
17087,087,17,2020,12358,32,1,33,100,154
17089,089,17,2010,516060,-373,51,-322,1818,739
17089,089,17,2011,519091,-1755,488,-1267,7095,2795
17089,089,17,2012,520615,-2713,137,-2576,6957,2872
17089,089,17,2013,522523,-2043,196,-1847,6762,2998
17089,089,17,2014,525476,-1335,527,-808,6759,2942
17089,089,17,2015,528562,-918,451,-467,6771,3169
17089,089,17,2016,530540,-1755,150,-1605,6741,3150
17089,089,17,2017,532101,-2026,272,-1754,6561,3248
17089,089,17,2018,532838,-2369,95,-2274,6388,3386
17089,089,17,2019,532293,-3140,-120,-3260,6209,3510
17089,089,17,2020,531010,-3664,-24,-3688,6211,3815
17091,091,17,2010,113420,-108,14,-94,370,300
17091,091,17,2011,113532,-333,116,-217,1342,1011
17091,091,17,2012,112995,-993,81,-912,1380,1019
17091,091,17,2013,112764,-539,60,-479,1331,1077
17091,091,17,2014,111916,-1212,66,-1146,1362,1086
17091,091,17,2015,111786,-418,68,-350,1336,1108
17091,091,17,2016,111066,-899,30,-869,1309,1159
17091,091,17,2017,110530,-699,20,-679,1357,1213
17091,091,17,2018,109863,-763,8,-755,1240,1156
17091,091,17,2019,109569,-332,11,-321,1238,1214
17091,091,17,2020,108594,-914,14,-900,1205,1280
17093,093,17,2010,115369,184,12,196,508,145
17093,093,17,2011,116817,104,114,218,1726,493
17093,093,17,2012,118255,156,104,260,1688,485
17093,093,17,2013,119582,62,105,167,1711,529
17093,093,17,2014,121385,513,171,684,1680,535
17093,093,17,2015,122892,339,131,470,1624,572
17093,093,17,2016,124549,502,115,617,1616,571
17093,093,17,2017,126163,535,140,675,1552,610
17093,093,17,2018,127663,475,100,575,1478,546
17093,093,17,2019,128900,280,61,341,1514,619
17093,093,17,2020,130638,854,62,916,1482,660
17095,095,17,2010,52911,29,17,46,122,172
17095,095,17,2011,52702,-97,68,-29,518,694
17095,095,17,2012,52302,-306,57,-249,540,689
17095,095,17,2013,52130,-77,85,8,557,727
17095,095,17,2014,51945,-206,105,-101,558,637
17095,095,17,2015,51377,-537,96,-441,581,709
17095,095,17,2016,50931,-401,93,-308,561,698
17095,095,17,2017,50601,-360,104,-256,590,665
17095,095,17,2018,50008,-577,87,-490,569,673
17095,095,17,2019,49669,-333,72,-261,544,621
17095,095,17,2020,49053,-580,54,-526,530,617
17097,097,17,2010,704179,-731,305,-426,2228,1018
17097,097,17,2011,701652,-7922,1218,-6704,8152,4029
17097,097,17,2012,702117,-5551,2054,-3497,8088,4232
17097,097,17,2013,704259,-3181,1652,-1529,7958,4318
17097,097,17,2014,704359,-5091,1702,-3389,7733,4359
17097,097,17,2015,704687,-5259,2138,-3121,7930,4512
17097,097,17,2016,704401,-5100,1498,-3602,7753,4462
17097,097,17,2017,702825,-6100,1659,-4441,7501,4682
17097,097,17,2018,700455,-6015,926,-5089,7351,4681
17097,097,17,2019,697134,-6166,563,-5603,7091,4833
17097,097,17,2020,693593,-5843,542,-5301,6927,5168
17099,099,17,2010,113812,-122,9,-113,291,271
17099,099,17,2011,113527,-283,66,-217,1238,1302
17099,099,17,2012,112913,-506,38,-468,1171,1314
17099,099,17,2013,112419,-345,41,-304,1122,1300
17099,099,17,2014,111650,-757,48,-709,1225,1290
17099,099,17,2015,111015,-555,44,-511,1235,1357
17099,099,17,2016,110176,-789,26,-763,1256,1331
17099,099,17,2017,109590,-547,34,-513,1226,1300
17099,099,17,2018,109136,-277,22,-255,1180,1378
17099,099,17,2019,108517,-420,11,-409,1051,1263
17099,099,17,2020,107571,-743,8,-735,1059,1270
17101,101,17,2010,16940,18,0,18,51,33
17101,101,17,2011,16904,22,0,22,158,216
17101,101,17,2012,16732,-119,1,-118,165,220
17101,101,17,2013,16728,12,-2,10,170,182
17101,101,17,2014,16564,-169,2,-167,179,178
17101,101,17,2015,16467,-79,6,-73,191,216
17101,101,17,2016,16176,-211,3,-208,150,234
17101,101,17,2017,16025,-116,3,-113,155,192
17101,101,17,2018,15816,-156,3,-153,147,203
17101,101,17,2019,15665,-92,0,-92,143,201
17101,101,17,2020,15467,-120,-1,-121,143,220
17103,103,17,2010,35978,-79,0,-79,67,44
17103,103,17,2011,35611,-350,4,-346,351,372
17103,103,17,2012,35218,-449,4,-445,374,335
17103,103,17,2013,35123,-94,2,-92,363,360
17103,103,17,2014,34912,-204,7,-197,363,377
17103,103,17,2015,34521,-354,7,-347,330,375
17103,103,17,2016,34499,-6,6,0,343,362
17103,103,17,2017,34533,66,0,66,354,383
17103,103,17,2018,34281,-212,-2,-214,339,377
17103,103,17,2019,34061,-157,-3,-160,334,393
17103,103,17,2020,33647,-311,0,-311,326,428
17105,105,17,2010,38862,-83,3,-80,129,140
17105,105,17,2011,38813,-123,20,-103,436,382
17105,105,17,2012,38519,-302,28,-274,428,454
17105,105,17,2013,37404,-1142,12,-1130,415,442
17105,105,17,2014,37043,-379,36,-343,384,406
17105,105,17,2015,36615,-453,40,-413,399,420
17105,105,17,2016,36104,-513,7,-506,415,422
17105,105,17,2017,36080,-2,11,9,410,441
17105,105,17,2018,35630,-417,7,-410,438,479
17105,105,17,2019,35557,-89,6,-83,420,411
17105,105,17,2020,35414,-185,4,-181,427,389
17107,107,17,2010,30282,-32,1,-31,76,66
17107,107,17,2011,30271,-21,18,-3,306,313
17107,107,17,2012,30359,101,19,120,267,298
17107,107,17,2013,29829,-515,8,-507,301,341
17107,107,17,2014,29660,-166,12,-154,322,337
17107,107,17,2015,29286,-354,15,-339,327,365
17107,107,17,2016,29167,-88,17,-71,300,346
17107,107,17,2017,29035,-99,19,-80,291,342
17107,107,17,2018,28873,-76,13,-63,289,388
17107,107,17,2019,28633,-238,10,-228,301,312
17107,107,17,2020,28383,-227,9,-218,287,317
17109,109,17,2010,32631,-18,13,-5,75,52
17109,109,17,2011,32527,-147,36,-111,306,300
17109,109,17,2012,32567,-8,48,40,293,286
17109,109,17,2013,32264,-382,90,-292,304,328
17109,109,17,2014,31811,-564,82,-482,304,290
17109,109,17,2015,31461,-382,93,-289,262,327
17109,109,17,2016,30938,-569,93,-476,284,335
17109,109,17,2017,30419,-631,127,-504,289,309
17109,109,17,2018,30091,-386,99,-287,264,308
17109,109,17,2019,29792,-317,79,-238,248,311
17109,109,17,2020,29295,-487,55,-432,246,308
17111,111,17,2010,309121,-171,29,-142,878,492
17111,111,17,2011,308519,-2306,238,-2068,3367,1913
17111,111,17,2012,308248,-1883,141,-1742,3332,1893
17111,111,17,2013,307629,-2031,206,-1825,3141,1965
17111,111,17,2014,307425,-1563,156,-1407,3180,2003
17111,111,17,2015,307595,-1196,107,-1089,3332,2074
17111,111,17,2016,307142,-1616,55,-1561,3149,2047
17111,111,17,2017,307842,-435,108,-327,3145,2112
17111,111,17,2018,308145,-560,41,-519,3092,2268
17111,111,17,2019,307439,-1453,-83,-1536,3001,2178
17111,111,17,2020,305888,-2092,-28,-2120,2957,2389
17113,113,17,2010,169815,-65,118,53,527,327
17113,113,17,2011,170939,-569,643,74,2149,1100
17113,113,17,2012,172762,194,627,821,2078,1043
17113,113,17,2013,175087,630,668,1298,2218,1182
17113,113,17,2014,174166,-2681,749,-1932,2056,1115
17113,113,17,2015,173222,-2661,768,-1893,2092,1179
17113,113,17,2016,173157,-1611,609,-1002,2103,1172
17113,113,17,2017,172769,-1954,720,-1234,2005,1172
17113,113,17,2018,172368,-1598,536,-1062,1902,1250
17113,113,17,2019,171272,-2047,399,-1648,1789,1242
17113,113,17,2020,171256,-781,323,-458,1752,1318
17115,115,17,2010,110786,-118,21,-97,358,249
17115,115,17,2011,110699,-373,75,-298,1387,1173
17115,115,17,2012,110162,-749,76,-673,1319,1185
17115,115,17,2013,109596,-844,65,-779,1387,1176
17115,115,17,2014,108562,-1216,74,-1142,1354,1267
17115,115,17,2015,107398,-1270,54,-1216,1380,1335
17115,115,17,2016,106411,-1121,47,-1074,1313,1230
17115,115,17,2017,105474,-1078,58,-1020,1294,1213
17115,115,17,2018,104529,-1028,37,-991,1333,1286
17115,115,17,2019,104012,-596,31,-565,1247,1199
17115,115,17,2020,103015,-1003,20,-983,1234,1245
17117,117,17,2010,47798,51,2,53,120,135
17117,117,17,2011,47742,-28,10,-18,496,533
17117,117,17,2012,47058,-593,7,-586,445,557
17117,117,17,2013,46685,-281,10,-271,452,557
17117,117,17,2014,46216,-341,5,-336,442,577
17117,117,17,2015,45887,-232,3,-229,450,547
17117,117,17,2016,45708,-78,7,-71,462,569
17117,117,17,2017,45521,-61,8,-53,458,589
17117,117,17,2018,45342,-46,4,-42,443,577
17117,117,17,2019,45079,-202,3,-199,479,543
17117,117,17,2020,44567,-363,4,-359,451,603
17119,119,17,2010,269315,-150,36,-114,821,666
17119,119,17,2011,268666,-1383,149,-1234,3230,2644
17119,119,17,2012,268124,-1255,162,-1093,3181,2626
17119,119,17,2013,267340,-1174,107,-1067,3077,2791
17119,119,17,2014,266662,-1085,82,-1003,3106,2774
17119,119,17,2015,266112,-832,67,-765,3133,2897
17119,119,17,2016,265773,-628,84,-544,3026,2810
17119,119,17,2017,265516,-488,116,-372,2984,2859
17119,119,17,2018,264481,-1016,81,-935,2950,3050
17119,119,17,2019,263609,-861,53,-808,2782,2854
17119,119,17,2020,262635,-754,41,-713,2754,3027
17121,121,17,2010,39416,30,0,30,122,169
17121,121,17,2011,39147,-213,7,-206,491,553
17121,121,17,2012,39018,-148,11,-137,504,493
17121,121,17,2013,38685,-327,11,-316,477,497
17121,121,17,2014,38573,-132,27,-105,491,494
17121,121,17,2015,38381,-212,26,-186,527,531
17121,121,17,2016,38057,-302,17,-285,490,528
17121,121,17,2017,37757,-253,19,-234,488,555
17121,121,17,2018,37453,-278,14,-264,476,517
17121,121,17,2019,37309,-121,13,-108,468,504
17121,121,17,2020,37045,-311,10,-301,455,418
17123,123,17,2010,12637,-12,2,-10,26,25
17123,123,17,2011,12488,-102,0,-102,122,170
17123,123,17,2012,12261,-158,-1,-159,95,164
17123,123,17,2013,12129,-117,3,-114,133,153
17123,123,17,2014,11966,-115,2,-113,114,164
17123,123,17,2015,11925,-23,1,-22,142,159
17123,123,17,2016,11887,-10,1,-9,137,165
17123,123,17,2017,11667,-163,1,-162,112,171
17123,123,17,2018,11485,-109,1,-108,106,179
17123,123,17,2019,11463,-6,1,-5,130,147
17123,123,17,2020,11309,-138,1,-137,122,139
17125,125,17,2010,14651,-29,1,-28,48,35
17125,125,17,2011,14470,-130,2,-128,152,204
17125,125,17,2012,14322,-97,3,-94,129,187
17125,125,17,2013,14144,-103,0,-103,140,213
17125,125,17,2014,14102,-8,0,-8,143,174
17125,125,17,2015,13862,-183,0,-183,122,182
17125,125,17,2016,13677,-123,0,-123,140,202
17125,125,17,2017,13672,38,0,38,130,172
17125,125,17,2018,13520,-58,0,-58,119,212
17125,125,17,2019,13387,-105,0,-105,134,162
17125,125,17,2020,13173,-163,0,-163,127,178
17127,127,17,2010,15380,-11,0,-11,43,81
17127,127,17,2011,15281,-64,1,-63,181,217
17127,127,17,2012,15067,-189,6,-183,170,203
17127,127,17,2013,14846,-142,3,-139,143,227
17127,127,17,2014,14756,-75,2,-73,159,175
17127,127,17,2015,14568,-113,-2,-115,158,231
17127,127,17,2016,14461,-69,-1,-70,180,217
17127,127,17,2017,14298,-98,0,-98,154,219
17127,127,17,2018,14037,-203,0,-203,141,200
17127,127,17,2019,13772,-206,0,-206,137,195
17127,127,17,2020,13636,-90,0,-90,136,182
17129,129,17,2010,12696,-7,0,-7,40,42
17129,129,17,2011,12700,-10,-2,-12,133,116
17129,129,17,2012,12692,0,-3,-3,112,118
17129,129,17,2013,12576,-90,-2,-92,114,138
17129,129,17,2014,12513,-59,-2,-61,132,135
17129,129,17,2015,12364,-119,-2,-121,97,125
17129,129,17,2016,12431,48,0,48,141,122
17129,129,17,2017,12311,-122,0,-122,132,131
17129,129,17,2018,12297,17,0,17,110,140
17129,129,17,2019,12198,-95,0,-95,116,119
17129,129,17,2020,12068,-87,0,-87,104,148
17131,131,17,2010,16410,-4,0,-4,39,59
17131,131,17,2011,16320,-81,5,-76,150,164
17131,131,17,2012,16165,-139,3,-136,149,172
17131,131,17,2013,16077,-51,3,-48,148,189
17131,131,17,2014,15902,-149,5,-144,156,188
17131,131,17,2015,15748,-121,4,-117,137,174
17131,131,17,2016,15611,-85,4,-81,140,195
17131,131,17,2017,15618,41,4,45,162,197
17131,131,17,2018,15572,31,4,35,131,210
17131,131,17,2019,15490,-48,4,-44,146,184
17131,131,17,2020,15225,-227,2,-225,139,179
17133,133,17,2010,33051,16,-1,15,84,49
17133,133,17,2011,33273,186,-3,183,306,266
17133,133,17,2012,33320,4,-4,0,319,267
17133,133,17,2013,33523,172,0,172,335,298
17133,133,17,2014,33608,33,3,36,318,266
17133,133,17,2015,33811,164,5,169,357,319
17133,133,17,2016,34037,99,6,105,400,279
17133,133,17,2017,34261,184,6,190,320,283
17133,133,17,2018,34446,143,5,148,347,308
17133,133,17,2019,34738,230,3,233,379,318
17133,133,17,2020,34739,-38,4,-34,383,348
17135,135,17,2010,30095,-13,0,-13,73,65
17135,135,17,2011,29866,-167,5,-162,299,365
17135,135,17,2012,29620,-231,0,-231,311,333
17135,135,17,2013,29367,-207,2,-205,301,355
17135,135,17,2014,29450,155,1,156,277,353
17135,135,17,2015,29196,-180,1,-179,281,356
17135,135,17,2016,29057,-67,0,-67,299,369
17135,135,17,2017,28781,-226,0,-226,319,370
17135,135,17,2018,28705,-38,0,-38,304,341
17135,135,17,2019,28401,-226,0,-226,299,378
17135,135,17,2020,28045,-252,0,-252,287,391
17137,137,17,2010,35499,-35,3,-32,78,87
17137,137,17,2011,35482,-35,30,-5,372,380
17137,137,17,2012,35318,-158,29,-129,378,411
17137,137,17,2013,35009,-314,34,-280,391,421
17137,137,17,2014,34684,-339,36,-303,350,372
17137,137,17,2015,34693,-30,47,17,388,391
17137,137,17,2016,34654,-43,52,9,347,393
17137,137,17,2017,34275,-409,58,-351,385,413
17137,137,17,2018,34052,-215,44,-171,367,421
17137,137,17,2019,33679,-350,39,-311,312,371
17137,137,17,2020,33400,-241,29,-212,318,386
17139,139,17,2010,14863,21,0,21,49,65
17139,139,17,2011,14859,43,1,44,168,214
17139,139,17,2012,14876,10,1,11,183,177
17139,139,17,2013,14799,-78,0,-78,177,175
17139,139,17,2014,14754,-64,3,-61,200,182
17139,139,17,2015,14747,7,3,10,194,210
17139,139,17,2016,14610,-136,2,-134,187,190
17139,139,17,2017,14704,75,2,77,187,170
17139,139,17,2018,14662,-44,2,-42,194,193
17139,139,17,2019,14464,-194,2,-192,155,162
17139,139,17,2020,14347,-126,2,-124,160,152
17141,141,17,2010,53420,-77,3,-74,135,138
17141,141,17,2011,53073,-431,8,-423,546,471
17141,141,17,2012,52788,-349,12,-337,521,474
17141,141,17,2013,52278,-587,6,-581,538,482
17141,141,17,2014,51944,-403,30,-373,546,514
17141,141,17,2015,51572,-405,32,-373,519,519
17141,141,17,2016,51174,-486,24,-462,546,486
17141,141,17,2017,51021,-181,19,-162,533,521
17141,141,17,2018,50802,-191,14,-177,504,546
17141,141,17,2019,50660,-203,17,-186,540,494
17141,141,17,2020,50306,-374,14,-360,526,520
17143,143,17,2010,186224,-563,81,-482,624,435
17143,143,17,2011,186775,-619,411,-208,2575,1812
17143,143,17,2012,187354,-681,443,-238,2580,1734
17143,143,17,2013,188688,-19,427,408,2780,1820
17143,143,17,2014,187572,-2480,327,-2153,2755,1765
17143,143,17,2015,186552,-2213,345,-1868,2705,1872
17143,143,17,2016,185116,-2516,327,-2189,2585,1838
17143,143,17,2017,182657,-3528,388,-3140,2504,1839
17143,143,17,2018,180773,-2874,292,-2582,2560,1868
17143,143,17,2019,179359,-2298,226,-2072,2465,1803
17143,143,17,2020,177652,-2374,187,-2187,2411,1920
17145,145,17,2010,22316,-4,3,-1,49,76
17145,145,17,2011,22267,-27,24,-3,204,249
17145,145,17,2012,21849,-431,19,-412,205,227
17145,145,17,2013,21718,-115,17,-98,209,240
17145,145,17,2014,21543,-162,4,-158,226,241
17145,145,17,2015,21522,43,4,47,201,267
17145,145,17,2016,21407,-118,8,-110,227,232
17145,145,17,2017,21292,-97,10,-87,209,236
17145,145,17,2018,21163,-106,9,-97,196,230
17145,145,17,2019,20935,-187,8,-179,180,229
17145,145,17,2020,20664,-205,6,-199,173,244
17147,147,17,2010,16710,-9,1,-8,47,54
17147,147,17,2011,16683,-38,4,-34,154,148
17147,147,17,2012,16505,-182,3,-179,177,178
17147,147,17,2013,16437,-38,2,-36,161,193
17147,147,17,2014,16414,-39,3,-36,182,167
17147,147,17,2015,16356,-67,0,-67,190,181
17147,147,17,2016,16511,150,0,150,163,156
17147,147,17,2017,16427,-93,-1,-94,181,173
17147,147,17,2018,16375,-69,-1,-70,181,162
17147,147,17,2019,16391,-4,-1,-5,184,164
17147,147,17,2020,16355,-25,-1,-26,180,189
17149,149,17,2010,16395,-14,0,-14,34,56
17149,149,17,2011,16348,-21,1,-20,189,215
17149,149,17,2012,16233,-77,0,-77,165,202
17149,149,17,2013,16069,-149,0,-149,169,185
17149,149,17,2014,15953,-87,0,-87,178,204
17149,149,17,2015,15794,-139,-1,-140,177,199
17149,149,17,2016,15757,-27,0,-27,203,212
17149,149,17,2017,15669,-56,1,-55,187,217
17149,149,17,2018,15614,-62,1,-61,203,197
17149,149,17,2019,15574,-48,1,-47,199,191
17149,149,17,2020,15239,-349,0,-349,203,187
17151,151,17,2010,4477,2,0,2,3,5
17151,151,17,2011,4502,47,2,49,33,58
17151,151,17,2012,4464,-15,3,-12,33,59
17151,151,17,2013,4462,23,1,24,29,54
17151,151,17,2014,4382,-68,0,-68,31,45
17151,151,17,2015,4302,-69,0,-69,32,44
17151,151,17,2016,4189,-81,0,-81,23,55
17151,151,17,2017,4193,29,1,30,25,50
17151,151,17,2018,4183,22,0,22,28,60
17151,151,17,2019,4176,2,0,2,29,37
17151,151,17,2020,4142,-27,0,-27,27,35
17153,153,17,2010,6131,-8,0,-8,14,39
17153,153,17,2011,5990,-129,2,-127,56,71
17153,153,17,2012,5965,-7,2,-5,71,90
17153,153,17,2013,5897,-40,3,-37,56,88
17153,153,17,2014,5802,-92,3,-89,64,72
17153,153,17,2015,5662,-110,2,-108,63,96
17153,153,17,2016,5604,-38,4,-34,62,85
17153,153,17,2017,5531,-90,6,-84,89,79
17153,153,17,2018,5426,-103,5,-98,57,65
17153,153,17,2019,5309,-103,3,-100,43,59
17153,153,17,2020,5201,-84,2,-82,42,67
17155,155,17,2010,6014,-2,1,-1,13,5
17155,155,17,2011,5978,-33,1,-32,49,53
17155,155,17,2012,5911,-69,2,-67,55,55
17155,155,17,2013,5854,-53,2,-51,51,59
17155,155,17,2014,5831,-12,2,-10,41,52
17155,155,17,2015,5729,-107,1,-106,64,61
17155,155,17,2016,5702,-6,0,-6,40,60
17155,155,17,2017,5696,12,0,12,53,71
17155,155,17,2018,5740,44,-1,43,52,51
17155,155,17,2019,5745,22,-1,21,39,54
17155,155,17,2020,5716,-3,1,-2,37,65
17157,157,17,2010,33410,-42,0,-42,82,56
17157,157,17,2011,33375,-30,9,-21,345,358
17157,157,17,2012,33023,-326,6,-320,343,381
17157,157,17,2013,33123,112,-1,111,373,381
17157,157,17,2014,33088,-46,5,-41,344,334
17157,157,17,2015,32754,-253,9,-244,310,401
17157,157,17,2016,32368,-352,18,-334,329,383
17157,157,17,2017,32258,-108,20,-88,370,390
17157,157,17,2018,32161,-85,17,-68,329,358
17157,157,17,2019,31725,-343,14,-329,293,398
17157,157,17,2020,31351,-256,12,-244,292,422
17159,159,17,2010,16193,-13,0,-13,49,76
17159,159,17,2011,16189,-40,5,-35,212,180
17159,159,17,2012,16132,-75,3,-72,190,175
17159,159,17,2013,16008,-106,0,-106,189,207
17159,159,17,2014,16019,22,6,28,195,209
17159,159,17,2015,15952,-54,4,-50,203,218
17159,159,17,2016,15819,-109,7,-102,192,224
17159,159,17,2017,15842,28,9,37,187,200
17159,159,17,2018,15700,-111,7,-104,184,221
17159,159,17,2019,15519,-160,5,-155,167,193
17159,159,17,2020,15507,19,1,20,165,196
17161,161,17,2010,147613,-163,62,-101,479,298
17161,161,17,2011,147474,-812,349,-463,1873,1548
17161,161,17,2012,147699,-489,405,-84,1899,1569
17161,161,17,2013,147686,-686,479,-207,1779,1574
17161,161,17,2014,147090,-1478,490,-988,1891,1509
17161,161,17,2015,146161,-1611,390,-1221,1883,1600
17161,161,17,2016,144977,-1792,315,-1477,1865,1572
17161,161,17,2017,143824,-1666,364,-1302,1789,1644
17161,161,17,2018,142522,-1588,299,-1289,1635,1650
17161,161,17,2019,141775,-1188,218,-970,1724,1501
17161,161,17,2020,140907,-1199,181,-1018,1686,1536
17163,163,17,2010,270368,-104,91,-13,836,513
17163,163,17,2011,270097,-1477,97,-1380,3552,2443
17163,163,17,2012,268748,-2691,354,-2337,3401,2465
17163,163,17,2013,266934,-2904,185,-2719,3367,2509
17163,163,17,2014,266061,-1946,209,-1737,3390,2539
17163,163,17,2015,265008,-2320,300,-2020,3430,2470
17163,163,17,2016,263482,-2614,213,-2401,3416,2550
17163,163,17,2017,262881,-1371,183,-1188,3174,2589
17163,163,17,2018,261631,-1913,83,-1830,3261,2685
17163,163,17,2019,259889,-2128,104,-2024,2984,2709
17163,163,17,2020,258046,-1984,82,-1902,2985,2926
17165,165,17,2010,24900,32,2,34,70,117
17165,165,17,2011,24904,44,7,51,311,357
17165,165,17,2012,24913,18,6,24,319,327
17165,165,17,2013,24801,-69,3,-66,309,353
17165,165,17,2014,24496,-252,3,-249,310,369
17165,165,17,2015,24495,-9,1,-8,368,358
17165,165,17,2016,24217,-229,0,-229,321,371
17165,165,17,2017,23968,-156,0,-156,299,391
17165,165,17,2018,23769,-88,0,-88,286,396
17165,165,17,2019,23540,-203,0,-203,288,313
17165,165,17,2020,23182,-284,0,-284,270,343
17167,167,17,2010,197769,162,31,193,626,497
17167,167,17,2011,199052,439,247,686,2404,1800
17167,167,17,2012,199431,-335,262,-73,2342,1850
17167,167,17,2013,199190,-969,282,-687,2284,1835
17167,167,17,2014,199252,-622,279,-343,2262,1841
17167,167,17,2015,198973,-909,284,-625,2335,1977
17167,167,17,2016,198085,-1447,239,-1208,2261,1943
17167,167,17,2017,197163,-1521,291,-1230,2273,1968
17167,167,17,2018,195802,-1739,215,-1524,2262,2106
17167,167,17,2019,194882,-1239,163,-1076,2226,2075
17167,167,17,2020,193882,-992,139,-853,2166,2315
17169,169,17,2010,7534,-1,3,2,19,29
17169,169,17,2011,7463,-41,-1,-42,63,91
17169,169,17,2012,7456,-1,0,-1,76,81
17169,169,17,2013,7393,-54,13,-41,59,83
17169,169,17,2014,7262,-117,4,-113,55,76
17169,169,17,2015,7150,-103,6,-97,68,85
17169,169,17,2016,7040,-101,20,-81,58,87
17169,169,17,2017,6984,-23,29,6,49,110
17169,169,17,2018,6896,-73,25,-48,63,102
17169,169,17,2019,6829,-65,21,-44,65,88
17169,169,17,2020,6738,-90,16,-74,61,77
17171,171,17,2010,5330,-9,0,-9,8,26
17171,171,17,2011,5232,-85,0,-85,50,64
17171,171,17,2012,5290,58,0,58,53,55
17171,171,17,2013,5212,-51,0,-51,41,67
17171,171,17,2014,5171,-34,1,-33,46,55
17171,171,17,2015,5112,-47,0,-47,54,66
17171,171,17,2016,5053,-65,6,-59,52,52
17171,171,17,2017,4983,-63,7,-56,48,62
17171,171,17,2018,4952,-35,6,-29,50,52
17171,171,17,2019,4974,37,6,43,30,51
17171,171,17,2020,4950,-16,5,-11,41,53
17173,173,17,2010,22354,-19,1,-18,64,47
17173,173,17,2011,22280,-81,8,-73,226,226
17173,173,17,2012,22204,-89,6,-83,229,221
17173,173,17,2013,22139,-82,7,-75,244,234
17173,173,17,2014,22102,-68,2,-66,261,227
17173,173,17,2015,21819,-267,1,-266,250,267
17173,173,17,2016,21734,-96,0,-96,254,241
17173,173,17,2017,21773,3,0,3,254,216
17173,173,17,2018,21685,-33,0,-33,213,267
17173,173,17,2019,21625,-63,-1,-64,241,237
17173,173,17,2020,21299,-284,0,-284,235,276
17175,175,17,2010,5970,-22,0,-22,17,18
17175,175,17,2011,5843,-114,1,-113,60,76
17175,175,17,2012,5742,-83,1,-82,65,85
17175,175,17,2013,5708,-6,0,-6,57,84
17175,175,17,2014,5602,-109,0,-109,72,71
17175,175,17,2015,5508,-67,2,-65,59,89
17175,175,17,2016,5523,31,2,33,74,91
17175,175,17,2017,5459,-52,1,-51,57,70
17175,175,17,2018,5407,-38,0,-38,60,75
17175,175,17,2019,5312,-66,1,-65,49,78
17175,175,17,2020,5262,-34,1,-33,51,68
17177,177,17,2010,47606,-55,3,-52,119,163
17177,177,17,2011,47328,-252,12,-240,486,523
17177,177,17,2012,46895,-451,11,-440,520,519
17177,177,17,2013,46683,-191,32,-159,482,536
17177,177,17,2014,46280,-405,29,-376,484,517
17177,177,17,2015,45680,-612,22,-590,526,541
17177,177,17,2016,45512,-144,23,-121,493,539
17177,177,17,2017,44998,-461,25,-436,472,550
17177,177,17,2018,44702,-208,19,-189,491,597
17177,177,17,2019,44371,-304,16,-288,490,532
17177,177,17,2020,43831,-430,17,-413,471,597
17179,179,17,2010,135487,3,5,8,400,298
17179,179,17,2011,135863,84,36,120,1655,1391
17179,179,17,2012,136149,47,28,75,1602,1365
17179,179,17,2013,136297,-129,46,-83,1629,1381
17179,179,17,2014,135392,-1233,57,-1176,1626,1372
17179,179,17,2015,134350,-1225,82,-1143,1551,1456
17179,179,17,2016,134004,-581,70,-511,1562,1393
17179,179,17,2017,133525,-559,85,-474,1446,1450
17179,179,17,2018,132465,-1085,63,-1022,1390,1430
17179,179,17,2019,131848,-626,48,-578,1398,1440
17179,179,17,2020,130777,-889,33,-856,1339,1556
17181,181,17,2010,17729,-35,0,-35,33,73
17181,181,17,2011,17690,-34,6,-28,182,192
17181,181,17,2012,17609,-32,8,-24,184,238
17181,181,17,2013,17541,-23,4,-19,188,235
17181,181,17,2014,17404,-93,7,-86,187,238
17181,181,17,2015,17285,-81,3,-78,196,235
17181,181,17,2016,17120,-172,4,-168,200,197
17181,181,17,2017,16982,-82,7,-75,175,237
17181,181,17,2018,16853,-90,6,-84,178,224
17181,181,17,2019,16693,-121,5,-116,177,221
17181,181,17,2020,16498,-136,3,-133,178,239
17183,183,17,2010,81642,-97,7,-90,274,163
17183,183,17,2011,81427,-307,31,-276,1089,1028
17183,183,17,2012,80881,-717,20,-697,1074,932
17183,183,17,2013,80608,-397,23,-374,1069,963
17183,183,17,2014,79811,-899,36,-863,1023,969
17183,183,17,2015,79209,-625,41,-584,1017,1034
17183,183,17,2016,78503,-777,25,-752,1016,971
17183,183,17,2017,77722,-803,25,-778,986,988
17183,183,17,2018,76703,-1019,16,-1003,987,1004
17183,183,17,2019,75736,-988,16,-972,918,911
17183,183,17,2020,74855,-790,13,-777,880,981
17185,185,17,2010,11916,-24,0,-24,17,23
17185,185,17,2011,11796,-120,20,-100,147,167
17185,185,17,2012,11690,-131,23,-108,147,147
17185,185,17,2013,11675,-38,30,-8,140,147
17185,185,17,2014,11604,-99,33,-66,132,139
17185,185,17,2015,11627,-12,33,21,139,135
17185,185,17,2016,11518,-129,5,-124,152,138
17185,185,17,2017,11466,-55,7,-48,136,139
17185,185,17,2018,11407,-76,5,-71,133,120
17185,185,17,2019,11370,-66,3,-63,145,118
17185,185,17,2020,11190,-182,2,-180,135,134
17187,187,17,2010,17710,-16,3,-13,54,30
17187,187,17,2011,17831,80,29,109,191,180
17187,187,17,2012,17742,-168,48,-120,223,192
17187,187,17,2013,17660,-168,46,-122,215,181
17187,187,17,2014,17705,-25,46,21,217,188
17187,187,17,2015,17448,-331,47,-284,214,190
17187,187,17,2016,17283,-245,34,-211,234,189
17187,187,17,2017,17133,-233,43,-190,205,165
17187,187,17,2018,16979,-196,29,-167,209,197
17187,187,17,2019,16816,-205,24,-181,203,184
17187,187,17,2020,16696,-146,19,-127,196,189
17189,189,17,2010,14711,-18,0,-18,34,20
17189,189,17,2011,14574,-130,-1,-131,151,158
17189,189,17,2012,14598,33,0,33,135,143
17189,189,17,2013,14411,-192,1,-191,163,162
17189,189,17,2014,14389,-19,3,-16,148,153
17189,189,17,2015,14259,-147,2,-145,170,155
17189,189,17,2016,14176,-87,4,-83,170,171
17189,189,17,2017,13960,-227,5,-222,155,148
17189,189,17,2018,14010,56,7,63,144,156
17189,189,17,2019,13926,-99,3,-96,158,146
17189,189,17,2020,13764,-162,1,-161,146,147
17191,191,17,2010,16739,-5,1,-4,56,71
17191,191,17,2011,16667,-77,6,-71,194,195
17191,191,17,2012,16668,-3,7,4,211,211
17191,191,17,2013,16679,6,14,20,193,199
17191,191,17,2014,16610,-49,11,-38,215,243
17191,191,17,2015,16534,-53,6,-47,199,226
17191,191,17,2016,16573,-23,6,-17,231,174
17191,191,17,2017,16435,-119,7,-112,185,210
17191,191,17,2018,16311,-127,7,-120,190,194
17191,191,17,2019,16196,-119,6,-113,209,209
17191,191,17,2020,16031,-145,4,-141,200,224
17193,193,17,2010,14598,-21,0,-21,29,74
17193,193,17,2011,14592,31,5,36,180,223
17193,193,17,2012,14524,-17,3,-14,157,208
17193,193,17,2013,14435,-27,4,-23,176,242
17193,193,17,2014,14265,-117,2,-115,153,209
17193,193,17,2015,14204,3,8,11,165,235
17193,193,17,2016,14081,-64,2,-62,162,221
17193,193,17,2017,13898,-100,3,-97,157,243
17193,193,17,2018,13642,-173,1,-172,148,231
17193,193,17,2019,13574,4,1,5,111,184
17193,193,17,2020,13364,-134,2,-132,121,199
17195,195,17,2010,58489,-93,4,-89,192,120
17195,195,17,2011,58288,-228,17,-211,654,643
17195,195,17,2012,57772,-473,4,-469,639,691
17195,195,17,2013,57477,-272,2,-270,634,657
17195,195,17,2014,57037,-434,3,-431,628,641
17195,195,17,2015,56943,-149,5,-144,645,590
17195,195,17,2016,56505,-415,10,-405,626,658
17195,195,17,2017,56009,-460,13,-447,639,688
17195,195,17,2018,55532,-304,3,-301,580,756
17195,195,17,2019,55215,-307,5,-302,615,630
17195,195,17,2020,54656,-495,4,-491,580,647
17197,197,17,2010,678829,-293,150,-143,2214,805
17197,197,17,2011,680813,-3227,916,-2311,8198,3909
17197,197,17,2012,682459,-3300,687,-2613,8096,3881
17197,197,17,2013,683720,-2961,462,-2499,7839,4084
17197,197,17,2014,685123,-2724,437,-2287,7717,4026
17197,197,17,2015,685825,-3394,488,-2906,7927,4327
17197,197,17,2016,688330,-1369,299,-1070,7904,4321
17197,197,17,2017,690356,-1170,438,-732,7444,4677
17197,197,17,2018,690934,-2283,215,-2068,7525,4894
17197,197,17,2019,690176,-3189,-1,-3190,7199,4790
17197,197,17,2020,688726,-3511,66,-3445,7169,5185
17199,199,17,2010,66440,25,6,31,190,149
17199,199,17,2011,66745,225,40,265,801,759
17199,199,17,2012,66793,18,52,70,750,756
17199,199,17,2013,67472,564,70,634,792,754
17199,199,17,2014,67439,-128,66,-62,778,735
17199,199,17,2015,67457,-116,49,-67,826,736
17199,199,17,2016,67504,-61,43,-18,837,770
17199,199,17,2017,67076,-425,50,-375,725,774
17199,199,17,2018,67017,-48,41,-7,770,820
17199,199,17,2019,66633,-357,23,-334,698,749
17199,199,17,2020,66415,-99,25,-74,702,849
17201,201,17,2010,295090,-643,68,-575,890,512
17201,201,17,2011,293667,-2805,359,-2446,3776,2762
17201,201,17,2012,292128,-2919,392,-2527,3559,2628
17201,201,17,2013,291006,-2305,353,-1952,3621,2815
17201,201,17,2014,288770,-3360,388,-2972,3551,2871
17201,201,17,2015,287237,-2582,445,-2137,3641,3048
17201,201,17,2016,286171,-2280,381,-1899,3735,2900
17201,201,17,2017,284658,-2569,447,-2122,3557,2954
17201,201,17,2018,283588,-1875,379,-1496,3527,3106
17201,201,17,2019,282465,-1899,203,-1696,3438,2869
17201,201,17,2020,281295,-1829,187,-1642,3440,2972
17203,203,17,2010,38662,-47,4,-43,111,64
17203,203,17,2011,38849,48,15,63,443,318
17203,203,17,2012,38846,-81,21,-60,458,398
17203,203,17,2013,39039,106,15,121,441,363
17203,203,17,2014,39068,-51,14,-37,442,373
17203,203,17,2015,38949,-143,12,-131,426,413
17203,203,17,2016,38934,-77,0,-77,435,373
17203,203,17,2017,38676,-246,3,-243,405,421
17203,203,17,2018,38461,-254,2,-252,427,392
17203,203,17,2019,38353,-171,1,-170,426,363
17203,203,17,2020,38091,-236,0,-236,405,430
18001,001,18,2010,34442,-63,1,-62,182,64
18001,001,18,2011,34370,-403,11,-392,635,316
18001,001,18,2012,34408,-345,14,-331,679,317
18001,001,18,2013,34655,-123,11,-112,676,315
18001,001,18,2014,34771,-286,8,-278,699,309
18001,001,18,2015,34962,-134,1,-133,650,323
18001,001,18,2016,35216,-126,11,-115,684,314
18001,001,18,2017,35409,-162,4,-158,671,320
18001,001,18,2018,35565,-207,7,-200,673,318
18001,001,18,2019,35688,-244,6,-238,639,279
18001,001,18,2020,35839,-194,5,-189,631,290
18003,003,18,2010,355956,-332,198,-134,1345,579
18003,003,18,2011,359013,-145,805,660,5261,2848
18003,003,18,2012,360946,-1082,789,-293,5206,2935
18003,003,18,2013,363432,-245,630,385,5180,3025
18003,003,18,2014,365254,-800,566,-234,5143,3031
18003,003,18,2015,367508,-161,434,273,5273,3244
18003,003,18,2016,369526,-597,643,46,5215,3227
18003,003,18,2017,371803,81,420,501,5221,3427
18003,003,18,2018,375076,772,734,1506,5140,3358
18003,003,18,2019,379006,1514,504,2018,5292,3386
18003,003,18,2020,382187,897,393,1290,5286,3415
18005,005,18,2010,76823,-72,73,1,249,205
18005,005,18,2011,77639,275,271,546,985,712
18005,005,18,2012,79031,681,323,1004,1069,701
18005,005,18,2013,79692,-2,305,303,1051,679
18005,005,18,2014,80546,123,426,549,1096,771
18005,005,18,2015,81516,212,419,631,1083,739
18005,005,18,2016,82373,-161,677,516,1077,733
18005,005,18,2017,82455,-638,467,-171,1065,813
18005,005,18,2018,83062,-436,731,295,1048,737
18005,005,18,2019,84063,164,539,703,1030,735
18005,005,18,2020,84447,-298,418,120,1051,790
18007,007,18,2010,8863,21,0,21,20,14
18007,007,18,2011,8859,-22,1,-21,99,82
18007,007,18,2012,8824,-61,5,-56,98,78
18007,007,18,2013,8752,-79,1,-78,106,99
18007,007,18,2014,8724,-63,2,-61,116,87
18007,007,18,2015,8698,-47,1,-46,114,94
18007,007,18,2016,8659,-63,0,-63,107,84
18007,007,18,2017,8637,-71,4,-67,118,73
18007,007,18,2018,8677,13,7,20,109,88
18007,007,18,2019,8763,71,0,71,103,89
18007,007,18,2020,8741,-42,1,-41,112,92
18009,009,18,2010,12771,-7,1,-6,33,22
18009,009,18,2011,12655,-121,6,-115,145,146
18009,009,18,2012,12527,-148,9,-139,144,137
18009,009,18,2013,12456,-65,-1,-66,136,143
18009,009,18,2014,12342,-71,3,-68,126,172
18009,009,18,2015,12237,-88,7,-81,150,174
18009,009,18,2016,12109,-102,11,-91,125,161
18009,009,18,2017,12019,-51,5,-46,115,159
18009,009,18,2018,11934,-62,7,-55,136,165
18009,009,18,2019,11787,-133,4,-129,150,169
18009,009,18,2020,11782,25,3,28,139,171
18011,011,18,2010,56924,177,18,195,164,88
18011,011,18,2011,57924,690,46,736,698,436
18011,011,18,2012,59050,831,59,890,702,477
18011,011,18,2013,60373,1056,46,1102,728,528
18011,011,18,2014,61663,977,48,1025,758,505
18011,011,18,2015,63080,1137,37,1174,768,534
18011,011,18,2016,64274,825,103,928,796,530
18011,011,18,2017,65833,1242,68,1310,795,548
18011,011,18,2018,66999,813,109,922,789,544
18011,011,18,2019,67915,553,75,628,782,493
18011,011,18,2020,69347,1128,57,1185,776,524
18013,013,18,2010,15210,-2,1,-1,19,53
18013,013,18,2011,15079,-98,-3,-101,109,138
18013,013,18,2012,15053,9,-3,6,123,154
18013,013,18,2013,15062,31,1,32,129,150
18013,013,18,2014,14953,-78,0,-78,108,140
18013,013,18,2015,15003,90,-1,89,109,147
18013,013,18,2016,15017,68,1,69,124,179
18013,013,18,2017,15025,46,-2,44,112,148
18013,013,18,2018,15244,265,-2,263,124,168
18013,013,18,2019,15066,-129,-1,-130,121,167
18013,013,18,2020,15112,108,-2,106,117,175
18015,015,18,2010,20200,1,2,3,68,30
18015,015,18,2011,20042,-167,-4,-171,204,192
18015,015,18,2012,20112,9,10,19,204,154
18015,015,18,2013,20117,-54,5,-49,234,177
18015,015,18,2014,19958,-222,7,-215,226,175
18015,015,18,2015,19891,-58,3,-55,194,203
18015,015,18,2016,19966,43,13,56,193,174
18015,015,18,2017,20074,63,12,75,224,191
18015,015,18,2018,20208,77,21,98,238,201
18015,015,18,2019,20211,-16,21,5,196,199
18015,015,18,2020,20228,18,16,34,198,214
18017,017,18,2010,38985,-51,24,-27,108,66
18017,017,18,2011,38917,-303,60,-243,514,339
18017,017,18,2012,38771,-357,107,-250,503,403
18017,017,18,2013,38580,-405,95,-310,505,393
18017,017,18,2014,38482,-259,77,-182,475,394
18017,017,18,2015,38079,-517,31,-486,504,425
18017,017,18,2016,37927,-374,111,-263,504,394
18017,017,18,2017,37827,-189,71,-118,460,442
18017,017,18,2018,37885,-84,123,39,430,411
18017,017,18,2019,37610,-358,100,-258,417,434
18017,017,18,2020,37388,-267,82,-185,402,439
18019,019,18,2010,110572,213,29,242,344,244
18019,019,18,2011,111504,432,81,513,1441,1019
18019,019,18,2012,111879,-87,106,19,1465,1083
18019,019,18,2013,112722,478,58,536,1457,1152
18019,019,18,2014,114082,933,48,981,1485,1121
18019,019,18,2015,114887,518,4,522,1472,1183
18019,019,18,2016,115660,524,66,590,1456,1271
18019,019,18,2017,116648,772,43,815,1448,1277
18019,019,18,2018,117287,363,82,445,1483,1289
18019,019,18,2019,118191,677,82,759,1378,1236
18019,019,18,2020,119266,912,65,977,1396,1299
18021,021,18,2010,26863,-23,2,-21,70,80
18021,021,18,2011,26847,-49,1,-48,325,293
18021,021,18,2012,26796,-73,-1,-74,317,292
18021,021,18,2013,26670,-141,0,-141,299,285
18021,021,18,2014,26439,-263,0,-263,317,288
18021,021,18,2015,26406,-10,1,-9,320,341
18021,021,18,2016,26218,-227,1,-226,328,291
18021,021,18,2017,26176,-41,0,-41,325,326
18021,021,18,2018,26215,56,0,56,303,319
18021,021,18,2019,26301,50,0,50,338,302
18021,021,18,2020,26246,-77,1,-76,324,303
18023,023,18,2010,33222,-57,10,-47,113,64
18023,023,18,2011,33034,-303,22,-281,430,339
18023,023,18,2012,32889,-230,32,-198,417,368
18023,023,18,2013,32765,-222,10,-212,467,381
18023,023,18,2014,32461,-386,-5,-391,425,347
18023,023,18,2015,32372,-189,-1,-190,489,387
18023,023,18,2016,32156,-252,-1,-253,425,388
18023,023,18,2017,32155,-92,-6,-98,463,365
18023,023,18,2018,32113,-70,4,-66,429,404
18023,023,18,2019,32298,105,-2,103,415,331
18023,023,18,2020,32206,-172,1,-171,421,343
18025,025,18,2010,10711,14,0,14,30,46
18025,025,18,2011,10622,-77,0,-77,98,110
18025,025,18,2012,10669,27,0,27,121,99
18025,025,18,2013,10621,-20,0,-20,102,130
18025,025,18,2014,10669,33,0,33,126,109
18025,025,18,2015,10556,-140,0,-140,135,109
18025,025,18,2016,10569,30,3,33,95,116
18025,025,18,2017,10532,-26,3,-23,117,130
18025,025,18,2018,10585,67,5,72,124,143
18025,025,18,2019,10593,-8,0,-8,120,105
18025,025,18,2020,10629,46,0,46,118,128
18027,027,18,2010,31721,11,8,19,144,92
18027,027,18,2011,31952,12,28,40,521,328
18027,027,18,2012,32113,-33,15,-18,531,351
18027,027,18,2013,32274,-42,12,-30,521,328
18027,027,18,2014,32671,199,0,199,533,332
18027,027,18,2015,32819,-57,8,-49,546,346
18027,027,18,2016,33000,-40,21,-19,524,322
18027,027,18,2017,33127,-95,16,-79,534,327
18027,027,18,2018,33314,-67,22,-45,580,347
18027,027,18,2019,33439,-109,9,-100,565,342
18027,027,18,2020,33505,-170,10,-160,573,346
18029,029,18,2010,50082,6,4,10,128,75
18029,029,18,2011,49990,-170,-6,-176,549,464
18029,029,18,2012,49742,-324,1,-323,531,459
18029,029,18,2013,49757,-58,-8,-66,512,430
18029,029,18,2014,49448,-383,-9,-392,511,432
18029,029,18,2015,49491,18,-6,12,508,472
18029,029,18,2016,49468,-40,3,-37,502,484
18029,029,18,2017,49634,202,6,208,495,532
18029,029,18,2018,49560,-107,13,-94,537,517
18029,029,18,2019,49573,-29,0,-29,523,480
18029,029,18,2020,49824,209,6,215,532,497
18031,031,18,2010,25795,6,10,16,73,29
18031,031,18,2011,25900,6,40,46,317,257
18031,031,18,2012,26041,77,26,103,289,246
18031,031,18,2013,26232,86,38,124,365,293
18031,031,18,2014,26411,91,9,100,341,258
18031,031,18,2015,26338,-188,14,-174,341,240
18031,031,18,2016,26569,135,24,159,365,292
18031,031,18,2017,26627,-23,13,-10,358,288
18031,031,18,2018,26685,-2,23,21,337,299
18031,031,18,2019,26472,-267,16,-251,315,277
18031,031,18,2020,26584,81,11,92,315,297
18033,033,18,2010,42335,-9,4,-5,156,68
18033,033,18,2011,42500,21,16,37,518,389
18033,033,18,2012,42337,-327,3,-324,520,362
18033,033,18,2013,42378,-49,-3,-52,496,399
18033,033,18,2014,42442,-37,-4,-41,520,406
18033,033,18,2015,42511,-33,-7,-40,563,450
18033,033,18,2016,42671,37,-4,33,535,405
18033,033,18,2017,42830,108,-2,106,507,453
18033,033,18,2018,43231,312,0,312,537,447
18033,033,18,2019,43561,189,-3,186,554,409
18033,033,18,2020,43670,0,-2,-2,541,431
18035,035,18,2010,117671,-91,35,-56,323,259
18035,035,18,2011,117914,1,153,154,1265,1171
18035,035,18,2012,117053,-1053,186,-867,1220,1231
18035,035,18,2013,116867,-369,158,-211,1292,1254
18035,035,18,2014,116528,-549,165,-384,1238,1188
18035,035,18,2015,115814,-779,113,-666,1187,1236
18035,035,18,2016,115696,-232,171,-61,1173,1222
18035,035,18,2017,115268,-359,99,-260,1168,1335
18035,035,18,2018,114118,-1073,164,-909,1114,1362
18035,035,18,2019,113769,-240,103,-137,1060,1275
18035,035,18,2020,113454,-207,86,-121,1064,1266
18037,037,18,2010,41905,-60,14,-46,127,65
18037,037,18,2011,42159,112,38,150,507,400
18037,037,18,2012,42084,-215,43,-172,509,411
18037,037,18,2013,42281,1,44,45,538,379
18037,037,18,2014,42306,-161,59,-102,542,413
18037,037,18,2015,42329,-171,43,-128,572,420
18037,037,18,2016,42463,-126,77,-49,584,398
18037,037,18,2017,42520,-134,48,-86,577,434
18037,037,18,2018,42568,-130,74,-56,510,407
18037,037,18,2019,42578,-163,55,-108,528,409
18037,037,18,2020,42542,-134,41,-93,503,446
18039,039,18,2010,197453,-564,5,-559,736,318
18039,039,18,2011,198292,-676,-19,-695,3053,1516
18039,039,18,2012,198988,-684,73,-611,2982,1661
18039,039,18,2013,200225,-204,94,-110,3019,1651
18039,039,18,2014,201446,-249,88,-161,3041,1622
18039,039,18,2015,203022,86,60,146,3184,1733
18039,039,18,2016,203626,-999,208,-791,3089,1691
18039,039,18,2017,204279,-806,128,-678,3133,1798
18039,039,18,2018,205588,-324,258,-66,3116,1738
18039,039,18,2019,206268,-964,176,-788,3125,1662
18039,039,18,2020,206161,-1539,150,-1389,3098,1817
18041,041,18,2010,24325,17,0,17,62,54
18041,041,18,2011,24152,-84,1,-83,233,322
18041,041,18,2012,23949,-131,3,-128,233,307
18041,041,18,2013,23827,-45,8,-37,264,344
18041,041,18,2014,23443,-338,6,-332,239,298
18041,041,18,2015,23389,9,2,11,249,311
18041,041,18,2016,23246,-69,7,-62,233,313
18041,041,18,2017,23138,-7,4,-3,245,347
18041,041,18,2018,23026,-40,7,-33,278,355
18041,041,18,2019,23038,52,6,58,273,320
18041,041,18,2020,22892,-112,5,-107,271,309
18043,043,18,2010,74706,6,2,8,258,128
18043,043,18,2011,74987,128,-1,127,874,716
18043,043,18,2012,75284,114,27,141,898,730
18043,043,18,2013,76053,623,34,657,845,738
18043,043,18,2014,76138,-119,31,-88,920,741
18043,043,18,2015,76559,323,13,336,860,765
18043,043,18,2016,76801,-6,37,31,942,728
18043,043,18,2017,77043,157,35,192,870,817
18043,043,18,2018,77870,751,63,814,880,867
18043,043,18,2019,78601,592,65,657,855,779
18043,043,18,2020,78936,248,51,299,853,817
18045,045,18,2010,17280,10,-1,9,57,26
18045,045,18,2011,17161,-101,-3,-104,184,199
18045,045,18,2012,17123,-15,1,-14,177,199
18045,045,18,2013,16886,-221,0,-221,193,213
18045,045,18,2014,16697,-205,1,-204,207,197
18045,045,18,2015,16543,-148,3,-145,203,212
18045,045,18,2016,16464,-58,12,-46,173,205
18045,045,18,2017,16442,9,6,15,160,197
18045,045,18,2018,16439,3,11,14,205,220
18045,045,18,2019,16425,-30,7,-23,202,194
18045,045,18,2020,16511,74,5,79,200,193
18047,047,18,2010,23058,-47,3,-44,64,60
18047,047,18,2011,23041,-85,13,-72,249,195
18047,047,18,2012,23036,-37,10,-27,238,216
18047,047,18,2013,22980,-104,13,-91,257,222
18047,047,18,2014,22993,-41,25,-16,240,210
18047,047,18,2015,22953,-73,4,-69,246,217
18047,047,18,2016,22774,-218,2,-216,240,203
18047,047,18,2017,22702,-126,3,-123,250,199
18047,047,18,2018,22752,-46,8,-38,307,219
18047,047,18,2019,22763,-24,3,-21,249,216
18047,047,18,2020,22761,-39,4,-35,264,231
18049,049,18,2010,20818,-14,5,-9,54,82
18049,049,18,2011,20734,-70,2,-68,256,271
18049,049,18,2012,20639,-101,-2,-103,239,230
18049,049,18,2013,20455,-209,0,-209,256,235
18049,049,18,2014,20522,33,-3,30,267,223
18049,049,18,2015,20346,-205,1,-204,265,239
18049,049,18,2016,20150,-222,8,-214,264,246
18049,049,18,2017,20022,-124,7,-117,213,224
18049,049,18,2018,20113,88,11,99,243,250
18049,049,18,2019,20042,-83,8,-75,240,237
18049,049,18,2020,20018,-47,7,-40,241,224
18051,051,18,2010,33545,33,0,33,108,97
18051,051,18,2011,33525,-123,1,-122,427,325
18051,051,18,2012,33533,-70,3,-67,413,332
18051,051,18,2013,33491,-87,4,-83,408,361
18051,051,18,2014,33733,168,3,171,422,347
18051,051,18,2015,33656,-123,24,-99,405,381
18051,051,18,2016,33669,-89,57,-32,419,373
18051,051,18,2017,33730,-2,45,43,403,383
18051,051,18,2018,33622,-196,66,-130,439,415
18051,051,18,2019,33709,10,53,63,390,367
18051,051,18,2020,33825,77,37,114,412,412
18053,053,18,2010,69906,-79,5,-74,171,251
18053,053,18,2011,69633,-254,26,-228,784,827
18053,053,18,2012,69110,-584,30,-554,742,719
18053,053,18,2013,68887,-250,22,-228,812,802
18053,053,18,2014,68381,-470,26,-444,772,833
18053,053,18,2015,67543,-802,22,-780,770,835
18053,053,18,2016,66731,-750,31,-719,722,818
18053,053,18,2017,66373,-253,21,-232,709,833
18053,053,18,2018,66112,-266,35,-231,821,849
18053,053,18,2019,65836,-191,14,-177,769,868
18053,053,18,2020,65225,-517,14,-503,765,873
18055,055,18,2010,33205,57,1,58,75,98
18055,055,18,2011,33034,-192,4,-188,357,341
18055,055,18,2012,32947,-70,9,-61,356,375
18055,055,18,2013,32746,-159,2,-157,336,382
18055,055,18,2014,32654,-14,8,-6,331,408
18055,055,18,2015,32428,-194,3,-191,341,375
18055,055,18,2016,32231,-153,9,-144,319,370
18055,055,18,2017,32194,27,12,39,348,423
18055,055,18,2018,32124,-35,18,-17,337,390
18055,055,18,2019,32117,-11,23,12,388,406
18055,055,18,2020,32203,152,18,170,360,443
18057,057,18,2010,276499,1011,196,1207,1008,348
18057,057,18,2011,283405,3641,673,4314,3840,1267
18057,057,18,2012,289821,3220,723,3943,3813,1391
18057,057,18,2013,296970,4186,641,4827,3697,1432
18057,057,18,2014,302921,2780,639,3419,4015,1485
18057,057,18,2015,308623,2943,529,3472,3830,1600
18057,057,18,2016,316221,4376,842,5218,3932,1561
18057,057,18,2017,323225,4467,522,4989,3806,1799
18057,057,18,2018,330635,4537,892,5429,3842,1858
18057,057,18,2019,337955,4926,588,5514,3738,1918
18057,057,18,2020,344238,4173,475,4648,3760,2124
18059,059,18,2010,70246,103,1,104,203,117
18059,059,18,2011,70373,-28,-7,-35,783,620
18059,059,18,2012,70594,101,0,101,745,608
18059,059,18,2013,71000,258,-3,255,778,615
18059,059,18,2014,71773,607,-9,598,753,582
18059,059,18,2015,72441,500,6,506,785,619
18059,059,18,2016,73790,1220,26,1246,800,699
18059,059,18,2017,75040,1071,25,1096,813,657
18059,059,18,2018,76521,1291,41,1332,818,666
18059,059,18,2019,78159,1494,12,1506,789,654
18059,059,18,2020,79553,1281,16,1297,802,700
18061,061,18,2010,39328,-10,4,-6,95,119
18061,061,18,2011,39187,-189,16,-173,401,369
18061,061,18,2012,39014,-241,15,-226,415,363
18061,061,18,2013,39002,-52,12,-40,414,385
18061,061,18,2014,39175,157,13,170,398,389
18061,061,18,2015,39537,253,20,273,472,380
18061,061,18,2016,39669,59,25,84,452,400
18061,061,18,2017,39797,104,13,117,454,441
18061,061,18,2018,40258,417,22,439,432,409
18061,061,18,2019,40552,235,15,250,411,365
18061,061,18,2020,40682,97,13,110,414,395
18063,063,18,2010,145954,188,89,277,434,209
18063,063,18,2011,148678,1656,272,1928,1777,988
18063,063,18,2012,150761,977,331,1308,1749,965
18063,063,18,2013,153596,2042,181,2223,1641,1056
18063,063,18,2014,155906,1354,203,1557,1811,1046
18063,063,18,2015,157848,1179,159,1338,1725,1110
18063,063,18,2016,160459,1698,234,1932,1805,1122
18063,063,18,2017,163637,2518,159,2677,1716,1216
18063,063,18,2018,166759,2432,272,2704,1694,1274
18063,063,18,2019,169924,2563,174,2737,1625,1188
18063,063,18,2020,173251,2802,151,2953,1647,1262
18065,065,18,2010,49530,36,1,37,129,100
18065,065,18,2011,49221,-198,0,-198,439,550
18065,065,18,2012,49118,17,6,23,469,589
18065,065,18,2013,48847,-178,3,-175,484,578
18065,065,18,2014,48887,122,6,128,503,579
18065,065,18,2015,48662,-116,5,-111,465,576
18065,065,18,2016,48349,-202,6,-196,472,588
18065,065,18,2017,48178,12,3,15,468,650
18065,065,18,2018,48205,123,4,127,481,580
18065,065,18,2019,48025,-63,3,-60,481,600
18065,065,18,2020,48033,102,2,104,480,577
18067,067,18,2010,82753,-68,24,-44,226,173
18067,067,18,2011,82805,-165,88,-77,998,865
18067,067,18,2012,82853,-92,61,-31,986,894
18067,067,18,2013,82761,-178,28,-150,1054,987
18067,067,18,2014,82633,-166,40,-126,949,942
18067,067,18,2015,82378,-179,19,-160,988,1075
18067,067,18,2016,82395,-34,56,22,1013,1014
18067,067,18,2017,82302,-24,48,24,953,1065
18067,067,18,2018,82339,18,79,97,1024,1080
18067,067,18,2019,82660,285,57,342,979,998
18067,067,18,2020,82732,43,46,89,995,1016
18069,069,18,2010,37115,-29,3,-26,120,102
18069,069,18,2011,37169,34,13,47,390,381
18069,069,18,2012,36983,-211,10,-201,429,416
18069,069,18,2013,36786,-208,13,-195,415,418
18069,069,18,2014,36624,-176,19,-157,424,425
18069,069,18,2015,36535,-151,7,-144,444,387
18069,069,18,2016,36313,-200,27,-173,414,463
18069,069,18,2017,36253,-80,13,-67,433,426
18069,069,18,2018,36249,-50,23,-27,412,388
18069,069,18,2019,36544,228,16,244,431,379
18069,069,18,2020,36395,-159,10,-149,419,420
18071,071,18,2010,42584,140,17,157,127,86
18071,071,18,2011,42922,147,61,208,580,448
18071,071,18,2012,42996,-88,96,8,522,447
18071,071,18,2013,43450,218,70,288,600,430
18071,071,18,2014,43719,87,84,171,598,491
18071,071,18,2015,43892,-27,81,54,618,495
18071,071,18,2016,43991,-179,121,-58,594,437
18071,071,18,2017,43942,-264,88,-176,623,496
18071,071,18,2018,44049,-155,139,-16,623,499
18071,071,18,2019,44179,-69,76,7,581,459
18071,071,18,2020,44222,-149,68,-81,606,484
18073,073,18,2010,33497,18,0,18,112,111
18073,073,18,2011,33429,-171,3,-168,373,274
18073,073,18,2012,33498,-37,11,-26,402,303
18073,073,18,2013,33432,-132,5,-127,405,346
18073,073,18,2014,33523,25,22,47,344,293
18073,073,18,2015,33498,-66,1,-65,401,361
18073,073,18,2016,33414,-152,6,-146,377,313
18073,073,18,2017,33439,-10,0,-10,384,347
18073,073,18,2018,33356,-137,2,-135,357,307
18073,073,18,2019,33516,145,1,146,368,353
18073,073,18,2020,33440,-72,1,-71,359,365
18075,075,18,2010,21179,-73,-1,-74,65,68
18075,075,18,2011,21336,29,2,31,326,201
18075,075,18,2012,21346,-51,2,-49,286,223
18075,075,18,2013,21267,-136,4,-132,291,237
18075,075,18,2014,21135,-196,1,-195,311,250
18075,075,18,2015,21135,-85,-1,-86,331,246
18075,075,18,2016,21021,-187,-4,-191,303,226
18075,075,18,2017,20879,-174,-8,-182,288,249
18075,075,18,2018,20721,-192,-10,-202,304,260
18075,075,18,2019,20446,-347,-11,-358,286,203
18075,075,18,2020,20416,-70,-6,-76,288,243
18077,077,18,2010,32399,8,0,8,92,100
18077,077,18,2011,32273,-95,6,-89,330,366
18077,077,18,2012,32442,129,15,144,372,340
18077,077,18,2013,32399,-15,8,-7,353,384
18077,077,18,2014,32412,39,17,56,355,394
18077,077,18,2015,32305,-110,9,-101,368,372
18077,077,18,2016,32259,-88,22,-66,395,375
18077,077,18,2017,32031,-228,17,-211,376,392
18077,077,18,2018,32169,114,28,142,380,384
18077,077,18,2019,32265,97,19,116,360,379
18077,077,18,2020,32110,-163,17,-146,367,378
18079,079,18,2010,28482,-63,2,-61,94,83
18079,079,18,2011,28154,-382,3,-379,343,294
18079,079,18,2012,28150,-90,5,-85,321,239
18079,079,18,2013,28238,17,-1,16,363,287
18079,079,18,2014,27930,-362,-1,-363,337,285
18079,079,18,2015,27847,-129,-1,-130,347,297
18079,079,18,2016,27682,-214,9,-205,324,284
18079,079,18,2017,27686,10,3,13,313,321
18079,079,18,2018,27650,-60,6,-54,338,321
18079,079,18,2019,27662,-4,7,3,313,302
18079,079,18,2020,27515,-127,7,-120,313,342
18081,081,18,2010,140269,160,59,219,443,244
18081,081,18,2011,141747,624,208,832,1842,1192
18081,081,18,2012,143502,970,217,1187,1827,1254
18081,081,18,2013,145448,1171,167,1338,1802,1195
18081,081,18,2014,147129,762,232,994,1889,1183
18081,081,18,2015,149021,1187,224,1411,1800,1317
18081,081,18,2016,151621,1726,318,2044,1906,1350
18081,081,18,2017,153879,1492,224,1716,1862,1318
18081,081,18,2018,156301,1623,334,1957,1843,1374
18081,081,18,2019,158332,1328,207,1535,1864,1365
18081,081,18,2020,160607,1648,180,1828,1857,1409
18083,083,18,2010,38394,-38,8,-30,108,121
18083,083,18,2011,38479,57,23,80,490,483
18083,083,18,2012,37986,-537,18,-519,449,439
18083,083,18,2013,38070,12,7,19,490,417
18083,083,18,2014,37979,-139,8,-131,499,453
18083,083,18,2015,37784,-167,9,-158,439,474
18083,083,18,2016,37367,-433,17,-416,453,456
18083,083,18,2017,37070,-300,12,-288,411,422
18083,083,18,2018,36602,-469,20,-449,427,448
18083,083,18,2019,36603,-14,13,-1,396,396
18083,083,18,2020,36522,-70,12,-58,398,422
18085,085,18,2010,77338,-125,14,-111,252,157
18085,085,18,2011,77349,-364,30,-334,996,650
18085,085,18,2012,77605,-93,48,-45,961,650
18085,085,18,2013,77873,-35,35,0,1043,760
18085,085,18,2014,78384,115,40,155,1060,691
18085,085,18,2015,78562,-260,39,-221,1111,705
18085,085,18,2016,78764,-200,132,-68,987,715
18085,085,18,2017,79121,-100,81,-19,1043,661
18085,085,18,2018,79467,-75,141,66,1040,756
18085,085,18,2019,79438,-397,103,-294,995,731
18085,085,18,2020,78988,-736,83,-653,991,786
18087,087,18,2010,37159,-88,3,-85,196,86
18087,087,18,2011,37470,-205,14,-191,755,253
18087,087,18,2012,37663,-305,25,-280,731,263
18087,087,18,2013,38089,-76,8,-68,745,247
18087,087,18,2014,38436,-134,-1,-135,751,265
18087,087,18,2015,38620,-278,-1,-279,728,265
18087,087,18,2016,39122,-9,-2,-11,751,236
18087,087,18,2017,39247,-339,-5,-344,752,284
18087,087,18,2018,39425,-273,-1,-274,747,296
18087,087,18,2019,39771,-159,-3,-162,783,275
18087,087,18,2020,40119,-152,-1,-153,781,283
18089,089,18,2010,495972,-575,29,-546,1594,1174
18089,089,18,2011,495035,-2693,100,-2593,6185,4528
18089,089,18,2012,493511,-3394,225,-3169,6133,4514
18089,089,18,2013,491909,-3025,121,-2904,6054,4755
18089,089,18,2014,491259,-2233,168,-2065,6076,4639
18089,089,18,2015,488195,-4249,84,-4165,5986,4899
18089,089,18,2016,486381,-3033,199,-2834,5814,4792
18089,089,18,2017,484834,-2121,19,-2102,5534,4977
18089,089,18,2018,484918,-741,262,-479,5712,5143
18089,089,18,2019,486244,491,81,572,5795,5040
18089,089,18,2020,487536,850,87,937,5722,5384
18091,091,18,2010,111458,-120,5,-115,333,226
18091,091,18,2011,111328,-319,3,-316,1326,1136
18091,091,18,2012,111321,-166,26,-140,1301,1155
18091,091,18,2013,111452,-23,9,-14,1322,1157
18091,091,18,2014,111774,120,18,138,1343,1131
18091,091,18,2015,110884,-951,0,-951,1319,1263
18091,091,18,2016,110331,-766,54,-712,1348,1188
18091,091,18,2017,109958,-364,36,-328,1269,1312
18091,091,18,2018,110134,-17,83,66,1325,1212
18091,091,18,2019,110044,-124,24,-100,1217,1208
18091,091,18,2020,109663,-362,37,-325,1249,1310
18093,093,18,2010,46105,4,6,10,114,147
18093,093,18,2011,46144,29,34,63,479,500
18093,093,18,2012,46121,40,26,66,474,553
18093,093,18,2013,45900,-179,16,-163,495,548
18093,093,18,2014,45653,-132,9,-123,451,568
18093,093,18,2015,45571,-27,2,-25,510,563
18093,093,18,2016,45560,35,1,36,477,522
18093,093,18,2017,45595,123,-1,122,508,590
18093,093,18,2018,45690,134,0,134,503,540
18093,093,18,2019,45419,-211,-6,-217,526,580
18093,093,18,2020,45496,168,-1,167,514,603
18095,095,18,2010,131621,-35,21,-14,374,361
18095,095,18,2011,131013,-805,71,-734,1631,1503
18095,095,18,2012,130216,-944,96,-848,1495,1454
18095,095,18,2013,130331,138,33,171,1500,1535
18095,095,18,2014,129773,-577,51,-526,1442,1460
18095,095,18,2015,129436,-374,38,-336,1514,1504
18095,095,18,2016,129360,-136,70,-66,1481,1484
18095,095,18,2017,129465,146,34,180,1469,1534
18095,095,18,2018,129509,92,62,154,1423,1529
18095,095,18,2019,129416,-10,49,39,1385,1519
18095,095,18,2020,129681,396,40,436,1377,1554
18097,097,18,2010,904604,-1149,693,-456,3572,1859
18097,097,18,2011,911294,-3060,2650,-410,14531,7415
18097,097,18,2012,919917,-1180,3118,1938,14414,7579
18097,097,18,2013,930127,808,2609,3417,14611,7750
18097,097,18,2014,936178,-3373,2859,-514,14423,7672
18097,097,18,2015,940152,-5237,2607,-2630,14593,7935
18097,097,18,2016,946050,-4742,4463,-279,14229,8021
18097,097,18,2017,951247,-3842,3275,-567,14208,8405
18097,097,18,2018,959370,-2959,5189,2230,14297,8365
18097,097,18,2019,963829,-5126,3899,-1227,14004,8326
18097,097,18,2020,966183,-5880,3045,-2835,13959,8808
18099,099,18,2010,47000,-105,13,-92,150,111
18099,099,18,2011,46944,-204,29,-175,544,425
18099,099,18,2012,46950,-244,29,-215,653,432
18099,099,18,2013,46921,-146,20,-126,569,469
18099,099,18,2014,46935,-78,22,-56,546,469
18099,099,18,2015,46746,-348,32,-316,581,456
18099,099,18,2016,46629,-311,40,-271,638,485
18099,099,18,2017,46434,-315,29,-286,566,477
18099,099,18,2018,46311,-301,52,-249,570,446
18099,099,18,2019,46197,-176,19,-157,526,483
18099,099,18,2020,46108,-130,22,-108,525,507
18101,101,18,2010,10361,0,0,0,24,42
18101,101,18,2011,10339,-37,3,-34,112,100
18101,101,18,2012,10322,-67,6,-61,140,95
18101,101,18,2013,10238,-101,0,-101,137,121
18101,101,18,2014,10245,-46,0,-46,149,97
18101,101,18,2015,10222,-37,-1,-38,122,107
18101,101,18,2016,10195,-47,-1,-48,122,101
18101,101,18,2017,10188,-15,-1,-16,114,104
18101,101,18,2018,10204,7,-1,6,115,105
18101,101,18,2019,10179,0,-1,-1,105,129
18101,101,18,2020,10079,-85,-1,-86,103,115
18103,103,18,2010,36810,-112,0,-112,84,71
18103,103,18,2011,36658,-217,-2,-219,403,336
18103,103,18,2012,36547,-109,6,-103,359,364
18103,103,18,2013,36191,-363,15,-348,354,370
18103,103,18,2014,36088,-181,15,-166,402,338
18103,103,18,2015,36023,-58,14,-44,364,385
18103,103,18,2016,36047,47,22,69,342,385
18103,103,18,2017,35903,-186,36,-150,403,397
18103,103,18,2018,35652,-264,62,-202,350,399
18103,103,18,2019,35488,-173,7,-166,363,363
18103,103,18,2020,35328,-140,16,-124,352,389
18105,105,18,2010,138574,229,224,453,376,227
18105,105,18,2011,140280,358,970,1328,1243,869
18105,105,18,2012,141570,-190,1050,860,1309,855
18105,105,18,2013,142185,-588,833,245,1286,906
18105,105,18,2014,143554,-54,974,920,1291,817
18105,105,18,2015,144432,-368,834,466,1347,926
18105,105,18,2016,145936,22,1183,1205,1292,992
18105,105,18,2017,146840,-152,762,610,1265,966
18105,105,18,2018,147411,-931,1201,270,1302,1008
18105,105,18,2019,148178,-346,832,486,1233,960
18105,105,18,2020,148219,-829,656,-173,1234,1029
18107,107,18,2010,38096,-71,0,-71,104,58
18107,107,18,2011,38340,136,-3,133,476,364
18107,107,18,2012,38180,-177,2,-175,439,420
18107,107,18,2013,38143,-165,25,-140,496,391
18107,107,18,2014,38158,-59,28,-31,433,385
18107,107,18,2015,38255,32,10,42,458,397
18107,107,18,2016,38240,-112,35,-77,452,389
18107,107,18,2017,38343,62,9,71,463,428
18107,107,18,2018,38251,-109,23,-86,440,446
18107,107,18,2019,38275,-33,20,-13,443,406
18107,107,18,2020,38365,57,21,78,431,420
18109,109,18,2010,69138,116,8,124,205,115
18109,109,18,2011,69237,-90,19,-71,806,633
18109,109,18,2012,69184,-189,25,-164,750,633
18109,109,18,2013,69352,90,19,109,751,679
18109,109,18,2014,69509,67,29,96,716,641
18109,109,18,2015,69576,-67,34,-33,768,660
18109,109,18,2016,69653,-86,56,-30,786,676
18109,109,18,2017,69835,41,42,83,816,712
18109,109,18,2018,70108,161,65,226,779,727
18109,109,18,2019,70403,220,52,272,769,745
18109,109,18,2020,70707,244,39,283,747,728
18111,111,18,2010,14234,5,2,7,28,39
18111,111,18,2011,14086,-118,9,-109,138,177
18111,111,18,2012,14046,-55,9,-46,157,149
18111,111,18,2013,14032,-3,24,21,136,171
18111,111,18,2014,14093,49,11,60,141,138
18111,111,18,2015,13978,-80,7,-73,131,172
18111,111,18,2016,14009,-5,19,14,169,152
18111,111,18,2017,14036,30,17,47,142,161
18111,111,18,2018,13979,-70,26,-44,149,162
18111,111,18,2019,13972,-23,33,10,147,162
18111,111,18,2020,13907,-84,24,-60,152,158
18113,113,18,2010,47455,-112,2,-110,153,129
18113,113,18,2011,47297,-256,-22,-278,568,448
18113,113,18,2012,47192,-237,-7,-244,578,442
18113,113,18,2013,47246,-80,-4,-84,582,439
18113,113,18,2014,47372,-57,-13,-70,623,420
18113,113,18,2015,47514,-43,0,-43,652,461
18113,113,18,2016,47432,-317,37,-280,629,432
18113,113,18,2017,47379,-187,20,-167,573,459
18113,113,18,2018,47649,12,39,51,658,437
18113,113,18,2019,47907,58,42,100,626,468
18113,113,18,2020,47832,-242,34,-208,628,495
18115,115,18,2010,6085,-18,0,-18,13,7
18115,115,18,2011,6055,-19,0,-19,53,63
18115,115,18,2012,6061,4,0,4,53,51
18115,115,18,2013,5992,-70,0,-70,59,56
18115,115,18,2014,5965,-23,2,-21,59,65
18115,115,18,2015,5888,-56,2,-54,41,65
18115,115,18,2016,5905,18,7,25,58,67
18115,115,18,2017,5867,-35,6,-29,56,65
18115,115,18,2018,5880,30,10,40,61,87
18115,115,18,2019,5908,20,1,21,61,54
18115,115,18,2020,5892,8,3,11,56,82
18117,117,18,2010,19812,-52,0,-52,45,27
18117,117,18,2011,19942,119,3,122,233,226
18117,117,18,2012,19743,-206,4,-202,208,210
18117,117,18,2013,19830,69,8,77,236,223
18117,117,18,2014,19767,-96,9,-87,242,217
18117,117,18,2015,19628,-133,9,-124,221,236
18117,117,18,2016,19470,-173,12,-161,243,240
18117,117,18,2017,19413,-67,8,-59,253,251
18117,117,18,2018,19567,105,14,119,248,211
18117,117,18,2019,19657,45,12,57,262,229
18117,117,18,2020,19651,-25,6,-19,264,251
18119,119,18,2010,21566,11,0,11,64,79
18119,119,18,2011,21489,-100,-2,-102,222,198
18119,119,18,2012,21368,-143,3,-140,225,205
18119,119,18,2013,21152,-182,1,-181,208,246
18119,119,18,2014,21016,-154,4,-150,233,221
18119,119,18,2015,20823,-181,6,-175,225,245
18119,119,18,2016,20898,88,6,94,224,243
18119,119,18,2017,20779,-80,2,-78,205,243
18119,119,18,2018,20879,91,6,97,239,235
18119,119,18,2019,20881,8,4,12,224,234
18119,119,18,2020,20833,-7,2,-5,237,281
18121,121,18,2010,17279,-66,1,-65,44,54
18121,121,18,2011,17082,-230,3,-227,186,159
18121,121,18,2012,17118,8,1,9,182,154
18121,121,18,2013,17235,87,2,89,200,171
18121,121,18,2014,17239,-40,2,-38,197,153
18121,121,18,2015,16974,-329,2,-327,214,155
18121,121,18,2016,16938,-93,0,-93,219,162
18121,121,18,2017,16902,-60,0,-60,198,174
18121,121,18,2018,16955,4,0,4,196,146
18121,121,18,2019,16893,-93,0,-93,198,167
18121,121,18,2020,16871,-17,0,-17,187,193
18123,123,18,2010,19411,67,0,67,51,52
18123,123,18,2011,19429,10,0,10,217,208
18123,123,18,2012,19376,-47,-3,-50,196,195
18123,123,18,2013,19424,53,0,53,209,210
18123,123,18,2014,19343,-20,1,-19,167,225
18123,123,18,2015,19323,-37,1,-36,217,200
18123,123,18,2016,19008,-345,11,-334,227,210
18123,123,18,2017,19010,5,8,13,218,228
18123,123,18,2018,19100,94,10,104,202,216
18123,123,18,2019,19184,70,7,77,206,200
18123,123,18,2020,19154,-40,7,-33,206,204
18125,125,18,2010,12716,0,0,0,40,17
18125,125,18,2011,12593,-121,2,-119,141,145
18125,125,18,2012,12614,20,3,23,139,139
18125,125,18,2013,12490,-136,2,-134,137,129
18125,125,18,2014,12485,-36,4,-32,152,125
18125,125,18,2015,12399,-63,9,-54,131,162
18125,125,18,2016,12371,4,5,9,134,169
18125,125,18,2017,12302,-54,3,-51,131,148
18125,125,18,2018,12384,79,4,83,151,152
18125,125,18,2019,12383,-15,2,-13,151,139
18125,125,18,2020,12378,-2,3,1,152,160
18127,127,18,2010,164492,59,35,94,445,317
18127,127,18,2011,165535,497,118,615,1710,1277
18127,127,18,2012,165742,-398,143,-255,1847,1367
18127,127,18,2013,166538,394,91,485,1719,1382
18127,127,18,2014,167242,169,113,282,1821,1364
18127,127,18,2015,167439,-100,73,-27,1764,1529
18127,127,18,2016,167616,-298,86,-212,1782,1388
18127,127,18,2017,168568,768,23,791,1665,1493
18127,127,18,2018,169647,958,73,1031,1674,1617
18127,127,18,2019,170599,924,32,956,1655,1655
18127,127,18,2020,170980,488,31,519,1656,1798
18129,129,18,2010,25861,-28,-1,-29,63,85
18129,129,18,2011,25695,-211,2,-209,277,235
18129,129,18,2012,25618,-169,5,-164,292,210
18129,129,18,2013,25565,-101,4,-97,275,233
18129,129,18,2014,25608,-14,7,-7,284,230
18129,129,18,2015,25621,-5,4,-1,274,260
18129,129,18,2016,25626,-9,-2,-11,260,242
18129,129,18,2017,25563,-81,-1,-82,263,245
18129,129,18,2018,25529,-64,0,-64,278,247
18129,129,18,2019,25408,-142,-1,-143,271,249
18129,129,18,2020,25275,-119,-1,-120,276,290
18131,131,18,2010,13320,-58,1,-57,42,48
18131,131,18,2011,13226,-78,1,-77,145,162
18131,131,18,2012,13006,-195,1,-194,113,144
18131,131,18,2013,12935,-54,4,-50,150,170
18131,131,18,2014,12911,-30,4,-26,138,134
18131,131,18,2015,12801,-111,11,-100,134,144
18131,131,18,2016,12613,-183,20,-163,125,150
18131,131,18,2017,12529,-74,7,-67,142,160
18131,131,18,2018,12502,-9,14,5,126,158
18131,131,18,2019,12379,-127,13,-114,126,135
18131,131,18,2020,12388,24,10,34,119,145
18133,133,18,2010,37903,-52,9,-43,71,65
18133,133,18,2011,37868,-100,39,-61,361,333
18133,133,18,2012,37654,-285,52,-233,335,329
18133,133,18,2013,37508,-183,29,-154,377,368
18133,133,18,2014,37464,-61,34,-27,359,369
18133,133,18,2015,37397,-107,28,-79,352,339
18133,133,18,2016,37151,-319,60,-259,378,366
18133,133,18,2017,37409,245,30,275,366,379
18133,133,18,2018,37494,19,58,77,371,361
18133,133,18,2019,37566,7,38,45,380,353
18133,133,18,2020,37469,-121,25,-96,376,378
18135,135,18,2010,26172,-44,0,-44,88,42
18135,135,18,2011,26030,-154,-2,-156,290,278
18135,135,18,2012,25857,-180,-1,-181,325,320
18135,135,18,2013,25618,-249,2,-247,300,294
18135,135,18,2014,25333,-277,7,-270,301,323
18135,135,18,2015,25139,-228,7,-221,305,278
18135,135,18,2016,25091,-66,11,-55,275,267
18135,135,18,2017,24917,-160,10,-150,310,333
18135,135,18,2018,24736,-133,18,-115,265,331
18135,135,18,2019,24533,-198,16,-182,279,300
18135,135,18,2020,24191,-324,15,-309,265,294
18137,137,18,2010,28815,-20,4,-16,101,82
18137,137,18,2011,28646,-217,24,-193,337,314
18137,137,18,2012,28449,-274,27,-247,338,291
18137,137,18,2013,28297,-171,15,-156,329,327
18137,137,18,2014,28343,2,26,28,325,302
18137,137,18,2015,28375,15,8,23,312,299
18137,137,18,2016,28412,-45,15,-30,357,290
18137,137,18,2017,28432,14,0,14,343,334
18137,137,18,2018,28526,48,-1,47,386,338
18137,137,18,2019,28465,-140,-2,-142,372,290
18137,137,18,2020,28448,-83,0,-83,394,327
18139,139,18,2010,17383,-21,0,-21,46,32
18139,139,18,2011,17284,-65,-2,-67,169,202
18139,139,18,2012,17106,-181,-2,-183,176,174
18139,139,18,2013,16998,-78,1,-77,186,218
18139,139,18,2014,16846,-155,3,-152,177,178
18139,139,18,2015,16709,-129,0,-129,198,208
18139,139,18,2016,16628,-79,4,-75,184,189
18139,139,18,2017,16642,16,3,19,205,208
18139,139,18,2018,16635,7,7,14,178,198
18139,139,18,2019,16605,-45,7,-38,192,183
18139,139,18,2020,16649,48,6,54,186,197
18141,141,18,2010,266799,-509,118,-391,872,604
18141,141,18,2011,266726,-1464,388,-1076,3543,2543
18141,141,18,2012,266576,-1637,495,-1142,3509,2523
18141,141,18,2013,267188,-950,516,-434,3589,2524
18141,141,18,2014,268023,-520,582,62,3448,2632
18141,141,18,2015,268567,-695,428,-267,3503,2667
18141,141,18,2016,270042,-137,696,559,3521,2592
18141,141,18,2017,270219,-1070,466,-604,3546,2761
18141,141,18,2018,270961,-657,771,114,3452,2823
18141,141,18,2019,271695,-844,538,-306,3594,2562
18141,141,18,2020,271484,-1517,434,-1083,3508,2640
18143,143,18,2010,24172,5,0,5,64,90
18143,143,18,2011,23909,-253,-2,-255,289,297
18143,143,18,2012,23724,-171,3,-168,281,301
18143,143,18,2013,23761,44,10,54,285,298
18143,143,18,2014,23645,-132,21,-111,280,288
18143,143,18,2015,23670,52,15,67,272,311
18143,143,18,2016,23700,10,23,33,291,294
18143,143,18,2017,23810,150,13,163,298,349
18143,143,18,2018,23773,19,22,41,271,348
18143,143,18,2019,23855,98,14,112,260,291
18143,143,18,2020,23788,-11,11,0,264,331
18145,145,18,2010,44295,-88,8,-80,130,136
18145,145,18,2011,44277,-120,35,-85,539,471
18145,145,18,2012,44258,-122,11,-111,517,420
18145,145,18,2013,44336,47,1,48,471,434
18145,145,18,2014,44359,-78,19,-59,517,428
18145,145,18,2015,44343,-106,12,-94,511,429
18145,145,18,2016,44241,-198,36,-162,499,438
18145,145,18,2017,44378,115,24,139,509,508
18145,145,18,2018,44535,139,41,180,465,486
18145,145,18,2019,44771,155,45,200,499,463
18145,145,18,2020,44871,51,37,88,488,477
18147,147,18,2010,20916,-31,0,-31,50,56
18147,147,18,2011,20971,6,0,6,236,187
18147,147,18,2012,20784,-239,-1,-240,233,184
18147,147,18,2013,20765,-20,2,-18,207,207
18147,147,18,2014,20764,-71,0,-71,218,148
18147,147,18,2015,20644,-176,-1,-177,246,190
18147,147,18,2016,20496,-120,-2,-122,195,219
18147,147,18,2017,20441,-47,-1,-48,202,209
18147,147,18,2018,20385,-50,-1,-51,201,205
18147,147,18,2019,20273,-84,-2,-86,182,208
18147,147,18,2020,20225,21,-1,20,182,250
18149,149,18,2010,23348,4,0,4,65,81
18149,149,18,2011,23174,-178,-2,-180,272,265
18149,149,18,2012,23165,4,2,6,265,274
18149,149,18,2013,23146,-22,-1,-23,253,247
18149,149,18,2014,22960,-134,-2,-136,250,300
18149,149,18,2015,22864,-80,-1,-81,284,296
18149,149,18,2016,23023,150,2,152,267,260
18149,149,18,2017,22946,-71,1,-70,252,257
18149,149,18,2018,22953,12,2,14,274,280
18149,149,18,2019,23011,68,1,69,267,278
18149,149,18,2020,23049,81,1,82,270,315
18151,151,18,2010,34110,-58,1,-57,84,64
18151,151,18,2011,34074,-111,0,-111,368,292
18151,151,18,2012,34168,13,15,28,356,283
18151,151,18,2013,34383,131,23,154,378,313
18151,151,18,2014,34506,43,15,58,383,309
18151,151,18,2015,34489,-76,1,-75,391,328
18151,151,18,2016,34372,-233,20,-213,429,332
18151,151,18,2017,34422,-10,15,5,384,337
18151,151,18,2018,34570,81,27,108,349,306
18151,151,18,2019,34759,122,32,154,378,343
18151,151,18,2020,34831,47,23,70,381,379
18153,153,18,2010,21387,-47,-1,-48,52,94
18153,153,18,2011,21216,-159,-1,-160,227,238
18153,153,18,2012,21202,-30,2,-28,245,231
18153,153,18,2013,21138,-78,1,-77,239,221
18153,153,18,2014,20994,-147,-2,-149,244,240
18153,153,18,2015,20874,-83,-1,-84,230,265
18153,153,18,2016,20695,-127,-5,-132,191,238
18153,153,18,2017,20690,18,-6,12,214,229
18153,153,18,2018,20673,-14,-6,-20,223,220
18153,153,18,2019,20601,-39,-6,-45,211,239
18153,153,18,2020,20578,-7,-2,-9,211,226
18155,155,18,2010,10718,9,2,11,34,14
18155,155,18,2011,10633,-104,2,-102,126,109
18155,155,18,2012,10462,-190,1,-189,124,112
18155,155,18,2013,10598,99,13,112,112,88
18155,155,18,2014,10565,-72,12,-60,135,110
18155,155,18,2015,10616,33,7,40,132,120
18155,155,18,2016,10650,-17,15,-2,131,95
18155,155,18,2017,10689,21,11,32,114,106
18155,155,18,2018,10757,74,13,87,118,137
18155,155,18,2019,10815,13,11,24,118,84
18155,155,18,2020,10724,-90,9,-81,113,124
18157,157,18,2010,173105,-347,320,-27,555,233
18157,157,18,2011,175892,244,1497,1741,2131,1084
18157,157,18,2012,179181,459,1728,2187,2279,1150
18157,157,18,2013,182043,165,1540,1705,2299,1112
18157,157,18,2014,184542,-279,1715,1436,2209,1117
18157,157,18,2015,186858,-244,1382,1138,2384,1192
18157,157,18,2016,190475,434,1975,2409,2381,1172
18157,157,18,2017,191334,-1431,1274,-157,2258,1256
18157,157,18,2018,193705,-551,1973,1422,2263,1318
18157,157,18,2019,194881,-1184,1449,265,2136,1236
18157,157,18,2020,196115,-769,1150,381,2142,1304
18159,159,18,2010,15878,-44,0,-44,39,54
18159,159,18,2011,15817,-50,-1,-51,153,164
18159,159,18,2012,15660,-131,-1,-132,148,179
18159,159,18,2013,15544,-65,0,-65,131,180
18159,159,18,2014,15406,-153,10,-143,171,168
18159,159,18,2015,15250,-130,3,-127,150,182
18159,159,18,2016,15161,-70,9,-61,147,174
18159,159,18,2017,15148,-11,12,1,153,167
18159,159,18,2018,15100,-35,22,-13,150,184
18159,159,18,2019,15133,44,17,61,139,167
18159,159,18,2020,15227,106,11,117,145,168
18161,161,18,2010,7537,11,0,11,19,8
18161,161,18,2011,7497,-48,0,-48,80,73
18161,161,18,2012,7355,-160,0,-160,73,59
18161,161,18,2013,7311,-32,0,-32,64,77
18161,161,18,2014,7252,-57,-2,-59,76,76
18161,161,18,2015,7201,-56,-4,-60,80,72
18161,161,18,2016,7162,-32,0,-32,65,72
18161,161,18,2017,7199,38,5,43,77,82
18161,161,18,2018,7086,-109,8,-101,64,75
18161,161,18,2019,7135,44,6,50,70,70
18161,161,18,2020,7119,-23,7,-16,70,70
18163,163,18,2010,179845,-16,32,16,628,476
18163,163,18,2011,180488,80,142,222,2245,1818
18163,163,18,2012,181075,-71,218,147,2319,1853
18163,163,18,2013,181633,80,156,236,2313,1963
18163,163,18,2014,182010,-15,135,120,2234,1940
18163,163,18,2015,181600,-751,109,-642,2242,1994
18163,163,18,2016,181536,-560,176,-384,2268,1938
18163,163,18,2017,181031,-745,110,-635,2157,2017
18163,163,18,2018,181165,-191,207,16,2142,2018
18163,163,18,2019,181561,73,157,230,2100,1937
18163,163,18,2020,182447,727,116,843,2069,2032
18165,165,18,2010,16117,-63,0,-63,35,67
18165,165,18,2011,16072,10,1,11,181,237
18165,165,18,2012,15924,-88,2,-86,152,217
18165,165,18,2013,15853,-64,11,-53,164,182
18165,165,18,2014,15661,-156,10,-146,157,204
18165,165,18,2015,15597,-8,9,1,164,228
18165,165,18,2016,15588,50,16,66,154,228
18165,165,18,2017,15507,-82,14,-68,169,181
18165,165,18,2018,15508,31,18,49,163,210
18165,165,18,2019,15493,1,14,15,179,209
18165,165,18,2020,15329,-129,9,-120,172,215
18167,167,18,2010,107891,-9,52,43,332,319
18167,167,18,2011,108350,92,186,278,1323,1137
18167,167,18,2012,108561,-156,208,52,1264,1084
18167,167,18,2013,108251,-514,137,-377,1269,1200
18167,167,18,2014,107989,-632,150,-482,1340,1114
18167,167,18,2015,107615,-650,136,-514,1290,1148
18167,167,18,2016,107871,-57,183,126,1292,1163
18167,167,18,2017,107648,-393,121,-272,1240,1190
18167,167,18,2018,107438,-441,196,-245,1202,1166
18167,167,18,2019,106958,-543,133,-410,1107,1180
18167,167,18,2020,106608,-323,108,-215,1115,1254
18169,169,18,2010,32850,-36,2,-34,83,87
18169,169,18,2011,32574,-240,4,-236,369,410
18169,169,18,2012,32396,-134,22,-112,353,416
18169,169,18,2013,32281,-18,11,-7,342,448
18169,169,18,2014,32117,-89,1,-88,334,410
18169,169,18,2015,31883,-148,7,-141,325,418
18169,169,18,2016,31569,-278,7,-271,382,424
18169,169,18,2017,31401,-33,11,-22,312,458
18169,169,18,2018,31210,-61,13,-48,318,460
18169,169,18,2019,31028,-100,11,-89,308,401
18169,169,18,2020,30784,-128,7,-121,303,427
18171,171,18,2010,8521,-9,0,-9,24,4
18171,171,18,2011,8472,-80,4,-76,98,71
18171,171,18,2012,8393,-125,2,-123,114,72
18171,171,18,2013,8370,-29,4,-25,75,72
18171,171,18,2014,8340,-44,2,-42,87,77
18171,171,18,2015,8272,-64,0,-64,86,90
18171,171,18,2016,8166,-98,2,-96,79,89
18171,171,18,2017,8203,37,2,39,90,92
18171,171,18,2018,8268,61,2,63,77,74
18171,171,18,2019,8262,-8,3,-5,73,74
18171,171,18,2020,8194,-50,2,-48,75,95
18173,173,18,2010,59840,98,17,115,166,130
18173,173,18,2011,60213,143,65,208,664,498
18173,173,18,2012,60365,-94,77,-17,637,465
18173,173,18,2013,60877,378,70,448,645,574
18173,173,18,2014,60986,-88,66,-22,615,480
18173,173,18,2015,61563,398,48,446,688,551
18173,173,18,2016,62046,332,46,378,667,558
18173,173,18,2017,62433,343,24,367,630,602
18173,173,18,2018,62443,-21,49,28,638,655
18173,173,18,2019,62851,406,31,437,599,627
18173,173,18,2020,63269,458,25,483,612,675
18175,175,18,2010,28297,22,1,23,70,52
18175,175,18,2011,28201,-102,11,-91,296,302
18175,175,18,2012,27919,-293,2,-291,305,303
18175,175,18,2013,27788,-150,-1,-151,310,289
18175,175,18,2014,27895,57,0,57,346,290
18175,175,18,2015,27784,-135,0,-135,327,302
18175,175,18,2016,27719,-11,-1,-12,308,359
18175,175,18,2017,27780,52,-1,51,322,310
18175,175,18,2018,27936,152,-1,151,321,315
18175,175,18,2019,28063,123,-1,122,309,304
18175,175,18,2020,28213,174,0,174,301,324
18177,177,18,2010,68897,-78,3,-75,172,194
18177,177,18,2011,68661,-334,-13,-347,847,734
18177,177,18,2012,68256,-412,8,-404,816,820
18177,177,18,2013,67829,-424,25,-399,803,831
18177,177,18,2014,67427,-307,51,-256,732,870
18177,177,18,2015,67044,-329,40,-289,819,911
18177,177,18,2016,66723,-309,95,-214,757,860
18177,177,18,2017,66307,-346,68,-278,759,896
18177,177,18,2018,66131,-145,112,-33,805,947
18177,177,18,2019,65943,-140,86,-54,763,899
18177,177,18,2020,65778,-68,67,-1,770,935
18179,179,18,2010,27680,-10,3,-7,97,44
18179,179,18,2011,27737,-33,18,-15,330,259
18179,179,18,2012,27707,-151,21,-130,368,268
18179,179,18,2013,27716,-59,17,-42,334,283
18179,179,18,2014,27817,14,28,42,339,275
18179,179,18,2015,27854,8,15,23,328,313
18179,179,18,2016,27863,-87,16,-71,362,281
18179,179,18,2017,27934,36,13,49,349,325
18179,179,18,2018,27982,32,18,50,318,318
18179,179,18,2019,28131,77,15,92,349,292
18179,179,18,2020,28142,-68,11,-57,335,267
18181,181,18,2010,24685,0,5,5,76,34
18181,181,18,2011,24594,-114,7,-107,286,269
18181,181,18,2012,24467,-186,3,-183,294,240
18181,181,18,2013,24404,-60,12,-48,287,299
18181,181,18,2014,24436,-22,19,-3,291,252
18181,181,18,2015,24279,-140,17,-123,275,310
18181,181,18,2016,24105,-245,37,-208,318,284
18181,181,18,2017,24178,55,25,80,289,294
18181,181,18,2018,24168,-52,43,-9,302,302
18181,181,18,2019,24197,12,30,42,280,291
18181,181,18,2020,24165,-48,26,-22,287,298
18183,183,18,2010,33351,19,4,23,109,63
18183,183,18,2011,33357,-82,18,-64,389,319
18183,183,18,2012,33336,-91,12,-79,367,309
18183,183,18,2013,33287,-144,11,-133,362,278
18183,183,18,2014,33449,50,18,68,410,309
18183,183,18,2015,33451,-73,8,-65,392,321
18183,183,18,2016,33479,-89,8,-81,400,290
18183,183,18,2017,33732,172,10,182,411,337
18183,183,18,2018,34036,201,16,217,405,316
18183,183,18,2019,33868,-218,9,-209,350,309
18183,183,18,2020,34378,488,9,497,356,339
19001,001,19,2010,7679,4,0,4,10,16
19001,001,19,2011,7546,-83,0,-83,66,116
19001,001,19,2012,7466,-56,1,-55,78,104
19001,001,19,2013,7385,-32,0,-32,68,118
19001,001,19,2014,7365,12,0,12,72,102
19001,001,19,2015,7142,-167,3,-164,63,125
19001,001,19,2016,7006,-100,3,-97,76,114
19001,001,19,2017,7047,65,2,67,72,99
19001,001,19,2018,7028,-6,1,-5,87,101
19001,001,19,2019,7102,57,2,59,100,83
19001,001,19,2020,7059,-46,2,-44,98,96
19003,003,19,2010,4023,-2,0,-2,16,20
19003,003,19,2011,3994,-16,0,-16,32,45
19003,003,19,2012,3910,-86,0,-86,51,52
19003,003,19,2013,3890,-19,0,-19,53,53
19003,003,19,2014,3874,-22,0,-22,52,47
19003,003,19,2015,3752,-103,0,-103,41,63
19003,003,19,2016,3690,-47,0,-47,35,50
19003,003,19,2017,3655,-37,0,-37,45,43
19003,003,19,2018,3628,-10,0,-10,28,43
19003,003,19,2019,3602,-37,0,-37,35,25
19003,003,19,2020,3588,-12,0,-12,36,39
19005,005,19,2010,14377,0,22,22,48,21
19005,005,19,2011,14224,-167,23,-144,159,168
19005,005,19,2012,14150,-98,17,-81,161,155
19005,005,19,2013,14074,-129,19,-110,201,168
19005,005,19,2014,14067,-48,22,-26,174,154
19005,005,19,2015,13881,-235,31,-204,181,166
19005,005,19,2016,13847,-67,34,-33,178,178
19005,005,19,2017,13812,-98,21,-77,207,166
19005,005,19,2018,13832,7,10,17,181,177
19005,005,19,2019,13671,-205,32,-173,190,177
19005,005,19,2020,13642,-35,25,-10,174,192
19007,007,19,2010,12861,-1,1,0,30,59
19007,007,19,2011,12853,-10,2,-8,153,153
19007,007,19,2012,12713,-146,1,-145,171,168
19007,007,19,2013,12659,-17,3,-14,136,174
19007,007,19,2014,12678,32,7,39,152,168
19007,007,19,2015,12587,-61,4,-57,145,179
19007,007,19,2016,12515,-58,5,-53,153,170
19007,007,19,2017,12367,-128,6,-122,131,157
19007,007,19,2018,12467,135,4,139,140,177
19007,007,19,2019,12525,86,5,91,134,167
19007,007,19,2020,12430,-71,5,-66,143,172
19009,009,19,2010,6094,-4,0,-4,15,31
19009,009,19,2011,6000,-74,0,-74,61,83
19009,009,19,2012,5861,-100,1,-99,54,95
19009,009,19,2013,5859,6,2,8,59,68
19009,009,19,2014,5768,-75,1,-74,63,81
19009,009,19,2015,5707,-56,1,-55,68,74
19009,009,19,2016,5625,-66,1,-65,67,83
19009,009,19,2017,5550,-47,2,-45,57,88
19009,009,19,2018,5482,-58,1,-57,65,75
19009,009,19,2019,5491,35,2,37,54,81
19009,009,19,2020,5481,4,1,5,58,74
19011,011,19,2010,26049,-15,6,-9,74,86
19011,011,19,2011,26079,-37,2,-35,289,223
19011,011,19,2012,25829,-318,4,-314,248,193
19011,011,19,2013,25698,-183,4,-179,289,243
19011,011,19,2014,25620,-150,5,-145,274,208
19011,011,19,2015,25608,-102,9,-93,319,239
19011,011,19,2016,25634,-45,9,-36,297,232
19011,011,19,2017,25651,-77,8,-69,322,236
19011,011,19,2018,25546,-113,2,-111,283,276
19011,011,19,2019,25544,-44,7,-37,282,247
19011,011,19,2020,25414,-161,7,-154,284,259
19013,013,19,2010,131164,-41,36,-5,428,327
19013,013,19,2011,131598,-351,265,-86,1663,1138
19013,013,19,2012,131904,-350,188,-162,1656,1166
19013,013,19,2013,132966,167,357,524,1754,1201
19013,013,19,2014,133433,-451,437,-14,1728,1222
19013,013,19,2015,133764,-589,337,-252,1777,1186
19013,013,19,2016,133144,-1498,302,-1196,1746,1172
19013,013,19,2017,132278,-1550,318,-1232,1656,1296
19013,013,19,2018,131769,-1159,176,-983,1698,1226
19013,013,19,2019,131089,-1418,357,-1061,1644,1264
19013,013,19,2020,130786,-895,280,-615,1594,1282
19015,015,19,2010,26271,-24,1,-23,75,87
19015,015,19,2011,26287,-9,-1,-10,315,289
19015,015,19,2012,26138,-163,-1,-164,306,290
19015,015,19,2013,26294,144,0,144,322,307
19015,015,19,2014,26303,43,-4,39,270,294
19015,015,19,2015,26468,165,-5,160,288,281
19015,015,19,2016,26434,6,-1,5,277,315
19015,015,19,2017,26498,68,-1,67,283,285
19015,015,19,2018,26356,-103,-1,-104,278,316
19015,015,19,2019,26338,-11,4,-7,276,287
19015,015,19,2020,26277,-13,7,-6,262,318
19017,017,19,2010,24296,11,2,13,49,44
19017,017,19,2011,24383,60,10,70,229,210
19017,017,19,2012,24499,44,12,56,262,196
19017,017,19,2013,24585,19,41,60,244,215
19017,017,19,2014,24678,-3,38,35,261,204
19017,017,19,2015,24755,7,32,39,266,226
19017,017,19,2016,24796,-89,42,-47,300,212
19017,017,19,2017,24861,4,57,61,243,238
19017,017,19,2018,25022,63,34,97,295,230
19017,017,19,2019,25170,73,56,129,253,231
19017,017,19,2020,25311,69,47,116,264,239
19019,019,19,2010,20975,-31,1,-30,81,28
19019,019,19,2011,20911,-124,5,-119,274,217
19019,019,19,2012,20995,-14,3,-11,295,198
19019,019,19,2013,21028,-46,11,-35,284,214
19019,019,19,2014,21135,32,7,39,289,218
19019,019,19,2015,21110,-104,9,-95,287,216
19019,019,19,2016,20999,-192,8,-184,276,203
19019,019,19,2017,21133,60,7,67,284,217
19019,019,19,2018,21140,-44,3,-41,274,225
19019,019,19,2019,21148,-85,5,-80,281,193
19019,019,19,2020,21287,66,3,69,274,203
19021,021,19,2010,20356,14,27,41,86,33
19021,021,19,2011,20310,-180,64,-116,297,228
19021,021,19,2012,20558,49,48,97,322,168
19021,021,19,2013,20649,-180,121,-59,335,186
19021,021,19,2014,20608,-270,86,-184,342,204
19021,021,19,2015,20373,-440,95,-345,300,195
19021,021,19,2016,20327,-269,114,-155,294,186
19021,021,19,2017,20154,-427,102,-325,321,172
19021,021,19,2018,19807,-493,37,-456,292,185
19021,021,19,2019,19690,-373,116,-257,295,154
19021,021,19,2020,19772,-148,90,-58,288,147
19023,023,19,2010,14916,48,2,50,39,42
19023,023,19,2011,14966,76,5,81,152,183
19023,023,19,2012,14972,2,8,10,173,174
19023,023,19,2013,14973,18,11,29,158,184
19023,023,19,2014,14958,-7,14,7,162,183
19023,023,19,2015,14880,-51,8,-43,157,190
19023,023,19,2016,14694,-152,11,-141,134,178
19023,023,19,2017,14593,-62,11,-51,135,185
19023,023,19,2018,14516,-9,3,-6,135,205
19023,023,19,2019,14404,-78,10,-68,156,201
19023,023,19,2020,14333,-38,7,-31,152,192
19025,025,19,2010,10159,-1,0,-1,27,44
19025,025,19,2011,10064,-32,3,-29,91,155
19025,025,19,2012,9912,-146,0,-146,115,125
19025,025,19,2013,9899,16,0,16,125,151
19025,025,19,2014,9845,-19,5,-14,105,145
19025,025,19,2015,9801,-23,5,-18,119,144
19025,025,19,2016,9808,32,5,37,110,139
19025,025,19,2017,9730,-41,9,-32,102,148
19025,025,19,2018,9653,-47,4,-43,103,136
19025,025,19,2019,9616,-51,11,-40,108,105
19025,025,19,2020,9473,-110,7,-103,103,142
19027,027,19,2010,20823,2,1,3,53,47
19027,027,19,2011,20860,-4,7,3,262,227
19027,027,19,2012,20653,-241,1,-240,292,264
19027,027,19,2013,20539,-119,7,-112,223,227
19027,027,19,2014,20495,-63,5,-58,271,255
19027,027,19,2015,20421,-108,6,-102,276,248
19027,027,19,2016,20362,-67,5,-62,249,245
19027,027,19,2017,20256,-112,3,-109,268,266
19027,027,19,2018,20101,-157,3,-154,240,241
19027,027,19,2019,20118,-7,5,-2,226,206
19027,027,19,2020,19914,-191,5,-186,225,242
19029,029,19,2010,13927,2,5,7,44,74
19029,029,19,2011,13762,-130,3,-127,147,183
19029,029,19,2012,13697,-14,1,-13,153,203
19029,029,19,2013,13569,-108,1,-107,155,176
19029,029,19,2014,13394,-114,0,-114,140,202
19029,029,19,2015,13354,19,2,21,132,191
19029,029,19,2016,13198,-126,17,-109,149,197
19029,029,19,2017,13155,10,17,27,132,200
19029,029,19,2018,12959,-156,9,-147,144,192
19029,029,19,2019,12822,-91,16,-75,138,201
19029,029,19,2020,12817,30,13,43,136,184
19031,031,19,2010,18453,1,2,3,34,28
19031,031,19,2011,18362,-105,5,-100,200,191
19031,031,19,2012,18299,-77,5,-72,179,170
19031,031,19,2013,18229,-91,14,-77,170,162
19031,031,19,2014,18278,35,14,49,177,174
19031,031,19,2015,18257,-23,5,-18,196,198
19031,031,19,2016,18351,98,0,98,186,189
19031,031,19,2017,18488,123,2,125,177,163
19031,031,19,2018,18508,22,-1,21,184,185
19031,031,19,2019,18541,28,1,29,185,180
19031,031,19,2020,18485,-36,1,-35,172,195
19033,033,19,2010,44097,-51,10,-41,125,134
19033,033,19,2011,43971,-159,21,-138,477,464
19033,033,19,2012,43704,-281,29,-252,486,502
19033,033,19,2013,43537,-192,46,-146,446,465
19033,033,19,2014,43224,-331,33,-298,499,512
19033,033,19,2015,43006,-200,26,-174,485,529
19033,033,19,2016,43107,175,38,213,438,546
19033,033,19,2017,43030,-47,22,-25,461,510
19033,033,19,2018,42643,-317,10,-307,445,526
19033,033,19,2019,42477,-169,38,-131,473,508
19033,033,19,2020,42103,-327,34,-293,462,541
19035,035,19,2010,12110,45,1,46,17,21
19035,035,19,2011,12027,-40,1,-39,112,156
19035,035,19,2012,11954,-36,0,-36,136,172
19035,035,19,2013,11876,-60,2,-58,140,162
19035,035,19,2014,11803,-68,10,-58,143,160
19035,035,19,2015,11488,-291,5,-286,130,163
19035,035,19,2016,11386,-54,7,-47,117,171
19035,035,19,2017,11315,-50,10,-40,136,166
19035,035,19,2018,11281,1,6,7,112,152
19035,035,19,2019,11231,-16,9,-7,109,151
19035,035,19,2020,11190,6,8,14,114,170
19037,037,19,2010,12411,-24,-1,-25,47,54
19037,037,19,2011,12407,-5,0,-5,137,135
19037,037,19,2012,12289,-145,0,-145,149,124
19037,037,19,2013,12273,1,1,2,136,151
19037,037,19,2014,12250,-44,9,-35,140,127
19037,037,19,2015,12152,-102,13,-89,127,136
19037,037,19,2016,12098,-71,14,-57,133,130
19037,037,19,2017,12008,-83,2,-81,146,156
19037,037,19,2018,11965,-81,10,-71,153,125
19037,037,19,2019,11943,-50,26,-24,128,126
19037,037,19,2020,11834,-138,21,-117,139,131
19039,039,19,2010,9321,11,1,12,35,11
19039,039,19,2011,9318,-7,0,-7,115,111
19039,039,19,2012,9339,27,-2,25,126,128
19039,039,19,2013,9244,-129,11,-118,130,107
19039,039,19,2014,9192,-60,3,-57,120,115
19039,039,19,2015,9213,-11,11,0,126,105
19039,039,19,2016,9293,28,35,63,128,110
19039,039,19,2017,9395,51,32,83,125,106
19039,039,19,2018,9489,59,22,81,129,115
19039,039,19,2019,9382,-166,53,-113,115,107
19039,039,19,2020,9353,-78,39,-39,121,111
19041,041,19,2010,16633,-27,0,-27,55,61
19041,041,19,2011,16598,-36,-3,-39,199,194
19041,041,19,2012,16540,-39,-2,-41,178,193
19041,041,19,2013,16440,-142,7,-135,223,191
19041,041,19,2014,16483,50,5,55,191,199
19041,041,19,2015,16498,2,9,11,212,204
19041,041,19,2016,16301,-196,16,-180,180,199
19041,041,19,2017,16151,-183,10,-173,184,160
19041,041,19,2018,16167,-17,6,-11,208,181
19041,041,19,2019,16094,-89,13,-76,191,189
19041,041,19,2020,15976,-123,10,-113,186,191
19043,043,19,2010,18080,-34,1,-33,46,61
19043,043,19,2011,18019,-35,3,-32,179,207
19043,043,19,2012,17947,-99,3,-96,189,166
19043,043,19,2013,17793,-144,7,-137,198,214
19043,043,19,2014,17771,-55,9,-46,208,184
19043,043,19,2015,17726,-44,8,-36,189,197
19043,043,19,2016,17657,-67,16,-51,172,189
19043,043,19,2017,17647,-6,14,8,200,216
19043,043,19,2018,17515,-118,8,-110,181,203
19043,043,19,2019,17497,-23,15,-8,178,188
19043,043,19,2020,17321,-150,10,-140,176,210
19045,045,19,2010,49091,-24,7,-17,166,164
19045,045,19,2011,49105,-65,23,-42,597,539
19045,045,19,2012,48711,-465,20,-445,572,531
19045,045,19,2013,48297,-492,54,-438,560,545
19045,045,19,2014,47921,-431,40,-391,538,527
19045,045,19,2015,47593,-404,46,-358,590,564
19045,045,19,2016,47285,-363,48,-315,583,576
19045,045,19,2017,46926,-336,37,-299,547,607
19045,045,19,2018,46506,-368,12,-356,519,582
19045,045,19,2019,46559,3,49,52,529,528
19045,045,19,2020,46392,-192,37,-155,516,529
19047,047,19,2010,17166,13,22,35,91,49
19047,047,19,2011,17213,-21,20,-1,231,183
19047,047,19,2012,17292,-55,15,-40,259,139
19047,047,19,2013,17351,-20,34,14,204,154
19047,047,19,2014,17156,-317,32,-285,251,166
19047,047,19,2015,17069,-218,83,-135,210,164
19047,047,19,2016,17107,-133,86,-47,251,165
19047,047,19,2017,17065,-112,26,-86,231,188
19047,047,19,2018,17081,-88,50,-38,220,165
19047,047,19,2019,16903,-406,163,-243,224,159
19047,047,19,2020,16834,-250,123,-127,217,157
19049,049,19,2010,66751,325,33,358,287,59
19049,049,19,2011,69699,2043,233,2276,1009,353
19049,049,19,2012,72248,1528,213,1741,1131,374
19049,049,19,2013,74968,1536,296,1832,1221,371
19049,049,19,2014,77758,1654,319,1973,1190,417
19049,049,19,2015,80658,1787,255,2042,1257,423
19049,049,19,2016,84278,2562,207,2769,1285,450
19049,049,19,2017,87219,1883,239,2122,1318,509
19049,049,19,2018,89999,1930,122,2052,1222,501
19049,049,19,2019,93631,2658,221,2879,1279,524
19049,049,19,2020,96963,2387,181,2568,1309,538
19051,051,19,2010,8777,7,0,7,30,13
19051,051,19,2011,8772,-46,0,-46,131,90
19051,051,19,2012,8705,-120,0,-120,137,85
19051,051,19,2013,8767,31,0,31,127,95
19051,051,19,2014,8755,-64,0,-64,136,83
19051,051,19,2015,8774,-48,0,-48,137,69
19051,051,19,2016,8893,64,3,67,162,109
19051,051,19,2017,8969,-2,2,0,158,81
19051,051,19,2018,8967,-69,0,-69,154,88
19051,051,19,2019,9006,-38,2,-36,162,87
19051,051,19,2020,9051,-32,3,-29,158,84
19053,053,19,2010,8419,-27,-1,-28,29,39
19053,053,19,2011,8250,-162,11,-151,80,97
19053,053,19,2012,8241,-16,9,-7,90,90
19053,053,19,2013,8223,-20,8,-12,88,94
19053,053,19,2014,8216,-7,9,2,105,115
19053,053,19,2015,8145,-94,12,-82,93,81
19053,053,19,2016,8061,-102,11,-91,94,88
19053,053,19,2017,7956,-128,9,-119,106,93
19053,053,19,2018,7901,-68,7,-61,95,91
19053,053,19,2019,7852,-76,8,-68,99,80
19053,053,19,2020,7769,-99,6,-93,90,78
19055,055,19,2010,17763,1,0,1,47,53
19055,055,19,2011,17631,-163,1,-162,187,158
19055,055,19,2012,17568,-97,3,-94,199,170
19055,055,19,2013,17475,-134,15,-119,195,171
19055,055,19,2014,17397,-136,15,-121,212,171
19055,055,19,2015,17395,-56,9,-47,230,185
19055,055,19,2016,17289,-152,5,-147,213,171
19055,055,19,2017,17139,-165,7,-158,183,175
19055,055,19,2018,17115,-75,4,-71,210,163
19055,055,19,2019,17057,-86,7,-79,194,173
19055,055,19,2020,16937,-124,6,-118,189,190
19057,057,19,2010,40243,-50,6,-44,119,156
19057,057,19,2011,40074,-207,15,-192,476,451
19057,057,19,2012,40247,158,15,173,456,449
19057,057,19,2013,40421,134,36,170,484,475
19057,057,19,2014,40127,-333,32,-301,465,462
19057,057,19,2015,39909,-238,28,-210,444,451
19057,057,19,2016,39719,-294,44,-250,516,456
19057,057,19,2017,39400,-284,51,-233,385,470
19057,057,19,2018,39259,-215,40,-175,480,444
19057,057,19,2019,39051,-177,27,-150,429,487
19057,057,19,2020,38708,-332,22,-310,445,475
19059,059,19,2010,16669,12,0,12,44,51
19059,059,19,2011,16861,245,4,249,141,199
19059,059,19,2012,16929,68,7,75,181,186
19059,059,19,2013,16883,15,8,23,154,222
19059,059,19,2014,16845,8,11,19,174,228
19059,059,19,2015,17009,168,6,174,173,183
19059,059,19,2016,17135,122,24,146,172,191
19059,059,19,2017,17167,98,21,119,130,215
19059,059,19,2018,17159,28,11,39,153,198
19059,059,19,2019,17290,150,19,169,157,194
19059,059,19,2020,17549,278,17,295,152,186
19061,061,19,2010,93933,120,22,142,317,163
19061,061,19,2011,94656,320,115,435,1159,868
19061,061,19,2012,95183,180,65,245,1163,865
19061,061,19,2013,95990,433,127,560,1167,916
19061,061,19,2014,96544,127,105,232,1283,940
19061,061,19,2015,96934,21,96,117,1237,952
19061,061,19,2016,96819,-573,127,-446,1198,864
19061,061,19,2017,97162,-49,137,88,1165,905
19061,061,19,2018,96961,-486,70,-416,1168,954
19061,061,19,2019,97432,6,150,156,1207,891
19061,061,19,2020,97590,-198,128,-70,1196,970
19063,063,19,2010,10277,-25,18,-7,30,49
19063,063,19,2011,10092,-237,63,-174,101,114
19063,063,19,2012,9949,-136,4,-132,115,130
19063,063,19,2013,9886,-38,11,-27,112,146
19063,063,19,2014,9830,-61,4,-57,113,113
19063,063,19,2015,9708,-125,8,-117,109,114
19063,063,19,2016,9588,-126,10,-116,109,115
19063,063,19,2017,9428,-148,12,-136,107,131
19063,063,19,2018,9276,-144,9,-135,116,133
19063,063,19,2019,9224,-50,11,-39,101,114
19063,063,19,2020,9095,-129,7,-122,106,113
19065,065,19,2010,20860,-32,2,-30,50,42
19065,065,19,2011,20975,108,28,136,217,237
19065,065,19,2012,20773,-196,18,-178,220,246
19065,065,19,2013,20516,-230,25,-205,220,275
19065,065,19,2014,20288,-192,31,-161,195,265
19065,065,19,2015,20143,-111,23,-88,210,266
19065,065,19,2016,19858,-263,20,-243,220,263
19065,065,19,2017,19680,-151,17,-134,211,254
19065,065,19,2018,19643,18,9,27,207,269
19065,065,19,2019,19575,-94,20,-74,219,213
19065,065,19,2020,19258,-298,14,-284,202,233
19067,067,19,2010,16308,11,3,14,32,29
19067,067,19,2011,16095,-222,-1,-223,194,185
19067,067,19,2012,16090,0,-4,-4,200,199
19067,067,19,2013,16029,-13,-5,-18,168,209
19067,067,19,2014,16008,-19,-1,-20,210,209
19067,067,19,2015,15920,-105,20,-85,197,200
19067,067,19,2016,15870,-95,24,-71,197,176
19067,067,19,2017,15778,-126,19,-107,204,189
19067,067,19,2018,15784,-25,34,9,190,192
19067,067,19,2019,15655,-150,2,-148,164,145
19067,067,19,2020,15480,-181,12,-169,171,176
19069,069,19,2010,10706,-3,5,2,41,16
19069,069,19,2011,10695,-15,0,-15,125,121
19069,069,19,2012,10509,-174,-3,-177,106,119
19069,069,19,2013,10507,20,4,24,112,138
19069,069,19,2014,10433,-109,11,-98,132,110
19069,069,19,2015,10318,-137,6,-131,123,108
19069,069,19,2016,10173,-142,6,-136,124,135
19069,069,19,2017,10150,-41,4,-37,134,119
19069,069,19,2018,10081,-40,1,-39,117,146
19069,069,19,2019,10082,-10,5,-5,108,102
19069,069,19,2020,9971,-111,6,-105,108,114
19071,071,19,2010,7434,-12,0,-12,22,13
19071,071,19,2011,7371,-59,3,-56,83,89
19071,071,19,2012,7140,-210,1,-209,65,95
19071,071,19,2013,7068,-43,2,-41,70,101
19071,071,19,2014,7029,-28,2,-26,79,92
19071,071,19,2015,6910,-99,3,-96,80,104
19071,071,19,2016,6945,46,2,48,84,96
19071,071,19,2017,6927,-10,2,-8,78,88
19071,071,19,2018,6956,29,0,29,82,82
19071,071,19,2019,6917,-29,2,-27,69,81
19071,071,19,2020,6729,-157,2,-155,64,96
19073,073,19,2010,9362,5,3,8,39,20
19073,073,19,2011,9331,-13,1,-12,93,112
19073,073,19,2012,9181,-114,4,-110,88,130
19073,073,19,2013,9158,-11,4,-7,108,123
19073,073,19,2014,9127,-9,0,-9,103,125
19073,073,19,2015,8947,-171,1,-170,105,116
19073,073,19,2016,9011,71,-1,70,116,123
19073,073,19,2017,8959,-22,1,-21,107,139
19073,073,19,2018,8971,30,0,30,102,118
19073,073,19,2019,8881,-74,0,-74,89,104
19073,073,19,2020,8795,-67,1,-66,90,110
19075,075,19,2010,12464,5,0,5,47,40
19075,075,19,2011,12478,6,1,7,134,127
19075,075,19,2012,12437,-54,1,-53,135,122
19075,075,19,2013,12340,-114,1,-113,135,122
19075,075,19,2014,12388,48,0,48,122,119
19075,075,19,2015,12402,36,0,36,123,143
19075,075,19,2016,12303,-107,0,-107,141,133
19075,075,19,2017,12296,42,0,42,97,146
19075,075,19,2018,12268,-10,0,-10,134,151
19075,075,19,2019,12227,-25,0,-25,137,153
19075,075,19,2020,12217,2,0,2,127,140
19077,077,19,2010,10942,5,1,6,20,43
19077,077,19,2011,10864,-53,3,-50,101,130
19077,077,19,2012,10768,-99,1,-98,111,111
19077,077,19,2013,10675,-96,4,-92,106,107
19077,077,19,2014,10690,25,7,32,108,123
19077,077,19,2015,10653,-10,5,-5,114,145
19077,077,19,2016,10661,-5,8,3,123,116
19077,077,19,2017,10652,19,8,27,90,126
19077,077,19,2018,10719,69,3,72,121,124
19077,077,19,2019,10741,39,8,47,94,120
19077,077,19,2020,10737,22,6,28,97,129
19079,079,19,2010,15634,-26,0,-26,39,53
19079,079,19,2011,15468,-165,-2,-167,157,158
19079,079,19,2012,15321,-159,8,-151,172,171
19079,079,19,2013,15347,16,21,37,161,172
19079,079,19,2014,15222,-181,20,-161,213,179
19079,079,19,2015,15220,-35,9,-26,190,165
19079,079,19,2016,15090,-185,7,-178,206,159
19079,079,19,2017,15034,-39,5,-34,168,189
19079,079,19,2018,14887,-134,2,-132,180,194
19079,079,19,2019,14797,-100,9,-91,175,174
19079,079,19,2020,14716,-87,8,-79,176,178
19081,081,19,2010,11300,-24,0,-24,30,47
19081,081,19,2011,11296,1,2,3,101,107
19081,081,19,2012,11180,-92,2,-90,103,130
19081,081,19,2013,11134,-26,4,-22,118,142
19081,081,19,2014,11043,-72,6,-66,103,128
19081,081,19,2015,11029,-20,4,-16,119,115
19081,081,19,2016,10887,-148,5,-143,115,115
19081,081,19,2017,10762,-124,3,-121,120,125
19081,081,19,2018,10726,-45,4,-41,123,118
19081,081,19,2019,10664,-61,8,-53,108,116
19081,081,19,2020,10507,-154,7,-147,110,119
19083,083,19,2010,17543,-5,1,-4,54,38
19083,083,19,2011,17376,-139,14,-125,185,227
19083,083,19,2012,17360,22,6,28,166,207
19083,083,19,2013,17390,43,30,73,200,240
19083,083,19,2014,17338,-40,14,-26,189,212
19083,083,19,2015,17257,-51,10,-41,185,224
19083,083,19,2016,17193,-33,14,-19,187,230
19083,083,19,2017,17076,-94,16,-78,173,211
19083,083,19,2018,16965,-98,11,-87,186,210
19083,083,19,2019,16809,-123,31,-92,149,213
19083,083,19,2020,16575,-180,22,-158,160,234
19085,085,19,2010,14908,-10,0,-10,43,61
19085,085,19,2011,14764,-87,0,-87,142,200
19085,085,19,2012,14474,-267,0,-267,146,176
19085,085,19,2013,14359,-77,0,-77,149,189
19085,085,19,2014,14268,-113,0,-113,181,160
19085,085,19,2015,14145,-86,0,-86,152,189
19085,085,19,2016,14051,-69,0,-69,162,187
19085,085,19,2017,14116,69,1,70,163,167
19085,085,19,2018,14086,-11,2,-9,161,182
19085,085,19,2019,14034,-28,0,-28,160,184
19085,085,19,2020,13928,-72,0,-72,157,190
19087,087,19,2010,20112,-35,11,-24,56,71
19087,087,19,2011,20252,129,15,144,227,231
19087,087,19,2012,20003,-273,4,-269,229,216
19087,087,19,2013,20029,-6,6,0,227,201
19087,087,19,2014,19846,-223,26,-197,236,227
19087,087,19,2015,19862,-29,21,-8,238,212
19087,087,19,2016,19842,-55,27,-28,226,216
19087,087,19,2017,20056,193,18,211,224,222
19087,087,19,2018,20015,-63,9,-54,231,218
19087,087,19,2019,19835,-206,15,-191,209,198
19087,087,19,2020,19697,-142,13,-129,202,211
19089,089,19,2010,9569,-13,2,-11,29,13
19089,089,19,2011,9548,-28,11,-17,114,118
19089,089,19,2012,9550,-11,2,-9,117,105
19089,089,19,2013,9443,-118,3,-115,121,114
19089,089,19,2014,9357,-92,-1,-93,111,105
19089,089,19,2015,9322,-57,0,-57,127,104
19089,089,19,2016,9261,-57,-3,-60,112,113
19089,089,19,2017,9235,-44,-2,-46,123,103
19089,089,19,2018,9185,-47,-2,-49,119,120
19089,089,19,2019,9146,-15,-1,-16,112,133
19089,089,19,2020,9176,36,-1,35,119,124
19091,091,19,2010,9791,-19,1,-18,25,31
19091,091,19,2011,9782,2,2,4,107,119
19091,091,19,2012,9724,-44,2,-42,109,125
19091,091,19,2013,9682,-45,9,-36,109,115
19091,091,19,2014,9641,-31,6,-25,102,116
19091,091,19,2015,9562,-75,9,-66,112,125
19091,091,19,2016,9530,-21,8,-13,107,124
19091,091,19,2017,9568,41,2,43,113,118
19091,091,19,2018,9520,-46,5,-41,107,115
19091,091,19,2019,9499,-50,15,-35,109,95
19091,091,19,2020,9473,-17,12,-5,105,124
19093,093,19,2010,7067,-8,0,-8,24,38
19093,093,19,2011,7046,13,0,13,71,106
19093,093,19,2012,7045,15,0,15,74,88
19093,093,19,2013,7075,33,2,35,91,95
19093,093,19,2014,6971,-106,2,-104,83,85
19093,093,19,2015,6967,-8,8,0,72,76
19093,093,19,2016,6960,1,1,2,83,92
19093,093,19,2017,6864,-72,0,-72,78,101
19093,093,19,2018,6829,9,0,9,69,113
19093,093,19,2019,6822,39,0,39,64,108
19093,093,19,2020,6833,50,0,50,68,108
19095,095,19,2010,16335,-29,0,-29,56,48
19095,095,19,2011,16324,-24,-3,-27,170,153
19095,095,19,2012,16183,-167,-2,-169,189,166
19095,095,19,2013,16286,113,-2,111,202,207
19095,095,19,2014,16325,28,0,28,194,180
19095,095,19,2015,16293,-52,-2,-54,189,167
19095,095,19,2016,16202,-81,-3,-84,185,191
19095,095,19,2017,16139,-74,-4,-78,184,169
19095,095,19,2018,16150,32,-4,28,169,184
19095,095,19,2019,16146,31,-4,27,170,201
19095,095,19,2020,16138,43,-2,41,165,214
19097,097,19,2010,19831,0,1,1,40,62
19097,097,19,2011,19734,-65,1,-64,209,242
19097,097,19,2012,19684,-14,1,-13,195,230
19097,097,19,2013,19516,-143,0,-143,204,230
19097,097,19,2014,19430,-85,3,-82,214,218
19097,097,19,2015,19363,-30,1,-29,204,240
19097,097,19,2016,19406,2,1,3,240,199
19097,097,19,2017,19377,-42,1,-41,228,214
19097,097,19,2018,19375,36,1,37,197,235
19097,097,19,2019,19375,0,1,1,221,222
19097,097,19,2020,19205,-140,1,-139,211,242
19099,099,19,2010,36810,-24,3,-21,114,123
19099,099,19,2011,36624,-237,15,-222,371,334
19099,099,19,2012,36583,-128,8,-120,454,376
19099,099,19,2013,36739,72,10,82,434,354
19099,099,19,2014,36891,133,-1,132,414,388
19099,099,19,2015,36762,-171,9,-162,418,383
19099,099,19,2016,36722,-99,6,-93,400,345
19099,099,19,2017,36997,289,6,295,406,424
19099,099,19,2018,37121,138,3,141,388,404
19099,099,19,2019,37171,5,11,16,420,385
19099,099,19,2020,37148,-34,9,-25,400,401
19101,101,19,2010,16835,-32,39,7,37,48
19101,101,19,2011,17099,63,236,299,129,163
19101,101,19,2012,17281,-58,235,177,147,142
19101,101,19,2013,17632,4,364,368,146,159
19101,101,19,2014,17795,-126,307,181,150,169
19101,101,19,2015,17913,-151,222,71,172,127
19101,101,19,2016,18027,-84,191,107,168,161
19101,101,19,2017,18108,-73,210,137,148,203
19101,101,19,2018,18102,-94,104,10,152,171
19101,101,19,2019,18180,-98,202,104,144,169
19101,101,19,2020,18347,60,158,218,141,191
19103,103,19,2010,131344,-23,210,187,453,166
19103,103,19,2011,134125,456,1135,1591,1761,576
19103,103,19,2012,137180,1153,713,1866,1793,632
19103,103,19,2013,140266,882,1071,1953,1809,683
19103,103,19,2014,142874,391,1119,1510,1800,683
19103,103,19,2015,145114,233,852,1085,1847,687
19103,103,19,2016,147167,12,966,978,1821,744
19103,103,19,2017,149703,338,1161,1499,1778,739
19103,103,19,2018,151003,-291,570,279,1753,730
19103,103,19,2019,152480,-632,1103,471,1742,742
19103,103,19,2020,153740,-501,868,367,1719,835
19105,105,19,2010,20687,27,0,27,58,30
19105,105,19,2011,20743,26,11,37,209,189
19105,105,19,2012,20602,-130,5,-125,200,218
19105,105,19,2013,20522,-107,17,-90,204,194
19105,105,19,2014,20553,4,39,43,223,231
19105,105,19,2015,20435,-149,18,-131,211,198
19105,105,19,2016,20385,-52,12,-40,202,212
19105,105,19,2017,20610,184,11,195,210,180
19105,105,19,2018,20627,14,7,21,201,204
19105,105,19,2019,20634,-11,14,3,198,193
19105,105,19,2020,20617,3,12,15,198,230
19107,107,19,2010,10508,-18,0,-18,29,12
19107,107,19,2011,10399,-137,1,-136,127,101
19107,107,19,2012,10427,-11,1,-10,135,97
19107,107,19,2013,10336,-68,4,-64,117,144
19107,107,19,2014,10282,-76,5,-71,131,116
19107,107,19,2015,10169,-104,6,-98,106,122
19107,107,19,2016,10171,-15,7,-8,120,110
19107,107,19,2017,10144,-29,10,-19,115,122
19107,107,19,2018,10221,63,6,69,138,130
19107,107,19,2019,10192,-20,10,-10,97,114
19107,107,19,2020,10085,-105,7,-98,105,114
19109,109,19,2010,15524,-22,0,-22,53,53
19109,109,19,2011,15396,-111,8,-103,160,185
19109,109,19,2012,15407,24,2,26,164,174
19109,109,19,2013,15325,-35,8,-27,150,204
19109,109,19,2014,15221,-74,8,-66,146,182
19109,109,19,2015,15150,-46,8,-38,178,211
19109,109,19,2016,15104,-52,12,-40,175,180
19109,109,19,2017,14935,-163,10,-153,160,175
19109,109,19,2018,14834,-95,3,-92,171,181
19109,109,19,2019,14769,-93,12,-81,172,156
19109,109,19,2020,14680,-89,5,-84,173,178
19111,111,19,2010,35850,-22,5,-17,88,77
19111,111,19,2011,35575,-260,23,-237,390,429
19111,111,19,2012,35549,-10,13,3,413,435
19111,111,19,2013,35250,-297,9,-288,428,446
19111,111,19,2014,35077,-150,4,-146,428,453
19111,111,19,2015,34916,-155,1,-154,429,436
19111,111,19,2016,34441,-415,-3,-418,381,437
19111,111,19,2017,34239,-194,-3,-197,437,443
19111,111,19,2018,33929,-272,-4,-276,387,421
19111,111,19,2019,33641,-203,-3,-206,338,421
19111,111,19,2020,33480,-29,2,-27,328,462
19113,113,19,2010,211713,-27,95,68,762,331
19113,113,19,2011,214242,1107,412,1519,2633,1621
19113,113,19,2012,215542,-38,268,230,2771,1648
19113,113,19,2013,216567,-406,429,23,2707,1684
19113,113,19,2014,218223,232,408,640,2716,1647
19113,113,19,2015,220392,698,375,1073,2892,1775
19113,113,19,2016,222299,512,367,879,2820,1778
19113,113,19,2017,224553,817,436,1253,2794,1781
19113,113,19,2018,226060,335,222,557,2781,1825
19113,113,19,2019,227241,-228,471,243,2703,1772
19113,113,19,2020,227854,-528,378,-150,2674,1921
19115,115,19,2010,11382,-22,2,-20,25,12
19115,115,19,2011,11384,-47,22,-25,136,108
19115,115,19,2012,11364,-82,21,-61,139,99
19115,115,19,2013,11353,-81,48,-33,127,105
19115,115,19,2014,11254,-185,56,-129,141,114
19115,115,19,2015,11289,-57,45,-12,155,109
19115,115,19,2016,11219,-154,46,-108,136,100
19115,115,19,2017,11203,-81,50,-31,132,115
19115,115,19,2018,11135,-109,22,-87,136,118
19115,115,19,2019,11059,-163,55,-108,129,97
19115,115,19,2020,11011,-93,45,-48,123,125
19117,117,19,2010,8897,-13,3,-10,26,19
19117,117,19,2011,8879,-48,16,-32,115,100
19117,117,19,2012,8777,-77,2,-75,82,109
19117,117,19,2013,8695,-68,0,-68,97,112
19117,117,19,2014,8633,-53,0,-53,91,101
19117,117,19,2015,8609,-5,0,-5,104,121
19117,117,19,2016,8565,-24,0,-24,105,124
19117,117,19,2017,8537,-21,-1,-22,108,114
19117,117,19,2018,8590,45,-1,44,128,118
19117,117,19,2019,8561,-39,-1,-40,99,88
19117,117,19,2020,8518,-48,0,-48,100,96
19119,119,19,2010,11569,-11,0,-11,48,49
19119,119,19,2011,11694,46,0,46,186,106
19119,119,19,2012,11761,37,2,39,150,120
19119,119,19,2013,11700,-101,1,-100,162,124
19119,119,19,2014,11709,-70,1,-69,173,97
19119,119,19,2015,11755,-12,1,-11,163,107
19119,119,19,2016,11800,-48,8,-40,186,101
19119,119,19,2017,11791,-61,6,-55,157,111
19119,119,19,2018,11849,-31,6,-25,197,114
19119,119,19,2019,11806,-109,10,-99,159,103
19119,119,19,2020,11756,-124,8,-116,174,108
19121,121,19,2010,15738,34,5,39,61,45
19121,121,19,2011,15738,-9,5,-4,159,154
19121,121,19,2012,15639,-147,2,-145,172,127
19121,121,19,2013,15482,-173,17,-156,161,166
19121,121,19,2014,15620,95,17,112,165,136
19121,121,19,2015,15727,78,8,86,159,137
19121,121,19,2016,15800,57,6,63,176,165
19121,121,19,2017,16005,185,6,191,162,149
19121,121,19,2018,16140,138,4,142,153,158
19121,121,19,2019,16273,93,6,99,179,146
19121,121,19,2020,16521,228,6,234,173,156
19123,123,19,2010,22409,-19,3,-16,73,30
19123,123,19,2011,22506,2,13,15,305,222
19123,123,19,2012,22407,-116,7,-109,246,235
19123,123,19,2013,22432,-61,40,-21,286,241
19123,123,19,2014,22466,-47,38,-9,270,219
19123,123,19,2015,22417,-151,33,-118,295,227
19123,123,19,2016,22325,-201,41,-160,312,243
19123,123,19,2017,22422,57,40,97,243,241
19123,123,19,2018,22203,-260,22,-238,262,244
19123,123,19,2019,22429,137,39,176,283,232
19123,123,19,2020,22370,-101,27,-74,263,250
19125,125,19,2010,33225,-77,8,-69,84,100
19125,125,19,2011,33274,-40,19,-21,384,312
19125,125,19,2012,33277,-14,13,-1,334,325
19125,125,19,2013,33019,-302,12,-290,383,356
19125,125,19,2014,33280,189,18,207,381,323
19125,125,19,2015,33123,-179,7,-172,363,350
19125,125,19,2016,33157,-24,14,-10,371,326
19125,125,19,2017,33107,-83,12,-71,403,380
19125,125,19,2018,33251,146,4,150,323,328
19125,125,19,2019,33280,-7,8,1,355,325
19125,125,19,2020,33168,-92,8,-84,336,365
19127,127,19,2010,40722,2,68,70,147,138
19127,127,19,2011,41013,44,168,212,538,458
19127,127,19,2012,41032,-199,126,-73,552,459
19127,127,19,2013,40993,-309,180,-129,589,501
19127,127,19,2014,40712,-494,103,-391,551,450
19127,127,19,2015,40340,-494,111,-383,516,509
19127,127,19,2016,40122,-388,112,-276,527,470
19127,127,19,2017,40051,-102,24,-78,490,481
19127,127,19,2018,39879,-275,40,-235,554,493
19127,127,19,2019,39472,-605,179,-426,490,470
19127,127,19,2020,39495,-135,144,9,490,476
19129,129,19,2010,15076,3,3,6,30,18
19129,129,19,2011,15031,-57,0,-57,156,143
19129,129,19,2012,14874,-152,-1,-153,150,157
19129,129,19,2013,14907,33,0,33,154,152
19129,129,19,2014,14763,-172,-2,-174,153,127
19129,129,19,2015,14885,78,7,85,166,128
19129,129,19,2016,15041,131,5,136,140,119
19129,129,19,2017,15060,5,0,5,152,137
19129,129,19,2018,15122,39,0,39,141,117
19129,129,19,2019,15124,14,4,18,135,152
19129,129,19,2020,14766,-344,4,-340,135,151
19131,131,19,2010,10793,9,1,10,48,39
19131,131,19,2011,10709,-76,6,-70,120,134
19131,131,19,2012,10714,25,2,27,113,133
19131,131,19,2013,10663,-32,1,-31,120,139
19131,131,19,2014,10694,23,4,27,131,124
19131,131,19,2015,10670,-6,1,-5,116,135
19131,131,19,2016,10650,-24,1,-23,125,121
19131,131,19,2017,10544,-71,1,-70,117,152
19131,131,19,2018,10536,10,1,11,131,149
19131,131,19,2019,10565,36,1,37,118,127
19131,131,19,2020,10647,80,1,81,131,129
19133,133,19,2010,9249,5,2,7,21,20
19133,133,19,2011,9238,53,4,57,76,144
19133,133,19,2012,9090,-88,1,-87,83,145
19133,133,19,2013,9030,5,4,9,93,162
19133,133,19,2014,8898,-46,3,-43,78,168
19133,133,19,2015,8865,11,-1,10,95,135
19133,133,19,2016,8779,-15,0,-15,88,158
19133,133,19,2017,8721,-10,-1,-11,92,139
19133,133,19,2018,8649,-26,-1,-27,92,136
19133,133,19,2019,8626,23,-1,22,87,132
19133,133,19,2020,8598,29,-1,28,92,147
19135,135,19,2010,7993,9,2,11,22,7
19135,135,19,2011,8057,80,3,83,104,123
19135,135,19,2012,8070,17,3,20,72,77
19135,135,19,2013,7974,-85,8,-77,90,108
19135,135,19,2014,7952,9,5,14,86,121
19135,135,19,2015,7919,1,2,3,85,119
19135,135,19,2016,7835,-78,1,-77,99,107
19135,135,19,2017,7782,-8,0,-8,69,113
19135,135,19,2018,7738,-22,0,-22,86,108
19135,135,19,2019,7681,-66,0,-66,90,80
19135,135,19,2020,7770,81,0,81,85,77
19137,137,19,2010,10690,-25,1,-24,27,52
19137,137,19,2011,10633,-16,-2,-18,106,147
19137,137,19,2012,10541,-71,0,-71,121,144
19137,137,19,2013,10407,-103,9,-94,107,148
19137,137,19,2014,10386,13,6,19,115,152
19137,137,19,2015,10153,-202,3,-199,127,163
19137,137,19,2016,10135,-18,5,-13,127,132
19137,137,19,2017,10119,-1,5,4,124,142
19137,137,19,2018,9976,-102,2,-100,115,160
19137,137,19,2019,9917,-7,8,1,93,152
19137,137,19,2020,9935,54,6,60,107,150
19139,139,19,2010,42804,-91,13,-78,137,60
19139,139,19,2011,42847,-176,47,-129,554,381
19139,139,19,2012,42922,-75,28,-47,534,407
19139,139,19,2013,43018,-162,118,-44,536,395
19139,139,19,2014,43032,-250,95,-155,576,408
19139,139,19,2015,43069,-187,102,-85,522,399
19139,139,19,2016,42942,-318,71,-247,533,413
19139,139,19,2017,42825,-309,83,-226,541,431
19139,139,19,2018,42784,-234,63,-171,549,421
19139,139,19,2019,42571,-415,75,-340,521,395
19139,139,19,2020,42394,-362,66,-296,512,392
19141,141,19,2010,14405,-10,0,-10,52,34
19141,141,19,2011,14217,-144,9,-135,137,189
19141,141,19,2012,14154,-30,3,-27,154,189
19141,141,19,2013,14046,-108,5,-103,165,172
19141,141,19,2014,14045,4,9,13,167,183
19141,141,19,2015,13927,-99,6,-93,179,202
19141,141,19,2016,13921,21,1,22,173,199
19141,141,19,2017,13777,-107,1,-106,161,198
19141,141,19,2018,13806,69,0,69,179,218
19141,141,19,2019,13796,7,1,8,163,181
19141,141,19,2020,13679,-98,2,-96,160,181
19143,143,19,2010,6458,-15,5,-10,15,9
19143,143,19,2011,6315,-120,3,-117,57,84
19143,143,19,2012,6203,-123,2,-121,63,58
19143,143,19,2013,6236,12,10,22,86,75
19143,143,19,2014,6231,-25,8,-17,76,65
19143,143,19,2015,6161,-88,8,-80,86,76
19143,143,19,2016,6089,-72,6,-66,69,74
19143,143,19,2017,6024,-55,2,-53,65,78
19143,143,19,2018,6020,-3,2,-1,62,65
19143,143,19,2019,5961,-66,9,-57,63,64
19143,143,19,2020,5987,31,7,38,63,75
19145,145,19,2010,15920,7,2,9,42,74
19145,145,19,2011,15900,7,9,16,173,209
19145,145,19,2012,15705,-163,4,-159,178,216
19145,145,19,2013,15521,-174,17,-157,173,204
19145,145,19,2014,15487,-38,16,-22,172,181
19145,145,19,2015,15466,16,12,28,175,221
19145,145,19,2016,15343,-108,22,-86,158,196
19145,145,19,2017,15253,-56,15,-41,165,213
19145,145,19,2018,15227,26,12,38,130,194
19145,145,19,2019,15129,-80,28,-52,144,188
19145,145,19,2020,15073,-3,22,19,131,206
19147,147,19,2010,9398,-32,2,-30,21,16
19147,147,19,2011,9354,-20,11,-9,104,139
19147,147,19,2012,9278,-46,6,-40,87,123
19147,147,19,2013,9163,-91,14,-77,97,135
19147,147,19,2014,9120,-43,20,-23,105,126
19147,147,19,2015,9137,21,21,42,117,142
19147,147,19,2016,9032,-112,22,-90,113,128
19147,147,19,2017,9045,19,23,42,101,128
19147,147,19,2018,8910,-132,13,-119,110,125
19147,147,19,2019,8873,-29,24,-5,102,134
19147,147,19,2020,8845,-23,20,-3,98,123
19149,149,19,2010,24978,-7,2,-5,55,58
19149,149,19,2011,24824,-221,7,-214,296,236
19149,149,19,2012,24836,-16,7,-9,274,252
19149,149,19,2013,24937,37,27,64,284,246
19149,149,19,2014,24918,-109,40,-69,279,231
19149,149,19,2015,24912,-75,30,-45,304,263
19149,149,19,2016,25207,190,29,219,300,222
19149,149,19,2017,25053,-176,7,-169,271,255
19149,149,19,2018,25024,-61,3,-58,299,270
19149,149,19,2019,25200,133,17,150,258,230
19149,149,19,2020,25219,-32,10,-22,277,236
19151,151,19,2010,7290,-23,0,-23,16,14
19151,151,19,2011,7203,-51,1,-50,72,110
19151,151,19,2012,7143,-60,0,-60,70,71
19151,151,19,2013,7112,7,0,7,83,122
19151,151,19,2014,7099,-10,2,-8,81,86
19151,151,19,2015,6970,-128,5,-123,86,94
19151,151,19,2016,6845,-99,1,-98,72,99
19151,151,19,2017,6830,-1,-1,-2,79,91
19151,151,19,2018,6709,-83,-1,-84,74,111
19151,151,19,2019,6632,-67,1,-66,74,86
19151,151,19,2020,6607,-12,1,-11,71,85
19153,153,19,2010,432360,447,424,871,1631,778
19153,153,19,2011,438783,1414,1633,3047,6478,3104
19153,153,19,2012,444753,1472,971,2443,6659,3096
19153,153,19,2013,452780,3018,1486,4504,6744,3273
19153,153,19,2014,461069,3210,1370,4580,6876,3214
19153,153,19,2015,467517,2048,975,3023,6969,3529
19153,153,19,2016,474593,2396,1064,3460,6992,3376
19153,153,19,2017,480962,1902,1214,3116,7008,3756
19153,153,19,2018,486222,1669,452,2121,6772,3642
19153,153,19,2019,491031,522,1232,1754,6554,3519
19153,153,19,2020,494281,-309,964,655,6524,3966
19155,155,19,2010,93363,104,19,123,326,232
19155,155,19,2011,93517,-272,12,-260,1254,839
19155,155,19,2012,92965,-928,20,-908,1208,868
19155,155,19,2013,92923,-396,95,-301,1154,889
19155,155,19,2014,93332,77,80,157,1200,925
19155,155,19,2015,93657,3,45,48,1202,913
19155,155,19,2016,93649,-372,56,-316,1191,881
19155,155,19,2017,93563,-349,39,-310,1172,946
19155,155,19,2018,93445,-329,27,-302,1141,957
19155,155,19,2019,93405,-246,94,-152,1059,947
19155,155,19,2020,93328,-176,82,-94,1058,1042
19157,157,19,2010,18926,-15,8,-7,57,39
19157,157,19,2011,18900,-35,48,13,182,220
19157,157,19,2012,18734,-140,25,-115,182,237
19157,157,19,2013,18618,-86,38,-48,172,237
19157,157,19,2014,18624,20,47,67,176,234
19157,157,19,2015,18379,-243,36,-207,186,226
19157,157,19,2016,18297,-79,33,-46,167,203
19157,157,19,2017,18359,83,36,119,168,225
19157,157,19,2018,18461,105,17,122,183,203
19157,157,19,2019,18458,31,34,65,155,222
19157,157,19,2020,18381,-47,29,-18,161,221
19159,159,19,2010,5113,3,0,3,10,29
19159,159,19,2011,5048,-27,0,-27,55,94
19159,159,19,2012,5025,-2,1,-1,47,70
19159,159,19,2013,4971,-30,0,-30,53,77
19159,159,19,2014,4961,1,2,3,51,64
19159,159,19,2015,4978,41,4,45,57,86
19159,159,19,2016,4994,25,4,29,68,80
19159,159,19,2017,5029,49,4,53,59,77
19159,159,19,2018,4921,-75,2,-73,53,87
19159,159,19,2019,4866,-37,4,-33,48,71
19159,159,19,2020,4801,-49,3,-46,47,66
19161,161,19,2010,10355,10,0,10,35,38
19161,161,19,2011,10223,-81,0,-81,90,142
19161,161,19,2012,10161,-35,0,-35,109,135
19161,161,19,2013,10028,-94,0,-94,103,142
19161,161,19,2014,10046,36,0,36,133,149
19161,161,19,2015,9961,-48,0,-48,108,145
19161,161,19,2016,9804,-125,0,-125,103,136
19161,161,19,2017,9797,6,-1,5,125,135
19161,161,19,2018,9675,-66,-1,-67,93,149
19161,161,19,2019,9675,8,-1,7,119,126
19161,161,19,2020,9603,-59,-1,-60,108,119
19163,163,19,2010,165291,-185,36,-149,520,312
19163,163,19,2011,166686,450,196,646,2183,1431
19163,163,19,2012,168433,797,147,944,2242,1428
19163,163,19,2013,170321,824,313,1137,2214,1462
19163,163,19,2014,171457,-25,330,305,2300,1437
19163,163,19,2015,172072,-402,271,-131,2261,1497
19163,163,19,2016,172361,-722,258,-464,2234,1481
19163,163,19,2017,172691,-479,232,-247,2153,1570
19163,163,19,2018,173019,-312,105,-207,2126,1587
19163,163,19,2019,173400,-467,270,-197,2065,1491
19163,163,19,2020,173216,-884,219,-665,2046,1571
19165,165,19,2010,12179,10,0,10,30,33
19165,165,19,2011,11997,-145,2,-143,117,158
19165,165,19,2012,12032,32,10,42,125,131
19165,165,19,2013,11905,-144,11,-133,123,120
19165,165,19,2014,11886,8,13,21,117,154
19165,165,19,2015,11799,-52,0,-52,133,167
19165,165,19,2016,11662,-92,-1,-93,112,155
19165,165,19,2017,11584,-33,-2,-35,104,149
19165,165,19,2018,11564,33,-2,31,107,155
19165,165,19,2019,11479,-78,-2,-80,132,136
19165,165,19,2020,11430,-35,-2,-37,126,138
19167,167,19,2010,33755,-59,24,-35,138,53
19167,167,19,2011,34022,-73,66,-7,510,236
19167,167,19,2012,34289,-25,48,23,500,255
19167,167,19,2013,34511,-115,87,-28,525,273
19167,167,19,2014,34648,-210,82,-128,514,252
19167,167,19,2015,34764,-206,64,-142,504,246
19167,167,19,2016,34955,-96,58,-38,496,266
19167,167,19,2017,34784,-440,46,-394,487,267
19167,167,19,2018,34767,-276,22,-254,490,254
19167,167,19,2019,34950,-163,61,-102,494,211
19167,167,19,2020,35043,-195,49,-146,500,263
19169,169,19,2010,89661,-205,143,-62,258,86
19169,169,19,2011,91164,72,931,1003,991,493
19169,169,19,2012,92046,-175,605,430,902,437
19169,169,19,2013,93938,485,915,1400,955,477
19169,169,19,2014,95894,559,966,1525,955,535
19169,169,19,2015,96744,-252,722,470,893,504
19169,169,19,2016,97012,-832,744,-88,882,532
19169,169,19,2017,97335,-816,762,-54,928,558
19169,169,19,2018,96749,-1209,327,-882,837,554
19169,169,19,2019,97441,-356,719,363,874,551
19169,169,19,2020,98237,-41,566,525,826,564
19171,171,19,2010,17718,-42,1,-41,56,65
19171,171,19,2011,17613,-103,4,-99,212,217
19171,171,19,2012,17500,-143,2,-141,215,191
19171,171,19,2013,17432,-61,1,-60,200,205
19171,171,19,2014,17309,-157,4,-153,249,220
19171,171,19,2015,17214,-120,12,-108,230,216
19171,171,19,2016,17212,-49,20,-29,228,200
19171,171,19,2017,17040,-165,1,-164,206,214
19171,171,19,2018,16853,-168,10,-158,202,232
19171,171,19,2019,16904,-19,40,21,216,185
19171,171,19,2020,16801,-143,30,-113,200,188
19173,173,19,2010,6322,-8,3,-5,23,12
19173,173,19,2011,6301,-6,2,-4,70,88
19173,173,19,2012,6259,-53,1,-52,68,57
19173,173,19,2013,6227,-35,16,-19,84,96
19173,173,19,2014,6172,-67,16,-51,74,81
19173,173,19,2015,6243,53,7,60,86,74
19173,173,19,2016,6219,-42,9,-33,78,69
19173,173,19,2017,6113,-83,10,-73,61,93
19173,173,19,2018,6190,68,9,77,81,80
19173,173,19,2019,6188,-28,19,-9,69,63
19173,173,19,2020,6092,-106,16,-90,65,69
19175,175,19,2010,12513,-22,2,-20,50,52
19175,175,19,2011,12555,25,11,36,144,137
19175,175,19,2012,12585,54,6,60,120,150
19175,175,19,2013,12615,2,13,15,141,124
19175,175,19,2014,12625,24,15,39,147,177
19175,175,19,2015,12431,-170,7,-163,115,149
19175,175,19,2016,12366,-50,12,-38,131,158
19175,175,19,2017,12472,72,17,89,152,134
19175,175,19,2018,12297,-163,9,-154,140,161
19175,175,19,2019,12224,-81,15,-66,121,129
19175,175,19,2020,12157,-61,13,-48,121,139
19177,177,19,2010,7577,-13,0,-13,31,12
19177,177,19,2011,7512,-60,1,-59,83,88
19177,177,19,2012,7449,-65,0,-65,92,90
19177,177,19,2013,7434,-30,0,-30,99,83
19177,177,19,2014,7390,-34,0,-34,89,100
19177,177,19,2015,7297,-80,0,-80,78,91
19177,177,19,2016,7243,-46,0,-46,86,94
19177,177,19,2017,7155,-86,1,-85,91,93
19177,177,19,2018,7008,-153,0,-153,102,95
19177,177,19,2019,7044,49,1,50,85,99
19177,177,19,2020,7069,27,0,27,96,97
19179,179,19,2010,35679,-1,31,30,109,78
19179,179,19,2011,35484,-301,59,-242,450,403
19179,179,19,2012,35430,-124,67,-57,411,404
19179,179,19,2013,35506,-55,118,63,417,398
19179,179,19,2014,35421,-217,121,-96,441,427
19179,179,19,2015,35450,-64,101,37,439,443
19179,179,19,2016,35270,-365,139,-226,452,407
19179,179,19,2017,35043,-473,173,-300,474,401
19179,179,19,2018,35060,-106,97,-9,444,418
19179,179,19,2019,35151,-89,185,96,423,428
19179,179,19,2020,34985,-336,139,-197,435,405
19181,181,19,2010,46341,46,5,51,135,67
19181,181,19,2011,46654,153,31,184,517,386
19181,181,19,2012,46906,88,21,109,514,365
19181,181,19,2013,47369,264,28,292,552,376
19181,181,19,2014,47848,338,11,349,538,402
19181,181,19,2015,48486,483,10,493,535,390
19181,181,19,2016,49383,717,3,720,569,391
19181,181,19,2017,50087,605,3,608,587,491
19181,181,19,2018,51053,828,0,828,578,437
19181,181,19,2019,51548,329,8,337,585,426
19181,181,19,2020,52265,598,7,605,578,463
19183,183,19,2010,21687,-19,2,-17,73,70
19183,183,19,2011,21825,123,4,127,280,268
19183,183,19,2012,21910,49,0,49,267,227
19183,183,19,2013,21954,-45,8,-37,303,222
19183,183,19,2014,22040,4,20,24,308,242
19183,183,19,2015,22160,41,13,54,323,254
19183,183,19,2016,22147,-97,13,-84,297,225
19183,183,19,2017,22236,84,11,95,269,273
19183,183,19,2018,22095,-206,12,-194,298,245
19183,183,19,2019,22030,-156,44,-112,285,238
19183,183,19,2020,21992,-126,29,-97,285,226
19185,185,19,2010,6419,11,0,11,17,11
19185,185,19,2011,6337,-88,7,-81,85,86
19185,185,19,2012,6329,15,0,15,88,110
19185,185,19,2013,6384,35,0,35,100,79
19185,185,19,2014,6375,-21,0,-21,89,76
19185,185,19,2015,6359,-12,-1,-13,84,86
19185,185,19,2016,6438,77,1,78,84,82
19185,185,19,2017,6488,32,0,32,101,84
19185,185,19,2018,6376,-99,0,-99,77,91
19185,185,19,2019,6413,22,0,22,94,78
19185,185,19,2020,6415,4,1,5,90,92
19187,187,19,2010,37882,-133,3,-130,112,117
19187,187,19,2011,37754,-169,43,-126,443,444
19187,187,19,2012,37335,-424,35,-389,454,492
19187,187,19,2013,37344,-13,52,39,440,464
19187,187,19,2014,37085,-305,56,-249,421,432
19187,187,19,2015,37089,-67,71,4,454,452
19187,187,19,2016,36813,-348,65,-283,446,438
19187,187,19,2017,36650,-180,36,-144,434,452
19187,187,19,2018,36361,-366,27,-339,454,406
19187,187,19,2019,35982,-439,67,-372,428,435
19187,187,19,2020,35934,-94,58,-36,429,442
19189,189,19,2010,10845,-28,1,-27,35,39
19189,189,19,2011,10699,-125,5,-120,111,136
19189,189,19,2012,10608,-88,-1,-89,114,118
19189,189,19,2013,10440,-134,3,-131,107,146
19189,189,19,2014,10567,91,2,93,140,106
19189,189,19,2015,10612,58,9,67,115,137
19189,189,19,2016,10599,27,4,31,101,144
19189,189,19,2017,10582,-22,9,-13,112,116
19189,189,19,2018,10555,-31,14,-17,109,120
19189,189,19,2019,10357,-169,5,-164,97,129
19189,189,19,2020,10277,-56,7,-49,97,128
19191,191,19,2010,21076,0,-1,-1,47,24
19191,191,19,2011,21055,-14,10,-4,159,177
19191,191,19,2012,21048,-7,1,-6,180,179
19191,191,19,2013,20849,-164,3,-161,159,196
19191,191,19,2014,20708,-141,6,-135,174,181
19191,191,19,2015,20756,52,12,64,176,190
19191,191,19,2016,20432,-346,14,-332,168,163
19191,191,19,2017,20140,-281,14,-267,167,194
19191,191,19,2018,20026,-102,3,-99,193,209
19191,191,19,2019,19992,-67,18,-49,178,163
19191,191,19,2020,19862,-130,11,-119,187,198
19193,193,19,2010,102393,-41,76,35,434,237
19193,193,19,2011,102741,-463,217,-246,1502,907
19193,193,19,2012,102351,-1195,168,-1027,1564,946
19193,193,19,2013,102317,-839,220,-619,1510,932
19193,193,19,2014,102333,-832,207,-625,1553,915
19193,193,19,2015,102532,-512,161,-351,1545,992
19193,193,19,2016,102654,-646,174,-472,1504,908
19193,193,19,2017,102098,-1205,178,-1027,1485,1018
19193,193,19,2018,102415,-250,99,-151,1423,953
19193,193,19,2019,103132,22,244,266,1417,967
19193,193,19,2020,103138,-651,200,-451,1421,968
19195,195,19,2010,7582,-10,0,-10,17,16
19195,195,19,2011,7560,-11,1,-10,73,83
19195,195,19,2012,7495,-57,1,-56,82,93
19195,195,19,2013,7488,11,1,12,71,91
19195,195,19,2014,7558,69,2,71,82,83
19195,195,19,2015,7503,-41,1,-40,71,84
19195,195,19,2016,7470,-23,1,-22,85,96
19195,195,19,2017,7456,-12,1,-11,86,89
19195,195,19,2018,7416,-31,0,-31,74,83
19195,195,19,2019,7407,-21,1,-20,80,69
19195,195,19,2020,7359,-62,0,-62,80,66
19197,197,19,2010,13185,-33,7,-26,44,62
19197,197,19,2011,13032,-133,7,-126,139,167
19197,197,19,2012,13019,-26,4,-22,157,146
19197,197,19,2013,12982,-19,9,-10,128,152
19197,197,19,2014,12905,-87,16,-71,156,163
19197,197,19,2015,12843,-76,14,-62,160,161
19197,197,19,2016,12825,-38,21,-17,150,152
19197,197,19,2017,12758,-67,13,-54,169,182
19197,197,19,2018,12669,-67,11,-56,148,180
19197,197,19,2019,12551,-137,29,-108,157,168
19197,197,19,2020,12416,-140,23,-117,158,174
20001,001,20,2010,13363,-14,0,-14,31,26
20001,001,20,2011,13348,13,5,18,152,185
20001,001,20,2012,13304,-10,5,-5,155,191
20001,001,20,2013,13065,-188,8,-180,134,197
20001,001,20,2014,12889,-153,2,-151,158,188
20001,001,20,2015,12680,-184,23,-161,134,182
20001,001,20,2016,12667,-8,11,3,146,161
20001,001,20,2017,12545,-110,1,-109,147,160
20001,001,20,2018,12500,-33,1,-32,147,160
20001,001,20,2019,12404,-95,0,-95,156,155
20001,001,20,2020,12399,3,1,4,157,166
20003,003,20,2010,8105,-10,0,-10,25,14
20003,003,20,2011,8066,-41,-1,-42,100,96
20003,003,20,2012,7925,-124,-2,-126,98,117
20003,003,20,2013,7859,-68,-3,-71,92,86
20003,003,20,2014,7888,18,-2,16,99,85
20003,003,20,2015,7826,-65,0,-65,88,85
20003,003,20,2016,7828,5,0,5,99,102
20003,003,20,2017,7850,41,0,41,105,122
20003,003,20,2018,7858,10,0,10,107,109
20003,003,20,2019,7899,29,0,29,105,93
20003,003,20,2020,7949,55,0,55,102,106
20005,005,20,2010,16855,-51,0,-51,52,70
20005,005,20,2011,16756,-128,0,-128,215,186
20005,005,20,2012,16779,-5,2,-3,206,176
20005,005,20,2013,16697,-115,0,-115,198,167
20005,005,20,2014,16534,-223,3,-220,218,165
20005,005,20,2015,16429,-114,2,-112,198,190
20005,005,20,2016,16376,-47,5,-42,187,198
20005,005,20,2017,16319,-80,1,-79,200,179
20005,005,20,2018,16202,-131,3,-128,191,181
20005,005,20,2019,16138,-71,0,-71,172,165
20005,005,20,2020,16015,-123,-3,-126,180,178
20007,007,20,2010,4852,-20,0,-20,13,5
20007,007,20,2011,4922,48,0,48,79,57
20007,007,20,2012,4867,-57,1,-56,57,54
20007,007,20,2013,4909,46,1,47,64,72
20007,007,20,2014,4881,-37,0,-37,69,58
20007,007,20,2015,4824,-44,0,-44,54,70
20007,007,20,2016,4672,-149,1,-148,57,61
20007,007,20,2017,4569,-101,0,-101,60,63
20007,007,20,2018,4462,-91,2,-89,47,64
20007,007,20,2019,4458,-21,4,-17,59,47
20007,007,20,2020,4358,-102,3,-99,51,51
20009,009,20,2010,27675,-10,6,-4,82,72
20009,009,20,2011,27700,-17,-17,-34,388,328
20009,009,20,2012,27522,-220,-17,-237,369,310
20009,009,20,2013,27447,-179,10,-169,372,278
20009,009,20,2014,27339,-229,33,-196,371,283
20009,009,20,2015,27164,-214,11,-203,332,303
20009,009,20,2016,26904,-353,24,-329,357,289
20009,009,20,2017,26427,-498,6,-492,304,290
20009,009,20,2018,26120,-326,28,-298,308,318
20009,009,20,2019,25938,-237,32,-205,312,288
20009,009,20,2020,25658,-299,27,-272,309,317
20011,011,20,2010,15137,-14,0,-14,44,66
20011,011,20,2011,14945,-237,12,-225,216,183
20011,011,20,2012,14877,-100,16,-84,196,181
20011,011,20,2013,14835,-89,21,-68,206,180
20011,011,20,2014,14798,-98,28,-70,230,199
20011,011,20,2015,14734,-96,24,-72,209,201
20011,011,20,2016,14619,-136,16,-120,204,196
20011,011,20,2017,14604,-6,5,-1,189,202
20011,011,20,2018,14538,-77,8,-69,197,196
20011,011,20,2019,14499,-58,5,-53,194,178
20011,011,20,2020,14435,-102,3,-99,195,160
20013,013,20,2010,9967,-5,0,-5,29,42
20013,013,20,2011,9973,-9,0,-9,138,122
20013,013,20,2012,9869,-129,2,-127,152,131
20013,013,20,2013,9916,29,3,32,139,123
20013,013,20,2014,9789,-135,2,-133,140,135
20013,013,20,2015,9710,-80,3,-77,115,116
20013,013,20,2016,9639,-98,3,-95,117,94
20013,013,20,2017,9619,-9,3,-6,127,140
20013,013,20,2018,9592,0,4,4,122,153
20013,013,20,2019,9541,-60,3,-57,141,135
20013,013,20,2020,9482,-69,4,-65,134,128
20015,015,20,2010,65901,2,3,5,198,181
20015,015,20,2011,65854,-291,62,-229,782,603
20015,015,20,2012,65692,-357,42,-315,756,616
20015,015,20,2013,65706,-162,51,-111,754,634
20015,015,20,2014,65900,51,21,72,744,611
20015,015,20,2015,66293,220,43,263,754,620
20015,015,20,2016,66723,256,53,309,762,638
20015,015,20,2017,66916,83,19,102,743,650
20015,015,20,2018,66887,-162,36,-126,764,667
20015,015,20,2019,66932,-17,25,8,681,644
20015,015,20,2020,66992,46,17,63,690,693
20017,017,20,2010,2784,3,0,3,8,17
20017,017,20,2011,2768,9,0,9,17,41
20017,017,20,2012,2741,-17,0,-17,25,35
20017,017,20,2013,2688,-49,0,-49,26,31
20017,017,20,2014,2652,-26,0,-26,27,36
20017,017,20,2015,2654,4,0,4,30,33
20017,017,20,2016,2631,-12,1,-11,28,38
20017,017,20,2017,2652,25,1,26,28,34
20017,017,20,2018,2565,-60,2,-58,16,45
20017,017,20,2019,2585,16,1,17,25,22
20017,017,20,2020,2586,-7,2,-5,25,18
20019,019,20,2010,3649,0,0,0,4,23
20019,019,20,2011,3612,-17,0,-17,36,56
20019,019,20,2012,3562,-23,1,-22,33,61
20019,019,20,2013,3532,-26,0,-26,42,47
20019,019,20,2014,3460,-49,0,-49,36,60
20019,019,20,2015,3389,-55,0,-55,37,53
20019,019,20,2016,3361,1,0,1,33,62
20019,019,20,2017,3320,-20,0,-20,28,49
20019,019,20,2018,3287,-14,0,-14,32,50
20019,019,20,2019,3203,-72,0,-72,34,47
20019,019,20,2020,3230,46,0,46,33,51
20021,021,20,2010,21529,-32,-1,-33,48,94
20021,021,20,2011,21368,-129,-1,-130,243,274
20021,021,20,2012,21206,-155,0,-155,265,274
20021,021,20,2013,20915,-233,-4,-237,204,261
20021,021,20,2014,20785,-115,-3,-118,241,255
20021,021,20,2015,20552,-206,0,-206,239,268
20021,021,20,2016,20280,-297,14,-283,243,232
20021,021,20,2017,20151,-72,8,-64,191,255
20021,021,20,2018,20024,-42,11,-31,227,323
20021,021,20,2019,19948,-76,8,-68,242,251
20021,021,20,2020,19681,-220,6,-214,230,281
20023,023,20,2010,2715,-2,0,-2,6,15
20023,023,20,2011,2693,-12,1,-11,28,39
20023,023,20,2012,2668,-15,4,-11,32,45
20023,023,20,2013,2672,16,5,21,23,41
20023,023,20,2014,2687,5,4,9,28,21
20023,023,20,2015,2676,-18,3,-15,43,40
20023,023,20,2016,2665,-5,1,-4,35,41
20023,023,20,2017,2682,10,-2,8,35,25
20023,023,20,2018,2625,-39,-1,-40,26,43
20023,023,20,2019,2624,11,-2,9,21,32
20023,023,20,2020,2600,5,-1,4,22,49
20025,025,20,2010,2199,-12,0,-12,8,12
20025,025,20,2011,2121,-68,1,-67,26,37
20025,025,20,2012,2166,56,0,56,24,37
20025,025,20,2013,2179,10,-1,9,29,24
20025,025,20,2014,2115,-50,0,-50,18,34
20025,025,20,2015,2082,-13,0,-13,21,40
20025,025,20,2016,2068,-12,1,-11,27,30
20025,025,20,2017,1996,-61,1,-60,20,33
20025,025,20,2018,1995,4,1,5,22,28
20025,025,20,2019,2006,10,1,11,25,25
20025,025,20,2020,1963,-46,0,-46,24,20
20027,027,20,2010,8544,17,0,17,20,34
20027,027,20,2011,8526,-4,-1,-5,99,111
20027,027,20,2012,8499,-24,-1,-25,104,103
20027,027,20,2013,8384,-133,-1,-134,115,98
20027,027,20,2014,8298,-82,1,-81,105,113
20027,027,20,2015,8291,-11,2,-9,107,103
20027,027,20,2016,8106,-185,4,-181,106,112
20027,027,20,2017,8003,-92,-2,-94,88,97
20027,027,20,2018,8008,-10,0,-10,109,93
20027,027,20,2019,8009,24,-2,22,78,100
20027,027,20,2020,8025,37,1,38,88,109
20029,029,20,2010,9518,8,1,9,23,47
20029,029,20,2011,9420,-117,21,-96,129,131
20029,029,20,2012,9416,-11,18,7,118,131
20029,029,20,2013,9355,-71,11,-60,125,124
20029,029,20,2014,9332,-7,13,6,94,121
20029,029,20,2015,9192,-107,12,-95,113,159
20029,029,20,2016,9088,-98,8,-90,122,136
20029,029,20,2017,8922,-110,5,-105,98,159
20029,029,20,2018,8725,-168,6,-162,97,133
20029,029,20,2019,8779,79,5,84,104,133
20029,029,20,2020,8642,-112,5,-107,104,133
20031,031,20,2010,8585,9,0,9,24,45
20031,031,20,2011,8489,-82,1,-81,89,105
20031,031,20,2012,8470,-9,2,-7,86,96
20031,031,20,2013,8381,-68,3,-65,91,116
20031,031,20,2014,8398,11,-1,10,91,84
20031,031,20,2015,8294,-82,3,-79,77,101
20031,031,20,2016,8346,67,2,69,90,107
20031,031,20,2017,8231,-121,0,-121,83,76
20031,031,20,2018,8212,2,0,2,89,110
20031,031,20,2019,8142,-61,-1,-62,70,78
20031,031,20,2020,8158,35,0,35,69,88
20033,033,20,2010,1886,4,0,4,6,15
20033,033,20,2011,1884,4,0,4,28,34
20033,033,20,2012,1916,34,0,34,28,31
20033,033,20,2013,1928,24,0,24,20,31
20033,033,20,2014,1950,32,0,32,21,30
20033,033,20,2015,1828,-107,-1,-108,22,38
20033,033,20,2016,1844,27,0,27,21,33
20033,033,20,2017,1763,-66,0,-66,13,29
20033,033,20,2018,1740,-7,0,-7,17,31
20033,033,20,2019,1704,-30,0,-30,12,18
20033,033,20,2020,1690,-14,0,-14,14,15
20035,035,20,2010,36314,-59,12,-47,118,67
20035,035,20,2011,36259,-133,51,-82,480,452
20035,035,20,2012,36281,-29,41,12,452,439
20035,035,20,2013,36186,-152,49,-103,440,429
20035,035,20,2014,35918,-415,75,-340,479,417
20035,035,20,2015,35774,-212,61,-151,459,449
20035,035,20,2016,35662,-109,33,-76,413,449
20035,035,20,2017,35311,-341,0,-341,422,434
20035,035,20,2018,35067,-202,12,-190,378,431
20035,035,20,2019,34784,-256,6,-250,387,422
20035,035,20,2020,34628,-88,7,-81,372,447
20037,037,20,2010,39173,-15,15,0,120,78
20037,037,20,2011,39210,-112,113,1,482,445
20037,037,20,2012,39333,-14,84,70,498,435
20037,037,20,2013,39264,-260,112,-148,456,379
20037,037,20,2014,39291,-246,151,-95,530,409
20037,037,20,2015,39166,-368,165,-203,516,439
20037,037,20,2016,39082,-283,134,-149,492,428
20037,037,20,2017,38942,-201,46,-155,476,460
20037,037,20,2018,38884,-159,74,-85,458,432
20037,037,20,2019,38734,-262,54,-208,441,384
20037,037,20,2020,38730,-100,41,-59,434,380
20039,039,20,2010,2957,-8,0,-8,4,4
20039,039,20,2011,2927,4,0,4,31,65
20039,039,20,2012,2886,-12,0,-12,29,58
20039,039,20,2013,2911,28,1,29,44,47
20039,039,20,2014,2900,-8,3,-5,32,38
20039,039,20,2015,2927,26,3,29,36,38
20039,039,20,2016,2829,-85,8,-77,27,49
20039,039,20,2017,2866,51,2,53,35,52
20039,039,20,2018,2842,-12,5,-7,28,44
20039,039,20,2019,2816,-25,7,-18,30,38
20039,039,20,2020,2776,-35,6,-29,29,40
20041,041,20,2010,19771,1,1,2,64,40
20041,041,20,2011,19686,-119,10,-109,257,234
20041,041,20,2012,19708,71,9,80,208,261
20041,041,20,2013,19436,-249,8,-241,215,249
20041,041,20,2014,19311,-144,6,-138,226,217
20041,041,20,2015,19214,-99,5,-94,238,240
20041,041,20,2016,18971,-225,-1,-226,240,257
20041,041,20,2017,18829,-108,-1,-109,201,235
20041,041,20,2018,18621,-161,0,-161,199,245
20041,041,20,2019,18381,-216,0,-216,172,196
20041,041,20,2020,18266,-86,1,-85,179,208
20043,043,20,2010,7959,4,0,4,18,10
20043,043,20,2011,7961,-29,6,-23,94,68
20043,043,20,2012,7891,-78,5,-73,84,82
20043,043,20,2013,7876,-29,7,-22,83,76
20043,043,20,2014,7839,-35,2,-33,70,75
20043,043,20,2015,7789,-58,8,-50,82,82
20043,043,20,2016,7713,-79,0,-79,83,79
20043,043,20,2017,7655,-40,-1,-41,78,96
20043,043,20,2018,7632,5,-1,4,83,108
20043,043,20,2019,7584,-57,-1,-58,81,70
20043,043,20,2020,7496,-99,-3,-102,88,74
20045,045,20,2010,111204,110,95,205,290,119
20045,045,20,2011,112500,22,651,673,1228,606
20045,045,20,2012,113360,-445,630,185,1266,593
20045,045,20,2013,114779,273,657,930,1222,712
20045,045,20,2014,116540,560,642,1202,1226,663
20045,045,20,2015,118265,284,871,1155,1259,677
20045,045,20,2016,119876,301,751,1052,1269,710
20045,045,20,2017,120516,-38,287,249,1128,730
20045,045,20,2018,121327,61,438,499,1129,814
20045,045,20,2019,122269,291,260,551,1127,742
20045,045,20,2020,122530,-307,211,-96,1101,754
20047,047,20,2010,3055,8,0,8,11,2
20047,047,20,2011,3021,-43,-1,-44,40,31
20047,047,20,2012,2968,-35,3,-32,29,50
20047,047,20,2013,2969,-16,8,-8,40,31
20047,047,20,2014,3026,52,10,62,28,37
20047,047,20,2015,2955,-70,1,-69,33,36
20047,047,20,2016,2896,-51,2,-49,26,36
20047,047,20,2017,2871,-10,0,-10,30,44
20047,047,20,2018,2806,-47,-1,-48,27,44
20047,047,20,2019,2783,-21,0,-21,30,33
20047,047,20,2020,2750,-37,0,-37,30,25
20049,049,20,2010,2868,-8,0,-8,12,18
20049,049,20,2011,2786,-65,0,-65,25,42
20049,049,20,2012,2662,-109,0,-109,22,41
20049,049,20,2013,2634,2,0,2,25,55
20049,049,20,2014,2695,47,1,48,36,24
20049,049,20,2015,2572,-96,0,-96,21,51
20049,049,20,2016,2514,-51,1,-50,32,38
20049,049,20,2017,2511,7,0,7,31,41
20049,049,20,2018,2470,-11,1,-10,22,53
20049,049,20,2019,2507,48,0,48,24,34
20049,049,20,2020,2507,12,0,12,23,34
20051,051,20,2010,28424,-48,9,-39,89,81
20051,051,20,2011,28772,138,44,182,391,225
20051,051,20,2012,29100,100,59,159,402,233
20051,051,20,2013,29044,-229,57,-172,382,267
20051,051,20,2014,28983,-228,65,-163,354,254
20051,051,20,2015,29030,-172,107,-65,355,242
20051,051,20,2016,28946,-257,57,-200,360,245
20051,051,20,2017,28755,-295,58,-237,318,272
20051,051,20,2018,28709,-194,82,-112,309,245
20051,051,20,2019,28652,-168,47,-121,306,242
20051,051,20,2020,28671,-59,42,-17,296,261
20053,053,20,2010,6518,22,0,22,21,24
20053,053,20,2011,6467,-24,5,-19,55,86
20053,053,20,2012,6469,5,0,5,69,72
20053,053,20,2013,6372,-86,0,-86,64,75
20053,053,20,2014,6353,15,0,15,51,86
20053,053,20,2015,6311,-6,1,-5,65,102
20053,053,20,2016,6300,14,2,16,53,81
20053,053,20,2017,6295,21,1,22,63,90
20053,053,20,2018,6156,-101,3,-98,57,97
20053,053,20,2019,6093,-54,3,-51,54,65
20053,053,20,2020,6034,-36,4,-32,48,75
20055,055,20,2010,36951,7,33,40,198,70
20055,055,20,2011,37114,-554,142,-412,754,181
20055,055,20,2012,37106,-590,108,-482,672,209
20055,055,20,2013,37069,-691,160,-531,709,228
20055,055,20,2014,37105,-609,158,-451,684,209
20055,055,20,2015,37127,-681,173,-508,730,206
20055,055,20,2016,36827,-888,154,-734,669,239
20055,055,20,2017,36685,-606,40,-566,632,209
20055,055,20,2018,36473,-733,84,-649,650,214
20055,055,20,2019,36351,-582,79,-503,595,214
20055,055,20,2020,35917,-873,58,-815,608,223
20057,057,20,2010,34006,71,21,92,160,94
20057,057,20,2011,34371,-139,88,-51,664,248
20057,057,20,2012,34661,-310,108,-202,711,220
20057,057,20,2013,34872,-470,255,-215,668,246
20057,057,20,2014,34923,-771,364,-407,674,230
20057,057,20,2015,34617,-1072,319,-753,660,226
20057,057,20,2016,34446,-824,283,-541,618,251
20057,057,20,2017,34082,-851,71,-780,681,269
20057,057,20,2018,33623,-902,146,-756,527,233
20057,057,20,2019,33346,-780,133,-647,587,217
20057,057,20,2020,33094,-666,95,-571,562,240
20059,059,20,2010,25986,-1,2,1,84,90
20059,059,20,2011,25861,-246,16,-230,335,231
20059,059,20,2012,25836,-104,10,-94,322,250
20059,059,20,2013,25747,-165,9,-156,303,236
20059,059,20,2014,25551,-256,13,-243,315,272
20059,059,20,2015,25495,-163,27,-136,329,249
20059,059,20,2016,25546,9,20,29,303,279
20059,059,20,2017,25667,104,12,116,299,293
20059,059,20,2018,25681,-47,18,-29,317,274
20059,059,20,2019,25618,-126,10,-116,294,241
20059,059,20,2020,25703,43,9,52,293,262
20061,061,20,2010,35241,569,88,657,250,77
20061,061,20,2011,35309,-922,133,-789,1044,192
20061,061,20,2012,37946,1271,540,1811,966,206
20061,061,20,2013,36857,-2248,239,-2009,1079,215
20061,061,20,2014,36530,-1377,165,-1212,1062,199
20061,061,20,2015,36783,-929,283,-646,1091,198
20061,061,20,2016,35401,-2479,208,-2271,1093,214
20061,061,20,2017,33935,-2200,51,-2149,904,229
20061,061,20,2018,32998,-1599,-12,-1611,890,213
20061,061,20,2019,31992,-1767,38,-1729,901,170
20061,061,20,2020,32218,-489,39,-450,874,195
20063,063,20,2010,2692,-3,0,-3,5,12
20063,063,20,2011,2727,41,0,41,31,37
20063,063,20,2012,2762,29,0,29,38,31
20063,063,20,2013,2796,48,2,50,32,48
20063,063,20,2014,2749,-39,2,-37,29,40
20063,063,20,2015,2700,-56,2,-54,44,41
20063,063,20,2016,2621,-76,2,-74,35,40
20063,063,20,2017,2623,3,2,5,32,35
20063,063,20,2018,2612,-18,2,-16,32,27
20063,063,20,2019,2665,32,2,34,45,26
20063,063,20,2020,2621,-44,2,-42,41,43
20065,065,20,2010,2602,11,0,11,7,3
20065,065,20,2011,2635,39,0,39,25,32
20065,065,20,2012,2581,-51,2,-49,29,34
20065,065,20,2013,2588,10,4,14,25,32
20065,065,20,2014,2557,-40,8,-32,24,24
20065,065,20,2015,2591,41,4,45,26,39
20065,065,20,2016,2558,-14,4,-10,17,39
20065,065,20,2017,2485,-63,2,-61,25,38
20065,065,20,2018,2448,-20,3,-17,19,39
20065,065,20,2019,2441,7,1,8,23,37
20065,065,20,2020,2389,-35,2,-33,23,42
20067,067,20,2010,7825,-10,5,-5,26,21
20067,067,20,2011,7893,-5,5,0,127,59
20067,067,20,2012,7833,-134,0,-134,115,45
20067,067,20,2013,7843,-36,-14,-50,120,64
20067,067,20,2014,7784,-129,-14,-143,127,46
20067,067,20,2015,7719,-137,-3,-140,131,58
20067,067,20,2016,7660,-123,-6,-129,119,49
20067,067,20,2017,7476,-245,-8,-253,124,57
20067,067,20,2018,7271,-248,-3,-251,113,70
20067,067,20,2019,7136,-210,-8,-218,121,36
20067,067,20,2020,7077,-140,-5,-145,119,34
20069,069,20,2010,6026,6,0,6,25,6
20069,069,20,2011,6086,21,3,24,86,50
20069,069,20,2012,5963,-178,0,-178,89,40
20069,069,20,2013,5979,-21,3,-18,86,53
20069,069,20,2014,6060,27,11,38,90,46
20069,069,20,2015,6083,-39,25,-14,85,48
20069,069,20,2016,6043,-103,25,-78,92,55
20069,069,20,2017,6020,-54,11,-43,81,62
20069,069,20,2018,6085,13,12,25,85,46
20069,069,20,2019,5996,-131,15,-116,72,44
20069,069,20,2020,5954,-85,13,-72,75,45
20071,071,20,2010,1259,11,0,11,4,6
20071,071,20,2011,1255,-8,0,-8,15,10
20071,071,20,2012,1268,16,0,16,18,21
20071,071,20,2013,1283,6,1,7,23,16
20071,071,20,2014,1302,10,3,13,25,19
20071,071,20,2015,1302,6,4,10,16,25
20071,071,20,2016,1280,-22,4,-18,17,21
20071,071,20,2017,1227,-43,2,-41,14,26
20071,071,20,2018,1229,-5,3,-2,26,22
20071,071,20,2019,1211,-13,2,-11,12,18
20071,071,20,2020,1196,-19,1,-18,12,11
20073,073,20,2010,6680,-8,0,-8,8,8
20073,073,20,2011,6611,-29,0,-29,69,110
20073,073,20,2012,6427,-151,0,-151,59,95
20073,073,20,2013,6361,-19,0,-19,50,97
20073,073,20,2014,6290,-44,0,-44,74,100
20073,073,20,2015,6235,-30,0,-30,68,92
20073,073,20,2016,6104,-83,0,-83,59,107
20073,073,20,2017,6068,3,0,3,77,117
20073,073,20,2018,6008,-7,0,-7,50,102
20073,073,20,2019,6001,-1,0,-1,53,60
20073,073,20,2020,5868,-114,0,-114,54,71
20075,075,20,2010,2705,1,1,2,17,1
20075,075,20,2011,2634,-84,2,-82,45,35
20075,075,20,2012,2648,-10,5,-5,50,31
20075,075,20,2013,2616,-36,11,-25,25,33
20075,075,20,2014,2654,-20,39,19,43,24
20075,075,20,2015,2563,-127,19,-108,42,26
20075,075,20,2016,2628,32,20,52,35,23
20075,075,20,2017,2609,-36,7,-29,33,23
20075,075,20,2018,2584,-42,12,-30,28,22
20075,075,20,2019,2515,-94,14,-80,28,18
20075,075,20,2020,2425,-110,10,-100,27,15
20077,077,20,2010,6008,-5,1,-4,13,34
20077,077,20,2011,5938,-45,5,-40,68,98
20077,077,20,2012,5862,-54,1,-53,62,86
20077,077,20,2013,5844,-15,1,-14,83,86
20077,077,20,2014,5831,-24,4,-20,87,79
20077,077,20,2015,5785,-39,5,-34,79,92
20077,077,20,2016,5670,-92,1,-91,73,97
20077,077,20,2017,5581,-72,0,-72,65,81
20077,077,20,2018,5500,-43,0,-43,64,103
20077,077,20,2019,5442,-47,0,-47,67,79
20077,077,20,2020,5336,-75,0,-75,66,94
20079,079,20,2010,34740,20,9,29,97,66
20079,079,20,2011,34698,-137,30,-107,459,393
20079,079,20,2012,34769,9,20,29,421,379
20079,079,20,2013,34736,-129,50,-79,452,407
20079,079,20,2014,34621,-205,77,-128,430,419
20079,079,20,2015,34832,140,60,200,425,409
20079,079,20,2016,34777,-124,75,-49,399,404
20079,079,20,2017,34436,-345,32,-313,398,425
20079,079,20,2018,34225,-228,55,-173,358,397
20079,079,20,2019,34442,165,53,218,387,387
20079,079,20,2020,34291,-212,43,-169,385,367
20081,081,20,2010,4272,9,1,10,8,2
20081,081,20,2011,4235,-70,6,-64,56,30
20081,081,20,2012,4212,-62,5,-57,50,20
20081,081,20,2013,4124,-127,10,-117,51,25
20081,081,20,2014,4100,-61,1,-60,59,24
20081,081,20,2015,4087,-28,0,-28,51,36
20081,081,20,2016,4026,-91,6,-85,54,31
20081,081,20,2017,4019,-22,2,-20,45,30
20081,081,20,2018,3993,-63,6,-57,62,32
20081,081,20,2019,3987,-55,11,-44,59,20
20081,081,20,2020,3923,-108,6,-102,64,26
20083,083,20,2010,1920,-5,0,-5,10,3
20083,083,20,2011,1957,39,-1,38,19,20
20083,083,20,2012,1927,-34,-1,-35,21,17
20083,083,20,2013,1923,-26,10,-16,28,17
20083,083,20,2014,1882,-53,4,-49,21,15
20083,083,20,2015,1868,-28,15,-13,24,25
20083,083,20,2016,1841,-32,8,-24,18,21
20083,083,20,2017,1858,14,5,19,21,24
20083,083,20,2018,1799,-50,6,-44,13,27
20083,083,20,2019,1763,-30,5,-25,13,24
20083,083,20,2020,1779,28,6,34,13,31
20085,085,20,2010,13461,15,1,16,35,48
20085,085,20,2011,13429,-79,3,-76,160,117
20085,085,20,2012,13402,-69,-3,-72,167,125
20085,085,20,2013,13312,-133,-1,-134,172,131
20085,085,20,2014,13441,100,0,100,156,125
20085,085,20,2015,13286,-183,1,-182,168,143
20085,085,20,2016,13274,-48,7,-41,166,137
20085,085,20,2017,13347,22,2,24,193,143
20085,085,20,2018,13288,-73,4,-69,168,158
20085,085,20,2019,13164,-150,2,-148,168,143
20085,085,20,2020,13171,-17,1,-16,164,142
20087,087,20,2010,19120,11,0,11,54,50
20087,087,20,2011,18941,-185,0,-185,192,188
20087,087,20,2012,18858,-74,1,-73,176,188
20087,087,20,2013,18767,-103,0,-103,187,175
20087,087,20,2014,18798,14,1,15,201,185
20087,087,20,2015,18789,22,0,22,158,186
20087,087,20,2016,18838,21,0,21,207,178
20087,087,20,2017,18935,105,0,105,188,195
20087,087,20,2018,18901,-10,0,-10,186,208
20087,087,20,2019,19165,227,0,227,185,147
20087,087,20,2020,19032,-171,0,-171,194,156
20089,089,20,2010,3063,-2,0,-2,5,12
20089,089,20,2011,3091,44,1,45,29,48
20089,089,20,2012,3055,-16,0,-16,24,43
20089,089,20,2013,3061,22,0,22,23,39
20089,089,20,2014,3044,-8,0,-8,38,47
20089,089,20,2015,2964,-59,0,-59,22,44
20089,089,20,2016,2890,-83,0,-83,41,32
20089,089,20,2017,2858,-31,0,-31,31,31
20089,089,20,2018,2832,-10,0,-10,30,46
20089,089,20,2019,2858,43,0,43,19,36
20089,089,20,2020,2833,-10,0,-10,25,40
20091,091,20,2010,545681,239,170,409,1924,780
20091,091,20,2011,553034,2071,1302,3373,7402,3410
20091,091,20,2012,559647,1848,1059,2907,7259,3472
20091,091,20,2013,566661,2326,1097,3423,7370,3729
20091,091,20,2014,573322,1606,1247,2853,7451,3552
20091,091,20,2015,580158,1146,2137,3283,7511,3893
20091,091,20,2016,586601,846,1941,2787,7382,3698
20091,091,20,2017,592055,1581,630,2211,7223,3952
20091,091,20,2018,599045,2640,1111,3751,7284,4031
20091,091,20,2019,602948,362,609,971,7099,4181
20091,091,20,2020,607220,1139,515,1654,7020,4438
20093,093,20,2010,4001,7,3,10,13,4
20093,093,20,2011,3960,-58,4,-54,59,47
20093,093,20,2012,3974,-31,6,-25,73,35
20093,093,20,2013,3913,-75,10,-65,51,47
20093,093,20,2014,3940,-11,15,4,66,45
20093,093,20,2015,3936,-37,9,-28,58,34
20093,093,20,2016,3896,-78,9,-69,60,32
20093,093,20,2017,3939,9,-2,7,72,36
20093,093,20,2018,3926,-45,-2,-47,59,25
20093,093,20,2019,3807,-148,-2,-150,61,30
20093,093,20,2020,3745,-93,0,-93,56,25
20095,095,20,2010,7857,-7,1,-6,16,12
20095,095,20,2011,7891,32,5,37,86,87
20095,095,20,2012,7827,-35,-2,-37,70,98
20095,095,20,2013,7803,17,-3,14,73,109
20095,095,20,2014,7687,-129,-1,-130,97,87
20095,095,20,2015,7639,-13,-1,-14,91,124
20095,095,20,2016,7407,-179,-1,-180,68,122
20095,095,20,2017,7278,-33,0,-33,76,172
20095,095,20,2018,7148,29,0,29,58,217
20095,095,20,2019,7056,-34,0,-34,79,138
20095,095,20,2020,6974,-53,0,-53,65,94
20097,097,20,2010,2569,12,0,12,6,3
20097,097,20,2011,2558,-25,3,-22,38,26
20097,097,20,2012,2512,-50,3,-47,28,28
20097,097,20,2013,2533,7,2,9,39,27
20097,097,20,2014,2530,-6,6,0,29,34
20097,097,20,2015,2568,21,3,24,36,22
20097,097,20,2016,2509,-82,3,-79,39,20
20097,097,20,2017,2488,-28,2,-26,32,27
20097,097,20,2018,2490,-5,4,-1,33,30
20097,097,20,2019,2470,-32,3,-29,42,32
20097,097,20,2020,2456,-30,1,-29,38,24
20099,099,20,2010,21536,-64,2,-62,65,81
20099,099,20,2011,21380,-138,12,-126,254,282
20099,099,20,2012,21165,-229,7,-222,273,272
20099,099,20,2013,20875,-303,-2,-305,287,276
20099,099,20,2014,20779,-110,-1,-111,271,256
20099,099,20,2015,20640,-154,4,-150,270,259
20099,099,20,2016,20323,-306,4,-302,271,287
20099,099,20,2017,20146,-202,2,-200,282,259
20099,099,20,2018,19929,-205,5,-200,254,272
20099,099,20,2019,19704,-271,0,-271,266,219
20099,099,20,2020,19586,-133,1,-132,250,235
20101,101,20,2010,1736,-8,0,-8,3,8
20101,101,20,2011,1743,14,0,14,22,28
20101,101,20,2012,1682,-56,0,-56,20,26
20101,101,20,2013,1698,16,0,16,22,22
20101,101,20,2014,1666,-34,0,-34,23,22
20101,101,20,2015,1630,-25,0,-25,18,28
20101,101,20,2016,1596,-20,1,-19,16,32
20101,101,20,2017,1549,-35,0,-35,16,28
20101,101,20,2018,1535,12,0,12,14,39
20101,101,20,2019,1527,-12,0,-12,21,18
20101,101,20,2020,1518,-9,0,-9,18,17
20103,103,20,2010,76536,154,44,198,234,115
20103,103,20,2011,77116,148,75,223,945,585
20103,103,20,2012,77708,-96,268,172,978,543
20103,103,20,2013,78177,-43,167,124,936,580
20103,103,20,2014,78678,-59,145,86,963,540
20103,103,20,2015,79269,-77,256,179,1010,591
20103,103,20,2016,80422,601,129,730,1041,619
20103,103,20,2017,81259,513,35,548,943,652
20103,103,20,2018,81659,12,38,50,965,615
20103,103,20,2019,81911,-112,-11,-123,1010,637
20103,103,20,2020,82246,18,14,32,991,694
20105,105,20,2010,3241,-2,0,-2,9,2
20105,105,20,2011,3232,-3,3,0,36,46
20105,105,20,2012,3179,-53,2,-51,40,44
20105,105,20,2013,3159,-15,2,-13,27,34
20105,105,20,2014,3182,28,2,30,27,32
20105,105,20,2015,3141,-47,0,-47,37,34
20105,105,20,2016,3075,-54,0,-54,31,43
20105,105,20,2017,3044,-29,0,-29,31,34
20105,105,20,2018,2994,-37,0,-37,25,37
20105,105,20,2019,2964,-22,0,-22,24,31
20105,105,20,2020,2986,38,0,38,24,41
20107,107,20,2010,9624,-15,0,-15,23,39
20107,107,20,2011,9610,-2,1,-1,94,107
20107,107,20,2012,9481,-115,0,-115,103,119
20107,107,20,2013,9538,97,1,98,77,117
20107,107,20,2014,9532,-6,1,-5,114,115
20107,107,20,2015,9574,46,0,46,97,101
20107,107,20,2016,9604,31,1,32,103,105
20107,107,20,2017,9694,108,0,108,110,128
20107,107,20,2018,9771,96,1,97,99,119
20107,107,20,2019,9714,-48,0,-48,94,103
20107,107,20,2020,9654,-27,0,-27,94,128
20109,109,20,2010,2774,9,1,10,12,8
20109,109,20,2011,2766,-5,5,0,32,40
20109,109,20,2012,2794,28,1,29,31,32
20109,109,20,2013,2775,-14,0,-14,33,37
20109,109,20,2014,2767,5,0,5,36,49
20109,109,20,2015,2785,23,1,24,37,43
20109,109,20,2016,2821,7,0,7,51,22
20109,109,20,2017,2812,-14,1,-13,41,36
20109,109,20,2018,2804,-19,1,-18,47,36
20109,109,20,2019,2776,-43,1,-42,47,33
20109,109,20,2020,2732,-72,1,-71,46,19
20111,111,20,2010,33647,-138,21,-117,109,45
20111,111,20,2011,33651,-208,106,-102,417,311
20111,111,20,2012,33544,-365,109,-256,418,278
20111,111,20,2013,33478,-310,87,-223,434,280
20111,111,20,2014,33148,-564,105,-459,413,294
20111,111,20,2015,33142,-248,126,-122,398,283
20111,111,20,2016,33367,18,85,103,415,290
20111,111,20,2017,33246,-289,13,-276,407,255
20111,111,20,2018,33302,-60,36,-24,409,329
20111,111,20,2019,33224,-230,24,-206,396,269
20111,111,20,2020,33045,-302,20,-282,401,299
20113,113,20,2010,29128,-36,5,-31,75,101
20113,113,20,2011,29158,34,22,56,320,345
20113,113,20,2012,29226,85,13,98,340,364
20113,113,20,2013,29424,202,16,218,366,384
20113,113,20,2014,28908,-438,5,-433,317,411
20113,113,20,2015,28667,-238,17,-221,347,367
20113,113,20,2016,28466,-179,14,-165,332,369
20113,113,20,2017,28722,315,8,323,308,374
20113,113,20,2018,28565,-80,12,-68,316,403
20113,113,20,2019,28584,53,4,57,286,325
20113,113,20,2020,28448,-76,2,-74,294,356
20115,115,20,2010,12671,-4,0,-4,34,18
20115,115,20,2011,12546,-76,5,-71,119,172
20115,115,20,2012,12378,-116,9,-107,109,174
20115,115,20,2013,12206,-144,10,-134,110,151
20115,115,20,2014,12188,22,9,31,120,168
20115,115,20,2015,12054,-69,12,-57,116,191
20115,115,20,2016,12008,12,8,20,103,170
20115,115,20,2017,11950,-7,4,-3,121,174
20115,115,20,2018,11885,-33,5,-28,115,152
20115,115,20,2019,11831,-25,5,-20,115,149
20115,115,20,2020,11652,-140,6,-134,108,151
20117,117,20,2010,10112,-12,1,-11,29,24
20117,117,20,2011,9985,-101,3,-98,107,135
20117,117,20,2012,10027,36,2,38,128,123
20117,117,20,2013,9975,-33,3,-30,118,137
20117,117,20,2014,9947,-33,2,-31,130,127
20117,117,20,2015,9848,-96,4,-92,121,128
20117,117,20,2016,9805,-76,10,-66,132,109
20117,117,20,2017,9697,-75,2,-73,112,145
20117,117,20,2018,9718,38,4,42,125,146
20117,117,20,2019,9691,-23,4,-19,112,119
20117,117,20,2020,9652,-47,3,-44,114,110
20119,119,20,2010,4596,17,0,17,9,4
20119,119,20,2011,4519,-82,2,-80,52,50
20119,119,20,2012,4378,-151,0,-151,61,56
20119,119,20,2013,4284,-127,11,-116,60,41
20119,119,20,2014,4355,49,21,70,58,56
20119,119,20,2015,4298,-85,8,-77,63,45
20119,119,20,2016,4230,-86,8,-78,57,47
20119,119,20,2017,4226,3,2,5,52,61
20119,119,20,2018,4091,-138,3,-135,59,60
20119,119,20,2019,4023,-84,5,-79,46,36
20119,119,20,2020,4029,-14,5,-9,53,38
20121,121,20,2010,32882,40,0,40,111,46
20121,121,20,2011,32743,-201,-4,-205,344,280
20121,121,20,2012,32681,-221,0,-221,385,236
20121,121,20,2013,32850,88,9,97,333,258
20121,121,20,2014,32889,-71,9,-62,368,269
20121,121,20,2015,32782,-144,21,-123,347,331
20121,121,20,2016,32960,107,24,131,361,312
20121,121,20,2017,33450,419,3,422,366,297
20121,121,20,2018,33714,211,8,219,383,335
20121,121,20,2019,34244,418,3,421,372,262
20121,121,20,2020,34334,35,1,36,374,320
20123,123,20,2010,6336,-19,0,-19,10,29
20123,123,20,2011,6284,-41,0,-41,81,91
20123,123,20,2012,6302,35,3,38,71,93
20123,123,20,2013,6309,13,9,22,82,95
20123,123,20,2014,6248,-64,10,-54,77,86
20123,123,20,2015,6295,15,11,26,93,73
20123,123,20,2016,6193,-84,0,-84,70,89
20123,123,20,2017,6132,-44,0,-44,73,90
20123,123,20,2018,6096,-43,1,-42,85,79
20123,123,20,2019,5967,-106,0,-106,71,94
20123,123,20,2020,5879,-56,1,-55,72,104
20125,125,20,2010,35353,-105,7,-98,116,136
20125,125,20,2011,34790,-583,46,-537,424,452
20125,125,20,2012,34483,-424,41,-383,513,446
20125,125,20,2013,34458,-102,61,-41,452,433
20125,125,20,2014,34109,-448,78,-370,428,417
20125,125,20,2015,33458,-756,85,-671,451,439
20125,125,20,2016,32850,-620,70,-550,409,470
20125,125,20,2017,32382,-438,41,-397,383,453
20125,125,20,2018,32040,-283,58,-225,349,466
20125,125,20,2019,31796,-246,42,-204,357,400
20125,125,20,2020,31502,-302,37,-265,344,371
20127,127,20,2010,5918,-9,0,-9,11,6
20127,127,20,2011,5864,-22,0,-22,55,87
20127,127,20,2012,5849,0,3,3,66,83
20127,127,20,2013,5720,-137,2,-135,76,73
20127,127,20,2014,5665,-40,3,-37,46,66
20127,127,20,2015,5630,-23,9,-14,67,87
20127,127,20,2016,5553,-57,16,-41,49,85
20127,127,20,2017,5471,-82,6,-76,71,77
20127,127,20,2018,5551,75,8,83,71,73
20127,127,20,2019,5623,65,5,70,65,62
20127,127,20,2020,5559,-63,5,-58,66,73
20129,129,20,2010,3241,-8,3,-5,15,2
20129,129,20,2011,3176,-57,5,-52,36,50
20129,129,20,2012,3126,-56,-3,-59,40,32
20129,129,20,2013,3114,-34,-4,-38,55,30
20129,129,20,2014,3039,-61,-4,-65,28,39
20129,129,20,2015,2950,-73,2,-71,26,46
20129,129,20,2016,2802,-151,4,-147,37,37
20129,129,20,2017,2743,-52,1,-51,27,35
20129,129,20,2018,2662,-90,4,-86,36,32
20129,129,20,2019,2536,-122,0,-122,21,24
20129,129,20,2020,2538,5,1,6,20,25
20131,131,20,2010,10159,-14,0,-14,39,44
20131,131,20,2011,10087,-60,1,-59,125,137
20131,131,20,2012,10070,8,1,9,112,137
20131,131,20,2013,10097,9,2,11,156,137
20131,131,20,2014,10092,-13,5,-8,142,136
20131,131,20,2015,10099,-17,8,-9,147,131
20131,131,20,2016,10102,-51,6,-45,149,101
20131,131,20,2017,10063,-41,0,-41,138,137
20131,131,20,2018,10085,9,0,9,150,136
20131,131,20,2019,10170,41,0,41,151,106
20131,131,20,2020,10121,-101,0,-101,146,94
20133,133,20,2010,16476,-32,4,-28,53,61
20133,133,20,2011,16454,-54,29,-25,226,223
20133,133,20,2012,16425,-78,24,-54,219,195
20133,133,20,2013,16390,-81,10,-71,230,194
20133,133,20,2014,16332,-73,5,-68,214,201
20133,133,20,2015,16291,-82,38,-44,206,203
20133,133,20,2016,16131,-216,51,-165,205,198
20133,133,20,2017,16098,-64,31,-33,199,200
20133,133,20,2018,15984,-124,41,-83,176,208
20133,133,20,2019,15899,-88,33,-55,164,193
20133,133,20,2020,15929,27,24,51,161,184
20135,135,20,2010,3103,3,0,3,9,15
20135,135,20,2011,3118,24,0,24,30,39
20135,135,20,2012,3077,-27,0,-27,35,47
20135,135,20,2013,3087,-7,11,4,39,33
20135,135,20,2014,3090,4,16,20,34,51
20135,135,20,2015,3022,-65,9,-56,38,50
20135,135,20,2016,2966,-50,11,-39,37,53
20135,135,20,2017,2864,-84,3,-81,19,41
20135,135,20,2018,2811,-41,12,-29,27,51
20135,135,20,2019,2782,-42,14,-28,35,36
20135,135,20,2020,2768,-23,13,-10,35,38
20137,137,20,2010,5664,5,0,5,10,20
20137,137,20,2011,5656,9,-1,8,47,61
20137,137,20,2012,5589,-66,-1,-67,44,46
20137,137,20,2013,5617,37,2,39,61,70
20137,137,20,2014,5536,-84,3,-81,54,56
20137,137,20,2015,5538,19,1,20,52,69
20137,137,20,2016,5504,-44,7,-37,68,66
20137,137,20,2017,5432,-62,5,-57,55,70
20137,137,20,2018,5443,0,6,6,53,49
20137,137,20,2019,5372,-66,4,-62,56,63
20137,137,20,2020,5328,-36,3,-33,56,68
20139,139,20,2010,16274,-10,0,-10,46,55
20139,139,20,2011,16342,50,2,52,183,166
20139,139,20,2012,16179,-157,5,-152,157,171
20139,139,20,2013,16084,-64,2,-62,157,188
20139,139,20,2014,15973,-91,4,-87,170,194
20139,139,20,2015,15867,-52,5,-47,156,215
20139,139,20,2016,15836,-27,4,-23,191,199
20139,139,20,2017,15842,34,0,34,156,182
20139,139,20,2018,15921,124,0,124,160,204
20139,139,20,2019,15906,6,-1,5,170,191
20139,139,20,2020,15770,-72,0,-72,166,230
20141,141,20,2010,3850,-18,0,-18,12,6
20141,141,20,2011,3833,-5,3,-2,38,53
20141,141,20,2012,3810,-9,3,-6,41,57
20141,141,20,2013,3800,7,7,14,42,67
20141,141,20,2014,3752,-43,4,-39,53,60
20141,141,20,2015,3641,-79,3,-76,39,75
20141,141,20,2016,3598,-29,3,-26,56,72
20141,141,20,2017,3539,-35,1,-34,34,58
20141,141,20,2018,3456,-60,0,-60,41,63
20141,141,20,2019,3438,-27,0,-27,44,36
20141,141,20,2020,3439,0,1,1,41,40
20143,143,20,2010,6097,-8,0,-8,20,6
20143,143,20,2011,6063,-26,2,-24,67,76
20143,143,20,2012,6027,-4,0,-4,52,85
20143,143,20,2013,6040,5,3,8,62,56
20143,143,20,2014,6027,-10,4,-6,49,55
20143,143,20,2015,5932,-90,1,-89,64,71
20143,143,20,2016,5898,-7,2,-5,56,85
20143,143,20,2017,5813,-62,0,-62,51,72
20143,143,20,2018,5744,-39,0,-39,50,81
20143,143,20,2019,5713,-41,0,-41,60,50
20143,143,20,2020,5712,7,0,7,59,66
20145,145,20,2010,6979,-1,0,-1,14,4
20145,145,20,2011,6977,16,-1,15,70,87
20145,145,20,2012,6865,-111,-1,-112,75,77
20145,145,20,2013,6863,11,-1,10,58,69
20145,145,20,2014,6823,-12,-2,-14,61,85
20145,145,20,2015,6772,-34,-3,-37,69,83
20145,145,20,2016,6716,-32,0,-32,59,83
20145,145,20,2017,6673,-42,-1,-43,85,85
20145,145,20,2018,6554,-78,-2,-80,63,102
20145,145,20,2019,6384,-150,-2,-152,50,68
20145,145,20,2020,6366,11,0,11,51,81
20147,147,20,2010,5632,-5,0,-5,7,10
20147,147,20,2011,5540,-62,1,-61,62,93
20147,147,20,2012,5520,-11,1,-10,59,69
20147,147,20,2013,5559,30,0,30,71,63
20147,147,20,2014,5494,-54,1,-53,70,82
20147,147,20,2015,5419,-77,4,-73,64,65
20147,147,20,2016,5402,1,5,6,55,78
20147,147,20,2017,5379,-6,1,-5,54,73
20147,147,20,2018,5274,-86,2,-84,50,71
20147,147,20,2019,5248,-31,1,-30,70,67
20147,147,20,2020,5181,-62,1,-61,61,66
20149,149,20,2010,21729,43,4,47,87,15
20149,149,20,2011,22033,37,28,65,380,139
20149,149,20,2012,22339,95,21,116,357,164
20149,149,20,2013,22586,66,7,73,350,174
20149,149,20,2014,22755,-3,8,5,358,190
20149,149,20,2015,23145,211,22,233,344,186
20149,149,20,2016,23646,278,13,291,396,186
20149,149,20,2017,23938,124,3,127,358,193
20149,149,20,2018,24243,96,5,101,385,178
20149,149,20,2019,24468,24,1,25,365,165
20149,149,20,2020,24722,88,3,91,371,210
20151,151,20,2010,9641,-22,0,-22,27,17
20151,151,20,2011,9644,-9,4,-5,138,129
20151,151,20,2012,9760,79,2,81,143,109
20151,151,20,2013,9780,7,4,11,147,138
20151,151,20,2014,9769,-27,14,-13,132,128
20151,151,20,2015,9695,-113,9,-104,140,110
20151,151,20,2016,9558,-160,6,-154,143,126
20151,151,20,2017,9493,-66,2,-64,107,108
20151,151,20,2018,9326,-172,4,-168,117,117
20151,151,20,2019,9114,-202,1,-201,107,117
20151,151,20,2020,9127,-9,3,-6,111,91
20153,153,20,2010,2496,-9,0,-9,6,20
20153,153,20,2011,2508,21,2,23,18,30
20153,153,20,2012,2509,4,4,8,24,30
20153,153,20,2013,2563,64,3,67,29,43
20153,153,20,2014,2543,-6,6,0,23,43
20153,153,20,2015,2504,-35,3,-32,34,40
20153,153,20,2016,2494,0,4,4,29,43
20153,153,20,2017,2471,-14,2,-12,32,43
20153,153,20,2018,2483,4,3,7,42,38
20153,153,20,2019,2493,5,4,9,33,31
20153,153,20,2020,2511,1,3,4,37,23
20155,155,20,2010,64552,44,3,47,200,199
20155,155,20,2011,64432,-130,1,-129,720,709
20155,155,20,2012,64210,-227,-9,-236,771,754
20155,155,20,2013,64090,-99,0,-99,750,761
20155,155,20,2014,63716,-339,28,-311,729,789
20155,155,20,2015,63612,-143,74,-69,710,739
20155,155,20,2016,63230,-409,82,-327,691,746
20155,155,20,2017,62756,-502,26,-476,731,728
20155,155,20,2018,62363,-306,43,-263,644,773
20155,155,20,2019,61963,-368,30,-338,623,687
20155,155,20,2020,61793,-59,19,-40,620,749
20157,157,20,2010,4938,-14,0,-14,3,30
20157,157,20,2011,4892,0,0,0,47,93
20157,157,20,2012,4826,-14,2,-12,41,94
20157,157,20,2013,4767,-31,2,-29,50,80
20157,157,20,2014,4741,14,8,22,53,101
20157,157,20,2015,4688,-14,7,-7,48,95
20157,157,20,2016,4660,-15,5,-10,48,66
20157,157,20,2017,4655,53,2,55,47,106
20157,157,20,2018,4623,-5,2,-3,55,84
20157,157,20,2019,4563,-41,3,-38,44,66
20157,157,20,2020,4536,-8,4,-4,41,65
20159,159,20,2010,10116,17,1,18,30,13
20159,159,20,2011,10096,-26,8,-18,123,124
20159,159,20,2012,9988,-99,11,-88,110,133
20159,159,20,2013,9974,-20,17,-3,121,130
20159,159,20,2014,9972,3,14,17,128,146
20159,159,20,2015,9926,-79,13,-66,133,114
20159,159,20,2016,9773,-155,5,-150,116,119
20159,159,20,2017,9559,-199,4,-195,114,133
20159,159,20,2018,9453,-85,5,-80,105,131
20159,159,20,2019,9512,39,4,43,111,94
20159,159,20,2020,9362,-162,3,-159,108,98
20161,161,20,2010,71557,57,169,226,282,91
20161,161,20,2011,73449,579,534,1113,1103,334
20161,161,20,2012,77545,1989,1160,3149,1140,322
20161,161,20,2013,76996,-2086,714,-1372,1094,302
20161,161,20,2014,76570,-1993,770,-1223,1075,319
20161,161,20,2015,77293,-1129,1180,51,1011,353
20161,161,20,2016,75374,-3469,848,-2621,1033,354
20161,161,20,2017,74129,-2092,274,-1818,936,381
20161,161,20,2018,74826,-41,282,241,870,414
20161,161,20,2019,72762,-2829,255,-2574,870,365
20161,161,20,2020,73202,-230,203,-27,852,389
20163,163,20,2010,5196,-2,0,-2,23,5
20163,163,20,2011,5201,12,2,14,59,68
20163,163,20,2012,5221,13,1,14,63,57
20163,163,20,2013,5195,-23,3,-20,60,67
20163,163,20,2014,5203,0,2,2,70,63
20163,163,20,2015,5179,-6,2,-4,48,67
20163,163,20,2016,5118,-56,0,-56,63,67
20163,163,20,2017,5055,-64,0,-64,63,62
20163,163,20,2018,4989,-51,0,-51,60,75
20163,163,20,2019,4937,-50,0,-50,66,68
20163,163,20,2020,4827,-90,0,-90,64,82
20165,165,20,2010,3314,16,1,17,8,20
20165,165,20,2011,3211,-81,1,-80,26,48
20165,165,20,2012,3208,21,1,22,28,52
20165,165,20,2013,3175,-11,0,-11,26,47
20165,165,20,2014,3160,15,0,15,26,56
20165,165,20,2015,3097,-49,0,-49,30,44
20165,165,20,2016,3052,-16,0,-16,36,65
20165,165,20,2017,3049,19,0,19,44,65
20165,165,20,2018,3037,22,0,22,23,58
20165,165,20,2019,2994,-16,0,-16,20,47
20165,165,20,2020,2947,-38,0,-38,21,29
20167,167,20,2010,7000,17,0,17,29,14
20167,167,20,2011,6985,7,0,7,82,105
20167,167,20,2012,6989,11,-1,10,86,91
20167,167,20,2013,6977,-7,-3,-10,88,89
20167,167,20,2014,7008,47,-4,43,79,91
20167,167,20,2015,7045,41,-5,36,92,89
20167,167,20,2016,6997,-38,-7,-45,68,70
20167,167,20,2017,6928,-51,-8,-59,85,95
20167,167,20,2018,6885,11,-8,3,71,117
20167,167,20,2019,6868,-18,-9,-27,89,80
20167,167,20,2020,6804,-41,-6,-47,81,98
20169,169,20,2010,55781,46,21,67,205,89
20169,169,20,2011,55785,-268,36,-232,789,553
20169,169,20,2012,55841,-211,31,-180,773,532
20169,169,20,2013,55765,-356,42,-314,772,530
20169,169,20,2014,55540,-426,33,-393,743,575
20169,169,20,2015,55463,-333,19,-314,766,526
20169,169,20,2016,54975,-657,18,-639,687,538
20169,169,20,2017,54529,-576,-17,-593,697,550
20169,169,20,2018,54351,-225,-2,-227,661,611
20169,169,20,2019,54140,-334,-6,-340,637,508
20169,169,20,2020,53926,-317,2,-315,627,526
20171,171,20,2010,4959,14,11,25,12,14
20171,171,20,2011,4892,-79,17,-62,62,66
20171,171,20,2012,4856,-40,-3,-43,66,60
20171,171,20,2013,4908,51,2,53,58,59
20171,171,20,2014,4968,35,0,35,77,51
20171,171,20,2015,4950,-46,0,-46,64,35
20171,171,20,2016,4976,21,2,23,51,49
20171,171,20,2017,4931,-40,-4,-44,55,55
20171,171,20,2018,4918,-33,-4,-37,70,47
20171,171,20,2019,4850,-74,-4,-78,62,51
20171,171,20,2020,4790,-61,-3,-64,66,63
20173,173,20,2010,499138,-327,136,-191,2024,1023
20173,173,20,2011,501051,-2861,858,-2003,7969,4057
20173,173,20,2012,504171,-1629,1077,-552,7740,4003
20173,173,20,2013,506542,-2309,1050,-1259,7802,4149
20173,173,20,2014,509084,-1831,1144,-687,7454,4176
20173,173,20,2015,511230,-2125,1529,-596,7259,4485
20173,173,20,2016,513324,-2022,1247,-775,7358,4474
20173,173,20,2017,513392,-2875,360,-2515,7093,4500
20173,173,20,2018,513877,-2399,714,-1685,6796,4626
20173,173,20,2019,516579,-15,518,503,6740,4555
20173,173,20,2020,519907,1075,415,1490,6669,4863
20175,175,20,2010,22972,-57,15,-42,117,54
20175,175,20,2011,23131,-175,14,-161,449,130
20175,175,20,2012,23358,-197,78,-119,474,128
20175,175,20,2013,23318,-423,63,-360,426,112
20175,175,20,2014,23308,-453,135,-318,449,151
20175,175,20,2015,23283,-557,211,-346,444,132
20175,175,20,2016,22907,-853,177,-676,429,132
20175,175,20,2017,22239,-1023,45,-978,434,129
20175,175,20,2018,21904,-693,89,-604,399,134
20175,175,20,2019,21421,-818,73,-745,371,108
20175,175,20,2020,21038,-680,55,-625,363,115
20177,177,20,2010,178365,68,20,88,672,318
20177,177,20,2011,178968,-330,115,-215,2497,1673
20177,177,20,2012,179013,-753,149,-604,2404,1742
20177,177,20,2013,178714,-1125,174,-951,2432,1787
20177,177,20,2014,178651,-949,271,-678,2397,1773
20177,177,20,2015,178789,-525,338,-187,2273,1933
20177,177,20,2016,178413,-1014,238,-776,2219,1815
20177,177,20,2017,178096,-604,42,-562,2177,1926
20177,177,20,2018,177224,-1136,121,-1015,2091,1949
20177,177,20,2019,176735,-702,96,-606,2085,1969
20177,177,20,2020,175999,-949,77,-872,2081,1946
20179,179,20,2010,2530,-6,0,-6,4,13
20179,179,20,2011,2501,-11,0,-11,25,42
20179,179,20,2012,2490,-15,-1,-16,26,20
20179,179,20,2013,2499,11,2,13,30,35
20179,179,20,2014,2501,4,0,4,27,28
20179,179,20,2015,2474,-26,3,-23,27,31
20179,179,20,2016,2489,8,4,12,33,29
20179,179,20,2017,2526,38,1,39,29,31
20179,179,20,2018,2521,-3,3,0,24,28
20179,179,20,2019,2517,-8,1,-7,24,22
20179,179,20,2020,2520,0,1,1,23,20
20181,181,20,2010,6018,-4,1,-3,20,8
20181,181,20,2011,6055,30,-1,29,78,71
20181,181,20,2012,6122,67,-3,64,76,75
20181,181,20,2013,6094,-41,-2,-43,86,72
20181,181,20,2014,6069,-22,-4,-26,83,81
20181,181,20,2015,5965,-111,0,-111,74,68
20181,181,20,2016,5960,-20,-2,-22,84,68
20181,181,20,2017,5935,-5,-3,-8,64,79
20181,181,20,2018,5915,-38,-3,-41,74,54
20181,181,20,2019,5932,24,-3,21,64,66
20181,181,20,2020,5777,-139,-3,-142,65,77
20183,183,20,2010,3860,9,0,9,7,8
20183,183,20,2011,3791,-46,0,-46,33,56
20183,183,20,2012,3754,-8,0,-8,32,60
20183,183,20,2013,3700,-14,0,-14,32,72
20183,183,20,2014,3730,75,0,75,26,72
20183,183,20,2015,3691,-14,0,-14,39,66
20183,183,20,2016,3657,-21,0,-21,46,58
20183,183,20,2017,3616,-10,0,-10,40,69
20183,183,20,2018,3582,-24,0,-24,40,50
20183,183,20,2019,3571,3,0,3,29,43
20183,183,20,2020,3544,-11,0,-11,26,41
20185,185,20,2010,4429,-9,0,-9,8,9
20185,185,20,2011,4383,-34,0,-34,51,63
20185,185,20,2012,4350,-20,-1,-21,43,56
20185,185,20,2013,4340,18,-1,17,38,63
20185,185,20,2014,4282,-55,0,-55,53,57
20185,185,20,2015,4217,-50,0,-50,49,64
20185,185,20,2016,4194,-33,0,-33,61,51
20185,185,20,2017,4187,2,-1,1,50,59
20185,185,20,2018,4119,-56,-1,-57,47,58
20185,185,20,2019,4081,-32,0,-32,46,52
20185,185,20,2020,4046,-17,-1,-18,40,58
20187,187,20,2010,2246,11,0,11,5,6
20187,187,20,2011,2213,-39,-3,-42,30,21
20187,187,20,2012,2156,-68,0,-68,28,18
20187,187,20,2013,2179,-1,6,5,34,16
20187,187,20,2014,2143,-62,11,-51,33,20
20187,187,20,2015,2072,-83,3,-80,27,18
20187,187,20,2016,2111,2,16,18,40,20
20187,187,20,2017,2056,-68,9,-59,28,24
20187,187,20,2018,2026,-40,10,-30,20,19
20187,187,20,2019,1987,-47,9,-38,18,20
20187,187,20,2020,1969,-23,6,-17,18,17
20189,189,20,2010,5751,15,2,17,12,5
20189,189,20,2011,5631,-180,7,-173,95,42
20189,189,20,2012,5737,64,7,71,81,46
20189,189,20,2013,5806,-2,20,18,97,46
20189,189,20,2014,5838,-46,49,3,76,49
20189,189,20,2015,5791,-105,29,-76,81,54
20189,189,20,2016,5655,-196,28,-168,80,48
20189,189,20,2017,5542,-126,0,-126,66,54
20189,189,20,2018,5496,-78,11,-67,72,51
20189,189,20,2019,5405,-144,18,-126,65,31
20189,189,20,2020,5388,-63,16,-47,67,38
20191,191,20,2010,24119,-54,0,-54,71,37
20191,191,20,2011,23788,-339,2,-337,296,291
20191,191,20,2012,23632,-149,7,-142,271,287
20191,191,20,2013,23534,-134,15,-119,278,260
20191,191,20,2014,23381,-153,13,-140,246,259
20191,191,20,2015,23414,-15,18,3,277,245
20191,191,20,2016,23165,-245,9,-236,262,276
20191,191,20,2017,23103,-91,2,-89,276,248
20191,191,20,2018,22982,-80,4,-76,251,295
20191,191,20,2019,22810,-180,2,-178,255,250
20191,191,20,2020,22578,-206,1,-205,249,276
20193,193,20,2010,7932,30,3,33,25,30
20193,193,20,2011,7948,-29,11,-18,106,73
20193,193,20,2012,7942,-53,4,-49,115,71
20193,193,20,2013,7944,-22,0,-22,96,72
20193,193,20,2014,7849,-162,10,-152,133,81
20193,193,20,2015,7908,-2,12,10,127,78
20193,193,20,2016,7838,-94,8,-86,97,82
20193,193,20,2017,7824,-72,1,-71,128,71
20193,193,20,2018,7673,-185,6,-179,108,80
20193,193,20,2019,7704,-11,7,-4,101,66
20193,193,20,2020,7702,-48,6,-42,102,63
20195,195,20,2010,3006,3,0,3,4,7
20195,195,20,2011,2953,-45,1,-44,32,41
20195,195,20,2012,2939,10,1,11,28,54
20195,195,20,2013,2943,14,0,14,28,37
20195,195,20,2014,2893,-31,0,-31,30,49
20195,195,20,2015,2904,11,1,12,44,45
20195,195,20,2016,2848,-40,2,-38,36,53
20195,195,20,2017,2842,19,1,20,25,51
20195,195,20,2018,2782,-53,2,-51,36,44
20195,195,20,2019,2779,2,1,3,27,33
20195,195,20,2020,2758,-6,1,-5,31,46
20197,197,20,2010,7047,-11,1,-10,7,5
20197,197,20,2011,7036,-21,3,-18,90,83
20197,197,20,2012,6993,-52,2,-50,81,74
20197,197,20,2013,7024,-12,1,-11,109,66
20197,197,20,2014,6936,-108,2,-106,82,65
20197,197,20,2015,6886,-76,9,-67,90,74
20197,197,20,2016,6876,-24,1,-23,73,61
20197,197,20,2017,6827,-59,1,-58,63,54
20197,197,20,2018,6882,40,1,41,81,67
20197,197,20,2019,6892,-1,1,0,66,55
20197,197,20,2020,6906,3,1,4,68,58
20199,199,20,2010,1480,3,0,3,2,10
20199,199,20,2011,1525,46,-1,45,18,18
20199,199,20,2012,1523,-6,0,-6,16,13
20199,199,20,2013,1560,35,1,36,22,21
20199,199,20,2014,1501,-56,0,-56,17,21
20199,199,20,2015,1505,3,1,4,20,21
20199,199,20,2016,1499,-9,0,-9,20,17
20199,199,20,2017,1513,16,0,16,21,21
20199,199,20,2018,1484,-43,0,-43,25,12
20199,199,20,2019,1518,12,0,12,33,10
20199,199,20,2020,1536,-4,0,-4,31,10
20201,201,20,2010,5785,-10,0,-10,8,7
20201,201,20,2011,5820,46,8,54,64,82
20201,201,20,2012,5727,-95,4,-91,61,66
20201,201,20,2013,5626,-114,2,-112,79,70
20201,201,20,2014,5610,-18,3,-15,67,70
20201,201,20,2015,5568,-47,3,-44,75,72
20201,201,20,2016,5561,-20,0,-20,77,64
20201,201,20,2017,5475,-86,0,-86,80,79
20201,201,20,2018,5457,-19,1,-18,76,76
20201,201,20,2019,5449,-13,1,-12,71,68
20201,201,20,2020,5427,-11,1,-10,76,88
20203,203,20,2010,2239,3,0,3,9,6
20203,203,20,2011,2260,15,1,16,33,28
20203,203,20,2012,2228,-27,-2,-29,21,24
20203,203,20,2013,2192,-46,2,-44,35,28
20203,203,20,2014,2187,-9,4,-5,28,27
20203,203,20,2015,2166,-22,2,-20,21,23
20203,203,20,2016,2133,-36,1,-35,24,23
20203,203,20,2017,2121,-4,1,-3,20,27
20203,203,20,2018,2112,-20,2,-18,33,24
20203,203,20,2019,2118,3,2,5,16,16
20203,203,20,2020,2074,-47,2,-45,22,21
20205,205,20,2010,9389,-14,0,-14,40,43
20205,205,20,2011,9239,-126,3,-123,110,136
20205,205,20,2012,9121,-132,0,-132,132,121
20205,205,20,2013,9093,-11,2,-9,113,131
20205,205,20,2014,8971,-104,0,-104,109,127
20205,205,20,2015,8847,-99,1,-98,91,117
20205,205,20,2016,8709,-143,0,-143,115,110
20205,205,20,2017,8707,2,0,2,113,117
20205,205,20,2018,8668,-22,0,-22,109,124
20205,205,20,2019,8555,-107,0,-107,97,103
20205,205,20,2020,8362,-172,0,-172,94,114
20207,207,20,2010,3308,0,0,0,13,14
20207,207,20,2011,3322,27,0,27,32,45
20207,207,20,2012,3274,-39,0,-39,38,49
20207,207,20,2013,3214,-19,0,-19,25,66
20207,207,20,2014,3186,-18,0,-18,33,44
20207,207,20,2015,3142,-19,0,-19,30,54
20207,207,20,2016,3184,57,0,57,31,47
20207,207,20,2017,3127,-38,-1,-39,37,55
20207,207,20,2018,3165,44,-1,43,31,36
20207,207,20,2019,3096,-46,-1,-47,23,46
20207,207,20,2020,3015,-56,-1,-57,21,45
20209,209,20,2010,157636,-196,45,-151,626,357
20209,209,20,2011,158039,-1489,456,-1033,2766,1334
20209,209,20,2012,159424,-502,528,26,2731,1341
20209,209,20,2013,161004,-541,697,156,2798,1357
20209,209,20,2014,162325,-716,772,56,2679,1386
20209,209,20,2015,163776,-761,878,117,2720,1367
20209,209,20,2016,164924,-1106,851,-255,2776,1369
20209,209,20,2017,165254,-1192,332,-860,2585,1392
20209,209,20,2018,165781,-1334,612,-722,2661,1407
20209,209,20,2019,166009,-1363,459,-904,2551,1419
20209,209,20,2020,165265,-2153,366,-1787,2572,1523
21001,001,21,2010,18750,74,1,75,37,31
21001,001,21,2011,18984,220,6,226,192,184
21001,001,21,2012,18939,-40,7,-33,179,187
21001,001,21,2013,19128,137,19,156,232,203
21001,001,21,2014,19268,94,8,102,221,181
21001,001,21,2015,19172,-116,7,-109,205,194
21001,001,21,2016,19293,51,14,65,239,182
21001,001,21,2017,19311,23,8,31,203,214
21001,001,21,2018,19201,-61,-1,-62,176,223
21001,001,21,2019,19472,280,0,280,195,205
21001,001,21,2020,19555,134,2,136,182,233
21003,003,21,2010,20023,31,2,33,67,19
21003,003,21,2011,20164,104,10,114,242,216
21003,003,21,2012,20220,31,2,33,234,204
21003,003,21,2013,20304,44,3,47,264,224
21003,003,21,2014,20482,111,-1,110,263,193
21003,003,21,2015,20655,170,4,174,245,246
21003,003,21,2016,20706,36,0,36,241,225
21003,003,21,2017,20891,189,-1,188,251,254
21003,003,21,2018,21104,234,-2,232,240,259
21003,003,21,2019,21320,201,-1,200,250,233
21003,003,21,2020,21303,1,-1,0,247,265
21005,005,21,2010,21478,31,2,33,45,68
21005,005,21,2011,21570,47,-1,46,243,196
21005,005,21,2012,21702,46,1,47,262,174
21005,005,21,2013,21758,1,3,4,245,189
21005,005,21,2014,21881,84,4,88,259,219
21005,005,21,2015,21933,0,15,15,253,215
21005,005,21,2016,22198,190,13,203,270,208
21005,005,21,2017,22553,325,12,337,297,280
21005,005,21,2018,22615,60,3,63,243,243
21005,005,21,2019,22700,42,9,51,248,216
21005,005,21,2020,22833,97,7,104,241,214
21007,007,21,2010,8250,13,0,13,18,16
21007,007,21,2011,8258,13,2,15,98,105
21007,007,21,2012,8274,35,3,38,80,102
21007,007,21,2013,8244,-5,1,-4,80,107
21007,007,21,2014,8178,-44,1,-43,77,100
21007,007,21,2015,8208,56,4,60,86,115
21007,007,21,2016,8043,-149,0,-149,88,104
21007,007,21,2017,8002,7,-1,6,64,111
21007,007,21,2018,7940,-23,-1,-24,81,118
21007,007,21,2019,7817,-108,-1,-109,78,92
21007,007,21,2020,7769,-14,-1,-15,74,107
21009,009,21,2010,42117,-43,7,-36,109,119
21009,009,21,2011,42322,105,29,134,512,439
21009,009,21,2012,42610,189,43,232,527,466
21009,009,21,2013,42944,203,46,249,530,442
21009,009,21,2014,43041,7,24,31,577,502
21009,009,21,2015,43559,446,26,472,555,511
21009,009,21,2016,43789,122,29,151,582,501
21009,009,21,2017,43787,-75,35,-40,596,555
21009,009,21,2018,44071,260,9,269,543,526
21009,009,21,2019,44185,47,7,54,575,516
21009,009,21,2020,44300,113,5,118,558,563
21011,011,21,2010,11622,12,1,13,35,18
21011,011,21,2011,11721,103,4,107,147,155
21011,011,21,2012,11783,49,1,50,145,133
21011,011,21,2013,11979,141,-2,139,186,129
21011,011,21,2014,12135,126,0,126,164,134
21011,011,21,2015,12209,48,4,52,162,140
21011,011,21,2016,12255,41,4,45,169,165
21011,011,21,2017,12393,96,4,100,184,146
21011,011,21,2018,12444,21,0,21,186,154
21011,011,21,2019,12532,39,2,41,195,147
21011,011,21,2020,12481,-69,1,-68,183,167
21013,013,21,2010,28704,26,1,27,83,95
21013,013,21,2011,28656,-15,-1,-16,346,376
21013,013,21,2012,28288,-383,-1,-384,378,375
21013,013,21,2013,28034,-271,8,-263,374,366
21013,013,21,2014,27830,-149,1,-148,327,379
21013,013,21,2015,27376,-407,8,-399,339,396
21013,013,21,2016,27222,-111,3,-108,357,401
21013,013,21,2017,26865,-267,6,-261,321,417
21013,013,21,2018,26534,-272,3,-269,328,392
21013,013,21,2019,26026,-406,-2,-408,322,422
21013,013,21,2020,25482,-453,-1,-454,317,403
21015,015,21,2010,119380,176,100,276,432,140
21015,015,21,2011,121742,1136,258,1394,1666,702
21015,015,21,2012,123456,363,315,678,1747,693
21015,015,21,2013,125083,360,320,680,1751,784
21015,015,21,2014,126752,613,155,768,1689,777
21015,015,21,2015,128270,414,224,638,1735,840
21015,015,21,2016,129649,388,280,668,1597,880
21015,015,21,2017,131151,592,212,804,1640,933
21015,015,21,2018,131971,3,30,33,1734,944
21015,015,21,2019,133670,838,92,930,1678,907
21015,015,21,2020,135396,1050,88,1138,1668,1081
21017,017,21,2010,19965,-24,11,-13,47,76
21017,017,21,2011,20051,5,66,71,215,199
21017,017,21,2012,20050,-79,38,-41,240,199
21017,017,21,2013,20023,-82,23,-59,231,199
21017,017,21,2014,20049,11,-3,8,211,187
21017,017,21,2015,20159,94,9,103,227,218
21017,017,21,2016,20123,-41,1,-40,231,225
21017,017,21,2017,20088,-22,7,-15,218,237
21017,017,21,2018,20102,48,-2,46,205,235
21017,017,21,2019,19774,-296,-13,-309,222,241
21017,017,21,2020,19901,177,-7,170,209,250
21019,019,21,2010,49602,59,1,60,126,115
21019,019,21,2011,49417,-139,1,-138,564,610
21019,019,21,2012,49238,-178,-2,-180,580,573
21019,019,21,2013,48905,-301,7,-294,573,610
21019,019,21,2014,48828,-110,-1,-111,620,583
21019,019,21,2015,48518,-347,11,-336,638,611
21019,019,21,2016,48175,-327,11,-316,570,597
21019,019,21,2017,47867,-212,6,-206,562,662
21019,019,21,2018,47406,-322,-5,-327,536,672
21019,019,21,2019,46839,-421,-7,-428,507,646
21019,019,21,2020,46516,-144,-5,-149,476,647
21021,021,21,2010,28668,186,4,190,83,58
21021,021,21,2011,28800,143,16,159,296,321
21021,021,21,2012,29026,248,14,262,287,326
21021,021,21,2013,29636,535,22,557,298,265
21021,021,21,2014,29820,140,19,159,339,309
21021,021,21,2015,29800,-49,37,-12,329,333
21021,021,21,2016,29984,160,29,189,322,326
21021,021,21,2017,29992,19,20,39,303,332
21021,021,21,2018,30109,114,-3,111,347,340
21021,021,21,2019,30000,-44,7,-37,284,357
21021,021,21,2020,30367,410,11,421,309,360
21023,023,21,2010,8513,8,2,10,25,7
21023,023,21,2011,8512,-21,6,-15,107,93
21023,023,21,2012,8464,-68,5,-63,104,88
21023,023,21,2013,8425,-71,2,-69,115,85
21023,023,21,2014,8362,-67,2,-65,107,106
21023,023,21,2015,8292,-68,3,-65,107,112
21023,023,21,2016,8366,71,3,74,89,89
21023,023,21,2017,8284,-79,1,-78,97,100
21023,023,21,2018,8273,-15,0,-15,104,100
21023,023,21,2019,8330,48,0,48,92,82
21023,023,21,2020,8286,-43,0,-43,99,102
21025,025,21,2010,13855,10,1,11,37,68
21025,025,21,2011,13786,-75,9,-66,165,169
21025,025,21,2012,13608,-167,4,-163,163,182
21025,025,21,2013,13525,-62,1,-61,179,199
21025,025,21,2014,13361,-127,1,-126,179,218
21025,025,21,2015,13358,7,1,8,179,187
21025,025,21,2016,13164,-143,1,-142,148,202
21025,025,21,2017,12922,-205,1,-204,150,187
21025,025,21,2018,12762,-149,0,-149,193,205
21025,025,21,2019,12612,-127,1,-126,168,191
21025,025,21,2020,12550,-22,0,-22,162,202
21027,027,21,2010,20045,17,0,17,45,70
21027,027,21,2011,20276,237,-1,236,204,210
21027,027,21,2012,20079,-174,-1,-175,229,255
21027,027,21,2013,20049,-19,-1,-20,216,223
21027,027,21,2014,19893,-165,0,-165,224,216
21027,027,21,2015,19987,112,6,118,221,242
21027,027,21,2016,19988,-29,3,-26,253,225
21027,027,21,2017,20131,124,14,138,251,244
21027,027,21,2018,20286,185,8,193,232,270
21027,027,21,2019,20471,162,-2,160,221,196
21027,027,21,2020,20537,52,-2,50,235,219
21029,029,21,2010,74483,101,0,101,197,104
21029,029,21,2011,75192,422,-7,415,747,454
21029,029,21,2012,75906,417,16,433,753,468
21029,029,21,2013,76886,775,18,793,729,551
21029,029,21,2014,78039,885,7,892,803,559
21029,029,21,2015,78698,441,8,449,782,569
21029,029,21,2016,79273,365,10,375,830,625
21029,029,21,2017,80309,900,9,909,829,703
21029,029,21,2018,81040,601,0,601,798,668
21029,029,21,2019,81803,637,3,640,779,654
21029,029,21,2020,82182,333,-1,332,775,731
21031,031,21,2010,12742,13,4,17,35,15
21031,031,21,2011,12727,-24,22,-2,142,154
21031,031,21,2012,12745,3,24,27,144,154
21031,031,21,2013,12714,-45,2,-43,146,135
21031,031,21,2014,12745,6,1,7,175,148
21031,031,21,2015,12742,-18,1,-17,154,140
21031,031,21,2016,12691,-42,4,-38,150,163
21031,031,21,2017,12792,110,8,118,160,174
21031,031,21,2018,12731,-54,6,-48,152,165
21031,031,21,2019,12861,117,6,123,163,155
21031,031,21,2020,12703,-153,3,-150,160,167
21033,033,21,2010,13010,9,0,9,39,26
21033,033,21,2011,13026,46,0,46,138,167
21033,033,21,2012,12988,-17,0,-17,154,175
21033,033,21,2013,12882,-92,0,-92,156,169
21033,033,21,2014,12844,-27,-1,-28,158,167
21033,033,21,2015,12744,-35,-1,-36,134,196
21033,033,21,2016,12635,-109,-1,-110,152,151
21033,033,21,2017,12660,46,-1,45,145,163
21033,033,21,2018,12684,52,-1,51,136,162
21033,033,21,2019,12731,56,-1,55,151,159
21033,033,21,2020,12687,-2,-1,-3,143,183
21035,035,21,2010,37360,133,26,159,110,118
21035,035,21,2011,37680,218,97,315,393,389
21035,035,21,2012,38065,245,132,377,391,385
21035,035,21,2013,38449,183,227,410,358,383
21035,035,21,2014,38482,-142,146,4,402,371
21035,035,21,2015,38695,32,209,241,396,420
21035,035,21,2016,38760,-83,162,79,387,401
21035,035,21,2017,38841,-48,111,63,398,377
21035,035,21,2018,38982,146,34,180,359,397
21035,035,21,2019,39073,102,56,158,336,405
21035,035,21,2020,39300,286,47,333,339,445
21037,037,21,2010,90806,321,13,334,284,185
21037,037,21,2011,91631,359,82,441,1155,770
21037,037,21,2012,91659,-415,122,-293,1196,866
21037,037,21,2013,91862,-243,214,-29,1101,856
21037,037,21,2014,92403,100,92,192,1144,782
21037,037,21,2015,92612,-179,149,-30,1098,848
21037,037,21,2016,92821,-109,140,31,1085,903
21037,037,21,2017,93366,240,124,364,1036,855
21037,037,21,2018,93990,338,38,376,1150,903
21037,037,21,2019,93841,-463,61,-402,1095,845
21037,037,21,2020,94020,-8,57,49,1088,962
21039,039,21,2010,5084,-2,1,-1,14,28
21039,039,21,2011,5034,-36,2,-34,51,67
21039,039,21,2012,5028,-18,3,-15,73,64
21039,039,21,2013,4959,-66,4,-62,63,70
21039,039,21,2014,4959,-1,2,1,69,70
21039,039,21,2015,4849,-112,0,-112,66,64
21039,039,21,2016,4782,-63,0,-63,73,78
21039,039,21,2017,4785,19,0,19,63,79
21039,039,21,2018,4711,-72,0,-72,57,60
21039,039,21,2019,4721,9,0,9,59,56
21039,039,21,2020,4692,-16,0,-16,59,73
21041,041,21,2010,10806,-34,7,-27,39,14
21041,041,21,2011,10994,102,35,137,163,113
21041,041,21,2012,10877,-176,25,-151,163,134
21041,041,21,2013,10844,-69,7,-62,157,129
21041,041,21,2014,10747,-123,-3,-126,138,112
21041,041,21,2015,10693,-71,1,-70,170,154
21041,041,21,2016,10635,-76,-2,-78,176,156
21041,041,21,2017,10720,70,-2,68,151,133
21041,041,21,2018,10711,-18,-2,-20,143,132
21041,041,21,2019,10658,-63,-2,-65,143,132
21041,041,21,2020,10730,66,0,66,144,138
21043,043,21,2010,27739,-4,2,-2,83,55
21043,043,21,2011,27621,-152,3,-149,340,310
21043,043,21,2012,27633,-20,3,-17,332,295
21043,043,21,2013,27599,-114,27,-87,364,308
21043,043,21,2014,27517,-225,9,-216,397,264
21043,043,21,2015,27443,-120,6,-114,378,339
21043,043,21,2016,27313,-200,5,-195,372,306
21043,043,21,2017,27216,-105,11,-94,350,352
21043,043,21,2018,27042,-157,4,-153,323,344
21043,043,21,2019,26766,-227,4,-223,301,354
21043,043,21,2020,26542,-124,2,-122,289,391
21045,045,21,2010,15987,14,0,14,44,34
21045,045,21,2011,15916,-41,1,-40,175,205
21045,045,21,2012,16029,78,-5,73,203,162
21045,045,21,2013,16017,-13,0,-13,200,195
21045,045,21,2014,15790,-235,-2,-237,196,189
21045,045,21,2015,15756,-31,-2,-33,196,194
21045,045,21,2016,15785,34,5,39,200,209
21045,045,21,2017,15836,29,5,34,211,193
21045,045,21,2018,15950,116,1,117,189,189
21045,045,21,2019,16204,262,0,262,186,194
21045,045,21,2020,16066,-105,-1,-106,189,220
21047,047,21,2010,74145,-190,114,-76,372,98
21047,047,21,2011,73516,-1614,97,-1517,1463,584
21047,047,21,2012,74975,-296,931,635,1438,611
21047,047,21,2013,73726,-2620,396,-2224,1571,651
21047,047,21,2014,73432,-1462,265,-1197,1472,576
21047,047,21,2015,73243,-1701,416,-1285,1668,581
21047,047,21,2016,71966,-2468,233,-2235,1494,542
21047,047,21,2017,71293,-1450,91,-1359,1333,638
21047,047,21,2018,71036,-890,-66,-956,1344,644
21047,047,21,2019,71577,-323,-32,-355,1546,646
21047,047,21,2020,71478,-968,6,-962,1530,660
21049,049,21,2010,35599,11,4,15,104,116
21049,049,21,2011,35438,-199,7,-192,404,374
21049,049,21,2012,35694,204,5,209,436,385
21049,049,21,2013,35566,-153,18,-135,426,418
21049,049,21,2014,35643,102,1,103,379,402
21049,049,21,2015,35685,14,5,19,454,426
21049,049,21,2016,35869,152,8,160,448,422
21049,049,21,2017,35941,51,10,61,434,421
21049,049,21,2018,36209,260,-7,253,430,418
21049,049,21,2019,36280,94,3,97,421,447
21049,049,21,2020,36463,182,2,184,420,421
21051,051,21,2010,21668,-61,1,-60,79,91
21051,051,21,2011,21602,-73,2,-71,293,289
21051,051,21,2012,21530,-103,2,-101,298,268
21051,051,21,2013,21199,-375,5,-370,273,244
21051,051,21,2014,21093,-169,9,-160,294,241
21051,051,21,2015,20986,-163,10,-153,278,234
21051,051,21,2016,20627,-315,6,-309,252,304
21051,051,21,2017,20264,-354,4,-350,265,281
21051,051,21,2018,20116,-142,5,-137,249,261
21051,051,21,2019,19912,-164,0,-164,238,277
21051,051,21,2020,19631,-242,2,-240,217,258
21053,053,21,2010,10256,1,0,1,26,48
21053,053,21,2011,10170,-89,15,-74,114,126
21053,053,21,2012,10282,99,14,113,118,122
21053,053,21,2013,10188,-100,19,-81,119,132
21053,053,21,2014,10218,40,13,53,104,125
21053,053,21,2015,10197,0,14,14,136,170
21053,053,21,2016,10209,17,0,17,122,125
21053,053,21,2017,10214,24,-1,23,106,123
21053,053,21,2018,10142,-32,-1,-33,92,131
21053,053,21,2019,10200,58,-1,57,125,123
21053,053,21,2020,10110,-67,-1,-68,112,134
21055,055,21,2010,9297,5,1,6,25,47
21055,055,21,2011,9249,-22,1,-21,82,109
21055,055,21,2012,9222,-3,0,-3,108,130
21055,055,21,2013,9180,-7,0,-7,105,138
21055,055,21,2014,9180,2,0,2,119,120
21055,055,21,2015,9174,21,-1,20,115,138
21055,055,21,2016,9133,-6,0,-6,87,122
21055,055,21,2017,9011,-77,1,-76,90,136
21055,055,21,2018,8900,-87,0,-87,104,127
21055,055,21,2019,8807,-54,0,-54,88,126
21055,055,21,2020,8847,64,0,64,92,116
21057,057,21,2010,6858,4,1,5,19,11
21057,057,21,2011,6865,18,6,24,79,95
21057,057,21,2012,6849,-6,7,1,78,93
21057,057,21,2013,6785,-46,8,-38,77,105
21057,057,21,2014,6717,-52,2,-50,80,97
21057,057,21,2015,6731,56,0,56,78,119
21057,057,21,2016,6739,11,0,11,91,94
21057,057,21,2017,6706,1,0,1,73,108
21057,057,21,2018,6704,27,0,27,66,94
21057,057,21,2019,6626,-41,0,-41,70,105
21057,057,21,2020,6523,-60,0,-60,76,119
21059,059,21,2010,96722,7,10,17,318,260
21059,059,21,2011,97185,96,41,137,1293,962
21059,059,21,2012,97871,234,75,309,1347,951
21059,059,21,2013,98334,20,144,164,1300,986
21059,059,21,2014,98488,-286,131,-155,1335,1010
21059,059,21,2015,99548,536,235,771,1358,1064
21059,059,21,2016,100080,-30,211,181,1374,1017
21059,059,21,2017,100508,50,172,222,1344,1132
21059,059,21,2018,100885,101,43,144,1339,1102
21059,059,21,2019,101555,355,72,427,1313,1070
21059,059,21,2020,101978,187,67,254,1308,1143
21061,061,21,2010,12239,39,0,39,26,18
21061,061,21,2011,12244,19,2,21,110,124
21061,061,21,2012,12106,-121,7,-114,98,122
21061,061,21,2013,12075,8,10,18,96,143
21061,061,21,2014,12022,-23,2,-21,107,138
21061,061,21,2015,12009,27,-2,25,113,148
21061,061,21,2016,12097,103,3,106,116,134
21061,061,21,2017,12248,192,3,195,118,163
21061,061,21,2018,12247,31,-2,29,111,140
21061,061,21,2019,12149,-76,-1,-77,127,148
21061,061,21,2020,12235,138,-1,137,114,163
21063,063,21,2010,7845,4,0,4,17,27
21063,063,21,2011,7782,-54,1,-53,57,68
21063,063,21,2012,7633,-137,0,-137,55,72
21063,063,21,2013,7550,-62,0,-62,64,86
21063,063,21,2014,7531,-20,1,-19,67,66
21063,063,21,2015,7546,5,0,5,81,70
21063,063,21,2016,7487,-61,-1,-62,75,72
21063,063,21,2017,7490,14,-3,11,70,79
21063,063,21,2018,7469,-8,-3,-11,74,83
21063,063,21,2019,7485,21,-3,18,65,68
21063,063,21,2020,7372,-88,-2,-90,61,84
21065,065,21,2010,14722,14,0,14,46,24
21065,065,21,2011,14662,-42,0,-42,170,188
21065,065,21,2012,14512,-124,0,-124,152,182
21065,065,21,2013,14492,5,0,5,158,180
21065,065,21,2014,14451,22,0,22,153,213
21065,065,21,2015,14381,-30,0,-30,158,197
21065,065,21,2016,14332,-11,1,-10,162,200
21065,065,21,2017,14186,-57,1,-56,122,211
21065,065,21,2018,14164,46,1,47,149,219
21065,065,21,2019,14143,12,0,12,149,181
21065,065,21,2020,14109,16,0,16,145,194
21067,067,21,2010,296868,178,308,486,966,452
21067,067,21,2011,301766,1716,1244,2960,4001,2074
21067,067,21,2012,306062,893,1496,2389,3981,2062
21067,067,21,2013,310025,370,1789,2159,4049,2219
21067,067,21,2014,311992,-922,1067,145,4084,2200
21067,067,21,2015,316079,1005,1478,2483,3959,2358
21067,067,21,2016,318190,-1205,1528,323,4148,2356
21067,067,21,2017,321554,608,1292,1900,3973,2509
21067,067,21,2018,322597,-712,352,-360,4002,2588
21067,067,21,2019,323922,-715,517,-198,3856,2342
21067,067,21,2020,324735,-920,421,-499,3839,2545
21069,069,21,2010,14398,23,0,23,49,18
21069,069,21,2011,14483,68,0,68,186,167
21069,069,21,2012,14527,27,-2,25,185,165
21069,069,21,2013,14540,0,0,0,209,194
21069,069,21,2014,14476,-58,0,-58,186,192
21069,069,21,2015,14576,94,0,94,193,184
21069,069,21,2016,14489,-108,0,-108,198,178
21069,069,21,2017,14439,-68,0,-68,198,180
21069,069,21,2018,14490,4,0,4,211,163
21069,069,21,2019,14574,57,0,57,193,167
21069,069,21,2020,14603,13,0,13,199,183
21071,071,21,2010,39933,444,2,446,128,155
21071,071,21,2011,39760,-198,7,-191,533,515
21071,071,21,2012,39142,-670,14,-656,536,521
21071,071,21,2013,38487,-701,12,-689,532,515
21071,071,21,2014,38012,-502,10,-492,475,466
21071,071,21,2015,37545,-435,14,-421,460,508
21071,071,21,2016,37002,-469,3,-466,479,557
21071,071,21,2017,36301,-609,0,-609,448,544
21071,071,21,2018,35861,-318,-1,-319,435,556
21071,071,21,2019,35515,-233,-2,-235,424,534
21071,071,21,2020,34974,-367,-1,-368,415,589
21073,073,21,2010,49248,-20,19,-1,149,155
21073,073,21,2011,49312,-99,94,-5,560,489
21073,073,21,2012,49455,21,71,92,534,470
21073,073,21,2013,49482,-114,56,-58,601,513
21073,073,21,2014,49738,118,42,160,595,493
21073,073,21,2015,50090,231,73,304,584,532
21073,073,21,2016,50344,130,94,224,600,568
21073,073,21,2017,50564,126,126,252,573,602
21073,073,21,2018,50807,166,44,210,606,571
21073,073,21,2019,50887,44,37,81,550,550
21073,073,21,2020,51118,230,31,261,544,576
21075,075,21,2010,6797,10,0,10,18,35
21075,075,21,2011,6739,-52,1,-51,96,103
21075,075,21,2012,6557,-161,0,-161,75,102
21075,075,21,2013,6381,-123,2,-121,74,130
21075,075,21,2014,6259,-107,0,-107,79,97
21075,075,21,2015,6259,5,0,5,78,84
21075,075,21,2016,6181,-77,0,-77,83,84
21075,075,21,2017,6151,29,0,29,59,117
21075,075,21,2018,6049,-60,0,-60,56,98
21075,075,21,2019,5989,-42,0,-42,69,87
21075,075,21,2020,5952,5,0,5,61,102
21077,077,21,2010,8607,2,6,8,27,9
21077,077,21,2011,8617,-33,19,-14,122,96
21077,077,21,2012,8551,-75,2,-73,110,104
21077,077,21,2013,8577,-12,14,2,123,98
21077,077,21,2014,8632,49,7,56,102,105
21077,077,21,2015,8610,-35,9,-26,106,100
21077,077,21,2016,8725,76,7,83,128,97
21077,077,21,2017,8716,-16,4,-12,111,108
21077,077,21,2018,8739,20,1,21,115,114
21077,077,21,2019,8842,85,2,87,101,85
21077,077,21,2020,8779,-82,2,-80,100,82
21079,079,21,2010,16942,11,-2,9,49,19
21079,079,21,2011,16869,-92,5,-87,167,153
21079,079,21,2012,17008,93,4,97,193,151
21079,079,21,2013,16995,-18,6,-12,170,170
21079,079,21,2014,16975,0,-1,-1,166,182
21079,079,21,2015,17212,211,0,211,196,171
21079,079,21,2016,17388,130,-1,129,209,163
21079,079,21,2017,17452,79,-1,78,182,195
21079,079,21,2018,17528,65,-1,64,208,196
21079,079,21,2019,17684,156,-1,155,186,184
21079,079,21,2020,17719,49,-1,48,182,196
21081,081,21,2010,24681,-30,-1,-31,83,30
21081,081,21,2011,24771,-74,-6,-80,356,186
21081,081,21,2012,24522,-410,-5,-415,383,230
21081,081,21,2013,24567,-40,-4,-44,321,228
21081,081,21,2014,24832,123,-8,115,375,221
21081,081,21,2015,24746,-212,-5,-217,364,233
21081,081,21,2016,24915,72,-6,66,357,254
21081,081,21,2017,24998,-46,-4,-50,395,260
21081,081,21,2018,25114,-9,-5,-14,375,244
21081,081,21,2019,25120,-93,-5,-98,358,256
21081,081,21,2020,25387,169,-3,166,363,261
21083,083,21,2010,37254,42,29,71,133,89
21083,083,21,2011,37608,189,76,265,523,433
21083,083,21,2012,37566,-124,50,-74,492,459
21083,083,21,2013,37408,-213,35,-178,492,472
21083,083,21,2014,37584,97,16,113,505,432
21083,083,21,2015,37249,-417,47,-370,466,435
21083,083,21,2016,37217,-134,52,-82,522,469
21083,083,21,2017,37160,-134,53,-81,508,483
21083,083,21,2018,37260,4,40,44,512,455
21083,083,21,2019,37170,-127,4,-123,493,460
21083,083,21,2020,36818,-369,11,-358,483,474
21085,085,21,2010,25786,43,2,45,85,93
21085,085,21,2011,25754,-21,-3,-24,305,312
21085,085,21,2012,25797,44,-2,42,340,336
21085,085,21,2013,25954,119,8,127,343,311
21085,085,21,2014,26071,106,8,114,327,319
21085,085,21,2015,26143,21,8,29,353,307
21085,085,21,2016,26105,-36,9,-27,335,344
21085,085,21,2017,26281,168,2,170,318,312
21085,085,21,2018,26265,58,-1,57,294,367
21085,085,21,2019,26435,161,-1,160,324,313
21085,085,21,2020,26480,55,1,56,314,326
21087,087,21,2010,11260,-7,2,-5,25,44
21087,087,21,2011,11218,-38,5,-33,118,125
21087,087,21,2012,11304,82,7,89,107,111
21087,087,21,2013,11181,-89,9,-80,117,160
21087,087,21,2014,11043,-112,-2,-114,101,127
21087,087,21,2015,10976,-30,0,-30,115,152
21087,087,21,2016,10991,50,2,52,114,150
21087,087,21,2017,11060,82,0,82,120,133
21087,087,21,2018,11007,-1,-1,-2,106,156
21087,087,21,2019,10949,-28,-1,-29,117,147
21087,087,21,2020,10995,90,0,90,107,150
21089,089,21,2010,36889,15,0,15,78,107
21089,089,21,2011,36848,2,3,5,402,448
21089,089,21,2012,36698,-71,1,-70,377,453
21089,089,21,2013,36505,-162,-1,-163,409,442
21089,089,21,2014,36326,-149,0,-149,436,461
21089,089,21,2015,36030,-197,-1,-198,384,479
21089,089,21,2016,35852,-71,1,-70,356,462
21089,089,21,2017,35542,-188,0,-188,361,481
21089,089,21,2018,35371,-39,-5,-44,369,495
21089,089,21,2019,35164,-85,-4,-89,350,469
21089,089,21,2020,34865,-134,3,-131,354,522
21091,091,21,2010,8550,-7,0,-7,24,31
21091,091,21,2011,8590,21,-1,20,104,83
21091,091,21,2012,8645,7,-1,6,115,65
21091,091,21,2013,8631,-22,0,-22,104,95
21091,091,21,2014,8687,36,0,36,104,82
21091,091,21,2015,8648,-89,0,-89,124,75
21091,091,21,2016,8743,44,0,44,135,83
21091,091,21,2017,8786,14,0,14,106,78
21091,091,21,2018,8751,-62,0,-62,117,90
21091,091,21,2019,8716,-33,0,-33,90,91
21091,091,21,2020,8742,24,0,24,100,98
21093,093,21,2010,106970,1043,125,1168,420,243
21093,093,21,2011,107542,-516,134,-382,1796,842
21093,093,21,2012,108280,-464,553,89,1488,821
21093,093,21,2013,109072,-387,389,2,1632,837
21093,093,21,2014,108612,-1525,272,-1253,1613,862
21093,093,21,2015,106415,-3156,325,-2831,1520,935
21093,093,21,2016,107106,7,166,173,1446,925
21093,093,21,2017,108314,579,96,675,1419,881
21093,093,21,2018,110435,1607,-37,1570,1461,908
21093,093,21,2019,110970,159,-6,153,1407,1027
21093,093,21,2020,111309,-21,16,-5,1377,1041
21095,095,21,2010,29223,-32,1,-31,93,116
21095,095,21,2011,29129,-144,5,-139,427,382
21095,095,21,2012,28686,-442,10,-432,402,424
21095,095,21,2013,28494,-133,3,-130,398,458
21095,095,21,2014,28018,-443,2,-441,382,425
21095,095,21,2015,27509,-462,2,-460,338,390
21095,095,21,2016,26986,-414,5,-409,337,453
21095,095,21,2017,26687,-246,6,-240,348,409
21095,095,21,2018,26338,-261,0,-261,321,410
21095,095,21,2019,25960,-216,2,-214,297,461
21095,095,21,2020,25566,-252,2,-250,293,436
21097,097,21,2010,18799,-22,0,-22,40,57
21097,097,21,2011,18680,-113,16,-97,199,221
21097,097,21,2012,18612,-79,33,-46,202,225
21097,097,21,2013,18564,-65,32,-33,210,223
21097,097,21,2014,18632,74,3,77,225,232
21097,097,21,2015,18642,23,3,26,206,220
21097,097,21,2016,18590,-82,4,-78,238,211
21097,097,21,2017,18737,157,4,161,222,235
21097,097,21,2018,18730,4,1,5,220,232
21097,097,21,2019,18838,89,-1,88,247,227
21097,097,21,2020,18920,93,0,93,232,243
21099,099,21,2010,18184,10,1,11,54,69
21099,099,21,2011,18286,10,6,16,254,168
21099,099,21,2012,18399,52,8,60,255,198
21099,099,21,2013,18462,75,9,84,210,229
21099,099,21,2014,18508,-17,4,-13,257,196
21099,099,21,2015,18415,-125,7,-118,260,234
21099,099,21,2016,18531,61,8,69,260,213
21099,099,21,2017,18737,168,3,171,282,246
21099,099,21,2018,18868,88,-1,87,268,225
21099,099,21,2019,19014,76,1,77,269,200
21099,099,21,2020,19013,-39,0,-39,254,218
21101,101,21,2010,46263,19,6,25,135,141
21101,101,21,2011,46345,2,6,8,583,508
21101,101,21,2012,46436,-1,2,1,539,437
21101,101,21,2013,46362,-159,9,-150,554,476
21101,101,21,2014,46396,9,4,13,546,517
21101,101,21,2015,46376,-58,3,-55,561,521
21101,101,21,2016,46254,-173,12,-161,536,496
21101,101,21,2017,45915,-342,5,-337,545,548
21101,101,21,2018,45566,-382,-1,-383,540,508
21101,101,21,2019,45276,-285,1,-284,503,507
21101,101,21,2020,44740,-464,3,-461,497,572
21103,103,21,2010,15372,-28,1,-27,38,49
21103,103,21,2011,15373,-23,12,-11,193,182
21103,103,21,2012,15335,-64,13,-51,167,152
21103,103,21,2013,15433,82,14,96,181,179
21103,103,21,2014,15550,119,2,121,159,162
21103,103,21,2015,15563,7,0,7,172,164
21103,103,21,2016,15837,274,2,276,187,190
21103,103,21,2017,15979,123,4,127,192,176
21103,103,21,2018,16049,81,0,81,190,199
21103,103,21,2019,16063,32,1,33,165,185
21103,103,21,2020,16067,32,2,34,161,190
21105,105,21,2010,4868,-17,0,-17,7,33
21105,105,21,2011,4793,-54,0,-54,41,63
21105,105,21,2012,4747,-37,0,-37,45,52
21105,105,21,2013,4720,-7,0,-7,35,54
21105,105,21,2014,4690,0,0,0,33,63
21105,105,21,2015,4622,-39,0,-39,44,74
21105,105,21,2016,4622,9,0,9,49,57
21105,105,21,2017,4531,-66,0,-66,47,72
21105,105,21,2018,4424,-82,0,-82,37,63
21105,105,21,2019,4365,-35,0,-35,37,61
21105,105,21,2020,4364,33,0,33,37,70
21107,107,21,2010,46841,-21,4,-17,124,177
21107,107,21,2011,46849,-56,13,-43,562,509
21107,107,21,2012,46618,-202,19,-183,553,603
21107,107,21,2013,46436,-120,33,-87,523,611
21107,107,21,2014,46168,-241,23,-218,534,584
21107,107,21,2015,46068,-73,35,-38,580,637
21107,107,21,2016,45616,-393,34,-359,527,621
21107,107,21,2017,45303,-191,24,-167,498,643
21107,107,21,2018,44978,-272,9,-263,546,607
21107,107,21,2019,44660,-328,17,-311,537,545
21107,107,21,2020,44662,60,15,75,523,598
21109,109,21,2010,13476,22,0,22,34,67
21109,109,21,2011,13380,-80,0,-80,154,170
21109,109,21,2012,13303,-64,0,-64,154,169
21109,109,21,2013,13385,70,0,70,170,157
21109,109,21,2014,13304,-108,0,-108,162,136
21109,109,21,2015,13321,7,0,7,175,162
21109,109,21,2016,13351,23,0,23,167,162
21109,109,21,2017,13418,45,0,45,183,160
21109,109,21,2018,13415,11,0,11,162,175
21109,109,21,2019,13316,-69,0,-69,150,180
21109,109,21,2020,13340,39,0,39,158,173
21111,111,21,2010,742096,-148,464,316,2554,1778
21111,111,21,2011,746458,-310,1838,1528,10079,7219
21111,111,21,2012,751802,188,2561,2749,9933,7213
21111,111,21,2013,759427,1815,3302,5117,10033,7497
21111,111,21,2014,762038,-1696,1846,150,9974,7326
21111,111,21,2015,765322,-1604,2684,1080,10042,7730
21111,111,21,2016,767770,-2011,2565,554,9979,8041
21111,111,21,2017,770383,-1355,2392,1037,9897,8268
21111,111,21,2018,768706,-4097,708,-3389,9819,8086
21111,111,21,2019,767785,-3687,1220,-2467,9587,8041
21111,111,21,2020,767452,-2492,980,-1512,9433,8281
21113,113,21,2010,48682,40,20,60,165,118
21113,113,21,2011,48892,-117,32,-85,661,367
21113,113,21,2012,49469,175,97,272,688,378
21113,113,21,2013,50124,249,141,390,653,387
21113,113,21,2014,50877,414,91,505,690,443
21113,113,21,2015,51822,638,124,762,653,474
21113,113,21,2016,52259,83,133,216,703,482
21113,113,21,2017,53274,736,126,862,632,478
21113,113,21,2018,53777,310,39,349,650,497
21113,113,21,2019,54012,60,23,83,610,457
21113,113,21,2020,54057,-104,19,-85,619,492
21115,115,21,2010,23398,55,0,55,74,104
21115,115,21,2011,23430,16,-1,15,278,260
21115,115,21,2012,23419,-34,-1,-35,330,301
21115,115,21,2013,23474,43,1,44,305,291
21115,115,21,2014,23266,-232,-1,-233,304,282
21115,115,21,2015,23144,-108,-2,-110,273,283
21115,115,21,2016,22895,-206,-2,-208,269,310
21115,115,21,2017,22618,-221,-3,-224,251,303
21115,115,21,2018,22432,-86,-3,-89,260,357
21115,115,21,2019,22188,-134,-3,-137,222,329
21115,115,21,2020,22002,-84,-3,-87,223,321
21117,117,21,2010,159967,-110,36,-74,632,305
21117,117,21,2011,160562,-563,130,-433,2380,1347
21117,117,21,2012,161774,150,192,342,2290,1394
21117,117,21,2013,163228,297,205,502,2383,1417
21117,117,21,2014,163741,-516,121,-395,2371,1435
21117,117,21,2015,164627,-66,148,82,2333,1511
21117,117,21,2016,165144,-366,180,-186,2212,1499
21117,117,21,2017,165835,-83,151,68,2198,1565
21117,117,21,2018,166501,-73,35,-38,2255,1545
21117,117,21,2019,167333,12,66,78,2237,1486
21117,117,21,2020,167949,-12,57,45,2180,1612
21119,119,21,2010,16350,-4,0,-4,50,53
21119,119,21,2011,16306,-14,-1,-15,178,206
21119,119,21,2012,16122,-121,2,-119,161,231
21119,119,21,2013,16090,-9,4,-5,188,212
21119,119,21,2014,15943,-173,3,-170,206,184
21119,119,21,2015,15681,-233,3,-230,164,196
21119,119,21,2016,15498,-158,3,-155,170,200
21119,119,21,2017,15243,-189,-2,-191,154,219
21119,119,21,2018,15090,-97,-4,-101,141,193
21119,119,21,2019,14861,-176,-4,-180,147,195
21119,119,21,2020,14512,-275,-3,-278,134,204
21121,121,21,2010,31846,-6,1,-5,100,127
21121,121,21,2011,31875,41,-2,39,379,387
21121,121,21,2012,31493,-445,-5,-450,417,356
21121,121,21,2013,31637,57,-5,52,451,355
21121,121,21,2014,31542,-152,31,-121,410,384
21121,121,21,2015,31467,-106,32,-74,391,388
21121,121,21,2016,31481,28,31,59,384,428
21121,121,21,2017,31461,16,13,29,375,422
21121,121,21,2018,31326,-152,-4,-156,427,406
21121,121,21,2019,31151,-154,4,-150,394,418
21121,121,21,2020,31022,-63,5,-58,396,470
21123,123,21,2010,14181,6,3,9,34,50
21123,123,21,2011,14190,56,-2,54,135,180
21123,123,21,2012,14057,-146,-1,-147,146,134
21123,123,21,2013,14029,-16,1,-15,167,177
21123,123,21,2014,14120,97,-1,96,166,170
21123,123,21,2015,14123,25,0,25,147,167
21123,123,21,2016,14019,-87,-1,-88,152,169
21123,123,21,2017,14204,185,0,185,166,165
21123,123,21,2018,14300,117,-2,115,166,185
21123,123,21,2019,14393,81,-1,80,174,160
21123,123,21,2020,14431,52,-1,51,157,171
21125,125,21,2010,58993,100,11,111,150,115
21125,125,21,2011,59364,164,45,209,727,565
21125,125,21,2012,59542,28,38,66,743,617
21125,125,21,2013,59714,-102,35,-67,762,513
21125,125,21,2014,59913,96,-6,90,687,565
21125,125,21,2015,59937,-128,-2,-130,763,603
21125,125,21,2016,60080,23,-5,18,739,610
21125,125,21,2017,60343,134,-4,130,793,656
21125,125,21,2018,60652,292,-5,287,737,714
21125,125,21,2019,60842,120,-4,116,720,646
21125,125,21,2020,61238,424,-4,420,713,737
21127,127,21,2010,15856,15,0,15,56,64
21127,127,21,2011,15931,72,0,72,198,194
21127,127,21,2012,15881,-61,5,-56,215,206
21127,127,21,2013,15893,10,20,30,178,194
21127,127,21,2014,15873,-64,13,-51,219,188
21127,127,21,2015,15861,-27,25,-2,216,224
21127,127,21,2016,15843,-20,11,-9,206,214
21127,127,21,2017,15757,-111,14,-97,202,190
21127,127,21,2018,15589,-137,13,-124,194,238
21127,127,21,2019,15395,-198,4,-194,213,214
21127,127,21,2020,15436,45,5,50,214,223
21129,129,21,2010,7714,-185,-1,-186,11,15
21129,129,21,2011,7706,22,-2,20,67,95
21129,129,21,2012,7582,-87,-1,-88,68,107
21129,129,21,2013,7147,-436,-1,-437,82,98
21129,129,21,2014,7069,-42,-1,-43,78,111
21129,129,21,2015,7023,-22,4,-18,63,91
21129,129,21,2016,6885,-132,2,-130,91,100
21129,129,21,2017,6860,9,2,11,75,110
21129,129,21,2018,7038,216,-2,214,70,107
21129,129,21,2019,7390,377,-1,376,76,102
21129,129,21,2020,7268,-77,0,-77,75,120
21131,131,21,2010,11278,-1,0,-1,34,64
21131,131,21,2011,11241,-23,-3,-26,156,167
21131,131,21,2012,11147,-105,0,-105,151,143
21131,131,21,2013,10995,-110,-1,-111,138,179
21131,131,21,2014,10841,-146,0,-146,139,150
21131,131,21,2015,10655,-174,2,-172,143,159
21131,131,21,2016,10431,-181,1,-180,115,159
21131,131,21,2017,10323,-69,2,-67,108,151
21131,131,21,2018,10135,-116,1,-115,101,173
21131,131,21,2019,9880,-203,2,-201,109,163
21131,131,21,2020,9637,-162,2,-160,96,178
21133,133,21,2010,24534,56,0,56,71,104
21133,133,21,2011,24375,-152,7,-145,312,327
21133,133,21,2012,24009,-354,4,-350,283,310
21133,133,21,2013,23536,-423,4,-419,281,340
21133,133,21,2014,23352,-163,0,-163,289,312
21133,133,21,2015,23043,-290,2,-288,260,282
21133,133,21,2016,22765,-239,2,-237,278,322
21133,133,21,2017,22297,-356,2,-354,255,371
21133,133,21,2018,21847,-373,1,-372,254,333
21133,133,21,2019,21560,-151,1,-150,230,368
21133,133,21,2020,21213,-232,1,-231,228,342
21135,135,21,2010,13836,-10,0,-10,25,60
21135,135,21,2011,13838,-9,-1,-10,167,154
21135,135,21,2012,13840,-25,0,-25,162,133
21135,135,21,2013,13755,-98,0,-98,184,172
21135,135,21,2014,13832,41,0,41,164,127
21135,135,21,2015,13666,-146,0,-146,153,175
21135,135,21,2016,13514,-94,0,-94,127,184
21135,135,21,2017,13369,-101,0,-101,149,194
21135,135,21,2018,13269,-73,0,-73,154,181
21135,135,21,2019,13309,31,0,31,177,169
21135,135,21,2020,13262,-44,0,-44,168,169
21137,137,21,2010,24730,-15,0,-15,86,79
21137,137,21,2011,24728,-79,-1,-80,327,250
21137,137,21,2012,24412,-342,-1,-343,295,275
21137,137,21,2013,24447,-29,-1,-30,345,277
21137,137,21,2014,24438,-31,0,-31,308,281
21137,137,21,2015,24351,-87,-1,-88,324,321
21137,137,21,2016,24367,-21,-2,-23,320,278
21137,137,21,2017,24500,80,-2,78,363,308
21137,137,21,2018,24614,59,-2,57,347,288
21137,137,21,2019,24519,-92,-2,-94,324,325
21137,137,21,2020,24466,-52,-2,-54,317,317
21139,139,21,2010,9520,23,0,23,23,46
21139,139,21,2011,9504,21,1,22,101,139
21139,139,21,2012,9438,-52,5,-47,98,115
21139,139,21,2013,9333,-92,5,-87,109,128
21139,139,21,2014,9330,21,0,21,109,130
21139,139,21,2015,9290,-21,0,-21,95,114
21139,139,21,2016,9199,-47,0,-47,97,140
21139,139,21,2017,9249,90,0,90,92,133
21139,139,21,2018,9222,-2,0,-2,107,131
21139,139,21,2019,9148,-40,0,-40,81,115
21139,139,21,2020,9041,-55,0,-55,82,134
21141,141,21,2010,26854,-15,6,-9,82,50
21141,141,21,2011,26851,-51,17,-34,339,307
21141,141,21,2012,26731,-148,-1,-149,320,294
21141,141,21,2013,26989,168,-2,166,399,307
21141,141,21,2014,26828,-217,-3,-220,355,297
21141,141,21,2015,26761,-49,-1,-50,329,342
21141,141,21,2016,26697,-128,-3,-131,353,285
21141,141,21,2017,27017,329,-1,328,324,331
21141,141,21,2018,27003,-35,-3,-38,348,323
21141,141,21,2019,27111,78,-3,75,377,344
21141,141,21,2020,27416,249,-2,247,377,318
21143,143,21,2010,8329,12,0,12,17,19
21143,143,21,2011,8435,150,0,150,59,105
21143,143,21,2012,8446,49,1,50,62,101
21143,143,21,2013,8454,55,1,56,58,104
21143,143,21,2014,8413,24,-1,23,53,117
21143,143,21,2015,8478,152,-1,151,46,135
21143,143,21,2016,8248,-168,8,-160,47,119
21143,143,21,2017,8293,102,18,120,55,130
21143,143,21,2018,8198,-55,11,-44,52,103
21143,143,21,2019,8256,125,-4,121,48,110
21143,143,21,2020,8133,-33,-4,-37,45,131
21145,145,21,2010,65523,-36,1,-35,168,147
21145,145,21,2011,65808,324,-16,308,775,797
21145,145,21,2012,65609,-161,6,-155,775,804
21145,145,21,2013,65368,-206,27,-179,788,843
21145,145,21,2014,65356,16,10,26,778,802
21145,145,21,2015,64990,-322,20,-302,755,814
21145,145,21,2016,65348,313,23,336,829,802
21145,145,21,2017,65420,46,23,69,817,810
21145,145,21,2018,65391,44,-5,39,738,803
21145,145,21,2019,65622,261,1,262,763,795
21145,145,21,2020,65644,151,-3,148,735,863
21147,147,21,2010,18328,21,0,21,68,66
21147,147,21,2011,18290,-96,-5,-101,240,177
21147,147,21,2012,18062,-278,-1,-279,245,203
21147,147,21,2013,17938,-143,-2,-145,233,212
21147,147,21,2014,17933,-50,4,-46,220,177
21147,147,21,2015,17902,-3,5,2,205,237
21147,147,21,2016,17588,-375,19,-356,232,191
21147,147,21,2017,17421,-144,20,-124,197,240
21147,147,21,2018,17327,-64,4,-60,209,243
21147,147,21,2019,17260,-57,13,-44,200,225
21147,147,21,2020,17071,-194,10,-184,196,201
21149,149,21,2010,9503,-8,1,-7,21,38
21149,149,21,2011,9497,-26,6,-20,128,115
21149,149,21,2012,9478,-23,4,-19,117,117
21149,149,21,2013,9442,-20,1,-19,117,134
21149,149,21,2014,9397,-61,1,-60,123,108
21149,149,21,2015,9385,30,1,31,85,126
21149,149,21,2016,9333,-28,1,-27,100,125
21149,149,21,2017,9202,-109,1,-108,105,127
21149,149,21,2018,9237,43,1,44,114,122
21149,149,21,2019,9162,-55,0,-55,96,115
21149,149,21,2020,9075,-67,0,-67,96,116
21151,151,21,2010,83471,415,19,434,241,166
21151,151,21,2011,84787,966,58,1024,951,666
21151,151,21,2012,85418,254,54,308,1005,677
21151,151,21,2013,85969,114,91,205,1037,678
21151,151,21,2014,87125,767,100,867,977,701
21151,151,21,2015,88274,762,153,915,994,764
21151,151,21,2016,89653,952,163,1115,1050,790
21151,151,21,2017,91259,1235,95,1330,991,726
21151,151,21,2018,92172,787,19,806,979,876
21151,151,21,2019,93099,664,35,699,1030,805
21151,151,21,2020,94265,979,26,1005,1004,843
21153,153,21,2010,13307,-4,0,-4,24,44
21153,153,21,2011,13222,-102,0,-102,166,150
21153,153,21,2012,13066,-179,1,-178,162,145
21153,153,21,2013,12945,-134,1,-133,167,156
21153,153,21,2014,12986,-2,4,2,179,138
21153,153,21,2015,12791,-171,3,-168,144,171
21153,153,21,2016,12673,-126,1,-125,154,147
21153,153,21,2017,12525,-136,1,-135,151,164
21153,153,21,2018,12331,-149,0,-149,130,176
21153,153,21,2019,12184,-115,1,-114,139,173
21153,153,21,2020,12017,-121,0,-121,135,180
21155,155,21,2010,19853,8,11,19,66,74
21155,155,21,2011,20012,62,36,98,254,194
21155,155,21,2012,19929,-121,13,-108,226,203
21155,155,21,2013,19934,-40,22,-18,227,200
21155,155,21,2014,19084,-915,2,-913,226,206
21155,155,21,2015,19219,64,3,67,272,201
21155,155,21,2016,19136,-102,2,-100,237,221
21155,155,21,2017,19284,126,-1,125,241,217
21155,155,21,2018,19314,29,-2,27,239,235
21155,155,21,2019,19237,-105,-2,-107,233,204
21155,155,21,2020,19314,56,-2,54,229,207
21157,157,21,2010,31453,31,4,35,86,116
21157,157,21,2011,31264,-79,9,-70,289,407
21157,157,21,2012,31264,86,12,98,294,391
21157,157,21,2013,31218,53,18,71,306,417
21157,157,21,2014,30997,-150,4,-146,335,406
21157,157,21,2015,31068,146,8,154,347,426
21157,157,21,2016,31277,311,7,318,317,424
21157,157,21,2017,31324,194,0,194,328,475
21157,157,21,2018,31247,35,-4,31,318,426
21157,157,21,2019,31113,45,-6,39,282,454
21157,157,21,2020,31163,233,1,234,278,460
21159,159,21,2010,12894,-38,0,-38,40,39
21159,159,21,2011,12832,-90,3,-87,154,128
21159,159,21,2012,12734,-91,3,-88,148,162
21159,159,21,2013,12661,-64,2,-62,136,146
21159,159,21,2014,12505,-162,-1,-163,133,128
21159,159,21,2015,12299,-209,-1,-210,120,119
21159,159,21,2016,11961,-304,-2,-306,120,153
21159,159,21,2017,11504,-439,-2,-441,119,139
21159,159,21,2018,11349,-114,-2,-116,106,146
21159,159,21,2019,11258,-58,-2,-60,99,130
21159,159,21,2020,11031,-177,-1,-178,102,151
21161,161,21,2010,17503,0,1,1,49,32
21161,161,21,2011,17545,34,-6,28,220,207
21161,161,21,2012,17463,-106,-1,-107,196,171
21161,161,21,2013,17326,-153,3,-150,240,228
21161,161,21,2014,17139,-182,5,-177,207,221
21161,161,21,2015,17052,-39,17,-22,178,242
21161,161,21,2016,17202,99,27,126,233,208
21161,161,21,2017,17221,7,47,54,200,233
21161,161,21,2018,17105,-118,24,-94,209,231
21161,161,21,2019,17049,-34,-2,-36,207,227
21161,161,21,2020,17035,-3,-1,-4,210,221
21163,163,21,2010,28701,53,36,89,77,67
21163,163,21,2011,29638,834,60,894,269,233
21163,163,21,2012,29257,-582,125,-457,265,202
21163,163,21,2013,29245,-136,81,-55,272,227
21163,163,21,2014,29100,-228,38,-190,253,212
21163,163,21,2015,27743,-1467,44,-1423,289,248
21163,163,21,2016,27967,209,15,224,248,249
21163,163,21,2017,28054,84,0,84,266,261
21163,163,21,2018,28648,620,-24,596,268,271
21163,163,21,2019,28610,-21,-7,-28,266,277
21163,163,21,2020,28616,6,-2,4,260,259
21165,165,21,2010,6368,48,0,48,19,10
21165,165,21,2011,6417,44,-1,43,75,68
21165,165,21,2012,6337,-86,0,-86,75,69
21165,165,21,2013,6341,1,-1,0,69,64
21165,165,21,2014,6303,-24,-1,-25,60,72
21165,165,21,2015,6371,76,0,76,79,89
21165,165,21,2016,6450,88,0,88,77,87
21165,165,21,2017,6465,27,0,27,77,88
21165,165,21,2018,6415,-6,0,-6,61,105
21165,165,21,2019,6483,74,0,74,58,63
21165,165,21,2020,6502,50,0,50,60,92
21167,167,21,2010,21318,15,2,17,64,84
21167,167,21,2011,21287,-81,32,-49,247,229
21167,167,21,2012,21333,-38,38,0,287,241
21167,167,21,2013,21300,-24,43,19,210,260
21167,167,21,2014,21365,48,8,56,243,231
21167,167,21,2015,21383,57,13,70,245,293
21167,167,21,2016,21408,29,12,41,249,264
21167,167,21,2017,21557,138,24,162,252,265
21167,167,21,2018,21674,139,12,151,263,296
21167,167,21,2019,21921,301,0,301,238,291
21167,167,21,2020,21889,24,1,25,241,300
21169,169,21,2010,10135,16,0,16,32,18
21169,169,21,2011,10059,-82,2,-80,138,136
21169,169,21,2012,9973,-110,3,-107,135,114
21169,169,21,2013,9952,-18,1,-17,131,134
21169,169,21,2014,9988,22,0,22,129,114
21169,169,21,2015,9917,-76,1,-75,139,135
21169,169,21,2016,10010,102,-1,101,128,135
21169,169,21,2017,10085,95,-1,94,112,130
21169,169,21,2018,10074,-17,-1,-18,130,123
21169,169,21,2019,10084,30,-1,29,118,137
21169,169,21,2020,10058,25,0,25,114,164
21171,171,21,2010,10970,15,1,16,19,27
21171,171,21,2011,10917,-15,11,-4,113,161
21171,171,21,2012,10845,-46,9,-37,127,163
21171,171,21,2013,10712,-127,16,-111,129,152
21171,171,21,2014,10672,-19,3,-16,124,147
21171,171,21,2015,10616,-46,3,-43,139,151
21171,171,21,2016,10536,-46,0,-46,137,172
21171,171,21,2017,10594,81,1,82,135,160
21171,171,21,2018,10746,137,0,137,168,152
21171,171,21,2019,10654,-68,-1,-69,111,132
21171,171,21,2020,10549,-77,0,-77,129,155
21173,173,21,2010,26554,-5,3,-2,119,71
21173,173,21,2011,26762,67,-2,65,388,245
21173,173,21,2012,26870,8,-5,3,380,270
21173,173,21,2013,27243,199,-5,194,412,236
21173,173,21,2014,27381,9,-2,7,378,242
21173,173,21,2015,27594,155,-1,154,374,312
21173,173,21,2016,27692,49,-2,47,368,316
21173,173,21,2017,27954,212,12,224,356,318
21173,173,21,2018,28179,163,0,163,373,311
21173,173,21,2019,28197,8,-12,-4,336,314
21173,173,21,2020,28186,-30,-8,-38,345,319
21175,175,21,2010,13732,-186,1,-185,24,51
21175,175,21,2011,13723,-10,3,-7,139,140
21175,175,21,2012,13538,-198,14,-184,142,149
21175,175,21,2013,13372,-153,3,-150,111,129
21175,175,21,2014,13356,-28,3,-25,144,133
21175,175,21,2015,13279,-55,10,-45,141,172
21175,175,21,2016,13286,-10,23,13,135,141
21175,175,21,2017,13263,-15,15,0,122,145
21175,175,21,2018,13363,119,1,120,114,135
21175,175,21,2019,13297,-39,8,-31,120,156
21175,175,21,2020,13142,-112,6,-106,115,164
21177,177,21,2010,31659,124,0,124,87,68
21177,177,21,2011,31528,-84,0,-84,330,376
21177,177,21,2012,31387,-120,1,-119,337,355
21177,177,21,2013,31332,-9,-1,-10,344,386
21177,177,21,2014,31312,2,0,2,355,369
21177,177,21,2015,31258,4,0,4,363,417
21177,177,21,2016,31151,-86,4,-82,347,370
21177,177,21,2017,30944,-161,1,-160,355,402
21177,177,21,2018,30841,-64,-3,-67,335,370
21177,177,21,2019,30681,-129,-2,-131,378,408
21177,177,21,2020,30457,-143,-3,-146,358,438
21179,179,21,2010,43626,86,-2,84,155,58
21179,179,21,2011,44060,201,-4,197,581,345
21179,179,21,2012,44401,95,0,95,608,355
21179,179,21,2013,44541,-49,1,-48,594,400
21179,179,21,2014,44861,100,-3,97,586,358
21179,179,21,2015,45119,76,1,77,562,375
21179,179,21,2016,45517,260,1,261,576,438
21179,179,21,2017,45606,-18,2,-16,559,452
21179,179,21,2018,45781,98,-3,95,542,461
21179,179,21,2019,46221,304,0,304,568,432
21179,179,21,2020,46450,128,0,128,551,453
21181,181,21,2010,7140,-2,1,-1,15,16
21181,181,21,2011,7101,-29,0,-29,90,100
21181,181,21,2012,7022,-79,0,-79,87,88
21181,181,21,2013,7021,23,1,24,90,114
21181,181,21,2014,7063,40,2,42,96,95
21181,181,21,2015,7072,20,-1,19,89,100
21181,181,21,2016,7091,32,0,32,90,101
21181,181,21,2017,7172,85,0,85,95,100
21181,181,21,2018,7198,35,-1,34,87,95
21181,181,21,2019,7248,70,0,70,78,97
21181,181,21,2020,7234,13,0,13,81,109
21183,183,21,2010,23829,-28,1,-27,83,74
21183,183,21,2011,23986,105,-2,103,301,244
21183,183,21,2012,24029,9,14,23,296,270
21183,183,21,2013,23987,-72,19,-53,305,291
21183,183,21,2014,23964,-18,10,-8,265,277
21183,183,21,2015,24040,91,-5,86,275,283
21183,183,21,2016,24202,139,0,139,322,298
21183,183,21,2017,24137,-40,0,-40,290,313
21183,183,21,2018,24125,-30,-1,-31,293,273
21183,183,21,2019,24043,-66,-1,-67,275,291
21183,183,21,2020,23899,-128,0,-128,269,284
21185,185,21,2010,60441,62,20,82,128,121
21185,185,21,2011,60782,46,72,118,531,309
21185,185,21,2012,62119,1091,63,1154,492,335
21185,185,21,2013,63078,790,29,819,518,377
21185,185,21,2014,63991,807,2,809,498,387
21185,185,21,2015,64586,425,38,463,550,411
21185,185,21,2016,65487,694,35,729,579,401
21185,185,21,2017,66606,920,46,966,585,425
21185,185,21,2018,66632,-147,12,-135,602,444
21185,185,21,2019,66818,59,-11,48,573,431
21185,185,21,2020,66999,71,-1,70,571,454
21187,187,21,2010,10848,-8,1,-7,33,13
21187,187,21,2011,10823,-29,1,-28,99,96
21187,187,21,2012,10762,-70,-1,-71,127,116
21187,187,21,2013,10646,-107,0,-107,101,109
21187,187,21,2014,10659,13,0,13,116,117
21187,187,21,2015,10737,107,0,107,86,115
21187,187,21,2016,10674,-32,0,-32,96,127
21187,187,21,2017,10794,130,0,130,101,110
21187,187,21,2018,10867,98,1,99,103,129
21187,187,21,2019,10884,20,0,20,111,114
21187,187,21,2020,11017,151,0,151,104,121
21189,189,21,2010,4751,14,0,14,10,32
21189,189,21,2011,4810,77,-1,76,53,69
21189,189,21,2012,4685,-88,-1,-89,48,87
21189,189,21,2013,4603,-29,-1,-30,35,86
21189,189,21,2014,4506,-80,0,-80,62,82
21189,189,21,2015,4449,-37,0,-37,53,72
21189,189,21,2016,4480,50,0,50,59,79
21189,189,21,2017,4404,-63,0,-63,57,70
21189,189,21,2018,4454,63,0,63,61,74
21189,189,21,2019,4413,-38,0,-38,55,59
21189,189,21,2020,4331,-54,0,-54,51,78
21191,191,21,2010,14915,27,0,27,32,17
21191,191,21,2011,14662,-261,0,-261,163,155
21191,191,21,2012,14555,-100,0,-100,150,160
21191,191,21,2013,14569,-29,4,-25,175,134
21191,191,21,2014,14484,-118,3,-115,167,136
21191,191,21,2015,14494,-2,10,8,176,173
21191,191,21,2016,14604,70,8,78,183,150
21191,191,21,2017,14609,-29,5,-24,177,148
21191,191,21,2018,14572,-52,1,-51,178,164
21191,191,21,2019,14566,-16,5,-11,192,188
21191,191,21,2020,14586,13,3,16,180,177
21193,193,21,2010,28668,8,0,8,92,128
21193,193,21,2011,28699,53,-2,51,405,425
21193,193,21,2012,28296,-392,-2,-394,409,430
21193,193,21,2013,27989,-315,0,-315,402,399
21193,193,21,2014,27561,-402,1,-401,367,398
21193,193,21,2015,27381,-216,30,-186,417,410
21193,193,21,2016,27222,-205,51,-154,408,413
21193,193,21,2017,26605,-573,36,-537,375,459
21193,193,21,2018,26246,-291,7,-284,344,421
21193,193,21,2019,25801,-323,20,-303,311,453
21193,193,21,2020,25456,-202,15,-187,313,470
21195,195,21,2010,65076,95,2,97,165,222
21195,195,21,2011,64923,-58,-2,-60,733,823
21195,195,21,2012,64605,-263,5,-258,749,804
21195,195,21,2013,63880,-673,14,-659,733,809
21195,195,21,2014,62970,-834,7,-827,750,847
21195,195,21,2015,61831,-1057,24,-1033,710,827
21195,195,21,2016,60475,-1220,27,-1193,637,807
21195,195,21,2017,58958,-1385,12,-1373,618,772
21195,195,21,2018,58567,-213,-1,-214,625,801
21195,195,21,2019,57919,-405,5,-400,578,828
21195,195,21,2020,57057,-571,8,-563,573,869
21197,197,21,2010,12641,16,0,16,37,26
21197,197,21,2011,12617,-9,0,-9,139,153
21197,197,21,2012,12470,-153,-1,-154,167,162
21197,197,21,2013,12470,17,-3,14,165,179
21197,197,21,2014,12347,-115,-3,-118,169,173
21197,197,21,2015,12224,-109,5,-104,170,190
21197,197,21,2016,12256,15,5,20,166,153
21197,197,21,2017,12284,38,-1,37,155,163
21197,197,21,2018,12356,102,-2,100,158,186
21197,197,21,2019,12303,-17,-2,-19,155,189
21197,197,21,2020,12218,-76,-1,-77,162,170
21199,199,21,2010,63195,86,9,95,209,169
21199,199,21,2011,63519,298,16,314,716,705
21199,199,21,2012,63528,13,22,35,770,781
21199,199,21,2013,63815,270,71,341,762,808
21199,199,21,2014,63894,134,41,175,714,797
21199,199,21,2015,63898,47,49,96,734,817
21199,199,21,2016,64061,180,40,220,747,800
21199,199,21,2017,64377,440,35,475,751,908
21199,199,21,2018,64735,398,8,406,812,859
21199,199,21,2019,65243,558,17,575,720,786
21199,199,21,2020,65530,376,13,389,748,851
21201,201,21,2010,2278,-2,0,-2,4,9
21201,201,21,2011,2294,5,0,5,31,20
21201,201,21,2012,2218,-65,0,-65,21,34
21201,201,21,2013,2218,26,0,26,21,47
21201,201,21,2014,2189,-24,0,-24,25,30
21201,201,21,2015,2139,-33,0,-33,20,39
21201,201,21,2016,2137,2,0,2,31,33
21201,201,21,2017,2127,5,0,5,20,36
21201,201,21,2018,2147,31,0,31,25,35
21201,201,21,2019,2149,-1,0,-1,19,17
21201,201,21,2020,2136,-10,0,-10,20,22
21203,203,21,2010,17086,6,0,6,42,21
21203,203,21,2011,17113,61,2,63,165,200
21203,203,21,2012,17063,-39,2,-37,207,217
21203,203,21,2013,16748,-305,3,-302,173,191
21203,203,21,2014,16832,122,0,122,177,214
21203,203,21,2015,16938,128,0,128,169,190
21203,203,21,2016,16879,-41,0,-41,187,203
21203,203,21,2017,16780,-104,-1,-105,171,166
21203,203,21,2018,16830,76,-1,75,194,217
21203,203,21,2019,16736,-31,-1,-32,153,216
21203,203,21,2020,16750,115,-1,114,160,260
21205,205,21,2010,23376,42,-2,40,72,72
21205,205,21,2011,23564,158,-10,148,262,221
21205,205,21,2012,23808,180,8,188,269,226
21205,205,21,2013,24225,315,12,327,302,223
21205,205,21,2014,24267,-40,25,-15,273,211
21205,205,21,2015,24658,315,24,339,272,223
21205,205,21,2016,24436,-255,21,-234,272,259
21205,205,21,2017,24546,57,16,73,279,241
21205,205,21,2018,24488,-95,-3,-98,271,232
21205,205,21,2019,24519,-14,7,-7,256,218
21205,205,21,2020,24682,126,5,131,254,224
21207,207,21,2010,17582,-21,7,-14,59,37
21207,207,21,2011,17712,115,31,146,222,237
21207,207,21,2012,17648,-115,45,-70,229,224
21207,207,21,2013,17759,90,13,103,224,213
21207,207,21,2014,17795,76,2,78,190,230
21207,207,21,2015,17694,-96,7,-89,224,234
21207,207,21,2016,17769,129,5,134,208,266
21207,207,21,2017,17721,1,5,6,215,268
21207,207,21,2018,17799,119,0,119,212,252
21207,207,21,2019,17944,186,-8,178,208,241
21207,207,21,2020,17998,96,-5,91,210,247
21209,209,21,2010,47271,63,7,70,155,43
21209,209,21,2011,47914,292,59,351,589,297
21209,209,21,2012,48976,603,83,686,645,287
21209,209,21,2013,50007,642,67,709,649,339
21209,209,21,2014,51236,833,29,862,667,321
21209,209,21,2015,52177,577,59,636,692,392
21209,209,21,2016,53454,894,40,934,710,369
21209,209,21,2017,54820,1052,44,1096,675,411
21209,209,21,2018,55983,912,13,925,703,470
21209,209,21,2019,57079,816,2,818,695,416
21209,209,21,2020,58470,1121,8,1129,713,448
21211,211,21,2010,42222,103,18,121,149,54
21211,211,21,2011,42891,292,117,409,586,325
21211,211,21,2012,43704,417,136,553,605,352
21211,211,21,2013,44507,353,150,503,621,324
21211,211,21,2014,45135,281,88,369,616,357
21211,211,21,2015,45838,331,122,453,612,364
21211,211,21,2016,46579,437,75,512,598,369
21211,211,21,2017,47216,402,74,476,550,391
21211,211,21,2018,48073,657,16,673,564,381
21211,211,21,2019,49022,755,32,787,553,391
21211,211,21,2020,49611,374,33,407,570,389
21213,213,21,2010,17337,19,-3,16,65,73
21213,213,21,2011,17308,-87,-4,-91,243,182
21213,213,21,2012,17552,217,0,217,231,207
21213,213,21,2013,17692,87,7,94,204,158
21213,213,21,2014,17764,41,13,54,205,184
21213,213,21,2015,17913,85,27,112,239,202
21213,213,21,2016,17995,24,17,41,228,185
21213,213,21,2017,18048,47,10,57,224,227
21213,213,21,2018,18386,341,-2,339,202,204
21213,213,21,2019,18530,137,3,140,230,225
21213,213,21,2020,18635,86,4,90,218,205
21215,215,21,2010,17167,31,-1,30,39,12
21215,215,21,2011,17434,187,-1,186,212,131
21215,215,21,2012,17486,-12,2,-10,191,127
21215,215,21,2013,17645,136,-2,134,155,132
21215,215,21,2014,17782,52,-2,50,205,116
21215,215,21,2015,18043,191,8,199,204,143
21215,215,21,2016,18298,224,12,236,174,155
21215,215,21,2017,18583,235,13,248,197,160
21215,215,21,2018,18959,316,6,322,195,140
21215,215,21,2019,19302,292,-2,290,198,145
21215,215,21,2020,19585,271,-2,269,189,174
21217,217,21,2010,24635,149,11,160,74,90
21217,217,21,2011,24952,253,40,293,304,280
21217,217,21,2012,25035,9,30,39,309,260
21217,217,21,2013,25125,-2,63,61,340,307
21217,217,21,2014,25330,83,37,120,362,276
21217,217,21,2015,25562,146,59,205,306,277
21217,217,21,2016,25420,-227,36,-191,360,310
21217,217,21,2017,25517,33,38,71,340,314
21217,217,21,2018,25483,-64,13,-51,328,310
21217,217,21,2019,25735,225,24,249,310,306
21217,217,21,2020,25707,-4,20,16,307,352
21219,219,21,2010,12426,-35,6,-29,48,50
21219,219,21,2011,12423,-51,26,-25,158,135
21219,219,21,2012,12617,103,17,120,196,123
21219,219,21,2013,12476,-224,8,-216,193,120
21219,219,21,2014,12432,-69,-3,-72,155,127
21219,219,21,2015,12449,-65,6,-59,186,111
21219,219,21,2016,12364,-135,7,-128,199,157
21219,219,21,2017,12203,-203,35,-168,158,151
21219,219,21,2018,12339,87,18,105,183,148
21219,219,21,2019,12318,-63,-7,-70,169,122
21219,219,21,2020,12448,97,-4,93,170,131
21221,221,21,2010,14321,30,0,30,27,61
21221,221,21,2011,14216,-78,0,-78,141,169
21221,221,21,2012,14412,183,-1,182,153,142
21221,221,21,2013,14306,-70,4,-66,151,189
21221,221,21,2014,14133,-133,3,-130,146,189
21221,221,21,2015,14222,103,1,104,146,162
21221,221,21,2016,14309,87,5,92,160,163
21221,221,21,2017,14426,136,2,138,152,173
21221,221,21,2018,14666,250,0,250,162,172
21221,221,21,2019,14666,3,1,4,161,164
21221,221,21,2020,14776,134,1,135,165,188
21223,223,21,2010,8809,-14,-1,-15,27,8
21223,223,21,2011,8812,-29,9,-20,95,73
21223,223,21,2012,8843,1,0,1,106,76
21223,223,21,2013,8808,-40,-2,-42,97,89
21223,223,21,2014,8726,-85,0,-85,90,89
21223,223,21,2015,8739,15,0,15,99,100
21223,223,21,2016,8593,-112,1,-111,87,123
21223,223,21,2017,8535,-55,5,-50,94,100
21223,223,21,2018,8500,-18,2,-16,82,101
21223,223,21,2019,8529,26,-2,24,100,95
21223,223,21,2020,8481,-31,-2,-33,92,109
21225,225,21,2010,15274,250,0,250,39,53
21225,225,21,2011,15264,-14,0,-14,163,159
21225,225,21,2012,15092,-207,10,-197,159,139
21225,225,21,2013,15078,-38,5,-33,178,159
21225,225,21,2014,15093,3,2,5,179,166
21225,225,21,2015,14976,-101,-2,-103,173,187
21225,225,21,2016,14795,-171,6,-165,158,175
21225,225,21,2017,14656,-118,5,-113,168,194
21225,225,21,2018,14519,-82,-2,-84,142,195
21225,225,21,2019,14497,-43,3,-40,160,143
21225,225,21,2020,14443,-36,2,-34,151,172
21227,227,21,2010,114348,238,101,339,370,161
21227,227,21,2011,115889,545,457,1002,1445,908
21227,227,21,2012,117436,426,568,994,1477,913
21227,227,21,2013,119640,792,801,1593,1567,964
21227,227,21,2014,121480,702,544,1246,1516,920
21227,227,21,2015,124224,1357,674,2031,1658,960
21227,227,21,2016,126752,1046,780,1826,1714,1013
21227,227,21,2017,129232,1287,593,1880,1653,1056
21227,227,21,2018,130926,900,124,1024,1714,1043
21227,227,21,2019,132759,821,309,1130,1751,1049
21227,227,21,2020,134510,850,254,1104,1728,1086
21229,229,21,2010,11683,15,0,15,21,54
21229,229,21,2011,11679,13,-1,12,117,134
21229,229,21,2012,11813,117,17,134,139,143
21229,229,21,2013,11843,-41,36,-5,165,130
21229,229,21,2014,11895,8,17,25,149,120
21229,229,21,2015,12000,90,23,113,130,138
21229,229,21,2016,12095,81,13,94,141,139
21229,229,21,2017,11871,-222,15,-207,135,155
21229,229,21,2018,12011,117,3,120,150,130
21229,229,21,2019,12098,74,0,74,156,144
21229,229,21,2020,12147,37,0,37,158,146
21231,231,21,2010,20833,3,1,4,54,21
21231,231,21,2011,20890,39,8,47,215,204
21231,231,21,2012,20816,-82,3,-79,237,233
21231,231,21,2013,20778,-69,7,-62,247,220
21231,231,21,2014,20615,-134,12,-122,210,249
21231,231,21,2015,20606,9,1,10,250,267
21231,231,21,2016,20726,102,-3,99,256,234
21231,231,21,2017,20621,-110,-3,-113,250,241
21231,231,21,2018,20401,-179,-3,-182,212,250
21231,231,21,2019,20278,-107,-3,-110,221,234
21231,231,21,2020,20209,-29,-2,-31,213,253
21233,233,21,2010,13579,-30,4,-26,42,56
21233,233,21,2011,13530,-42,9,-33,167,184
21233,233,21,2012,13461,-42,10,-32,133,167
21233,233,21,2013,13359,-104,12,-92,154,166
21233,233,21,2014,13184,-168,10,-158,150,170
21233,233,21,2015,13153,-45,12,-33,169,166
21233,233,21,2016,13180,31,9,40,162,173
21233,233,21,2017,13012,-159,4,-155,166,179
21233,233,21,2018,13047,11,0,11,190,168
21233,233,21,2019,12945,-138,2,-136,184,149
21233,233,21,2020,12923,-50,2,-48,175,148
21235,235,21,2010,35718,19,10,29,130,77
21235,235,21,2011,35863,61,20,81,531,467
21235,235,21,2012,35784,-184,8,-176,528,433
21235,235,21,2013,35892,68,11,79,519,483
21235,235,21,2014,35864,-171,10,-161,601,468
21235,235,21,2015,36143,196,15,211,600,527
21235,235,21,2016,36116,-143,36,-107,557,476
21235,235,21,2017,36135,-61,33,-28,588,540
21235,235,21,2018,36196,13,4,17,542,496
21235,235,21,2019,36362,141,19,160,508,503
21235,235,21,2020,36451,45,14,59,511,482
21237,237,21,2010,7364,-4,0,-4,26,14
21237,237,21,2011,7365,-13,0,-13,106,93
21237,237,21,2012,7197,-154,0,-154,84,104
21237,237,21,2013,7282,106,0,106,88,110
21237,237,21,2014,7255,-12,0,-12,83,97
21237,237,21,2015,7247,12,-1,11,86,103
21237,237,21,2016,7203,-17,0,-17,100,127
21237,237,21,2017,7264,64,0,64,99,102
21237,237,21,2018,7215,-34,-1,-35,85,99
21237,237,21,2019,7151,-41,0,-41,87,111
21237,237,21,2020,7106,3,0,3,80,128
21239,239,21,2010,25040,50,0,50,82,35
21239,239,21,2011,24943,-184,14,-170,292,220
21239,239,21,2012,25114,86,45,131,257,211
21239,239,21,2013,25344,162,21,183,273,225
21239,239,21,2014,25584,195,-4,191,275,223
21239,239,21,2015,25860,239,13,252,275,252
21239,239,21,2016,26147,175,13,188,338,237
21239,239,21,2017,26375,193,16,209,272,252
21239,239,21,2018,26487,73,-4,69,292,249
21239,239,21,2019,26654,178,-13,165,251,248
21239,239,21,2020,26765,119,-6,113,266,266
22001,001,22,2010,61876,-9,6,-3,210,113
22001,001,22,2011,61872,-223,40,-183,871,691
22001,001,22,2012,62007,-140,25,-115,879,619
22001,001,22,2013,62310,66,56,122,880,690
22001,001,22,2014,62681,30,39,69,918,601
22001,001,22,2015,62696,-245,36,-209,899,674
22001,001,22,2016,62830,-236,46,-190,937,611
22001,001,22,2017,62581,-509,24,-485,865,630
22001,001,22,2018,62315,-461,24,-437,848,678
22001,001,22,2019,62207,-266,41,-225,806,692
22001,001,22,2020,61918,-371,33,-338,802,753
22003,003,22,2010,25704,-43,3,-40,78,85
22003,003,22,2011,25740,-92,25,-67,348,246
22003,003,22,2012,25619,-189,-2,-191,313,243
22003,003,22,2013,25660,-74,0,-74,349,231
22003,003,22,2014,25710,10,1,11,325,279
22003,003,22,2015,25630,-132,10,-122,310,268
22003,003,22,2016,25696,-21,19,-2,309,240
22003,003,22,2017,25595,-129,12,-117,311,294
22003,003,22,2018,25535,-111,8,-103,315,271
22003,003,22,2019,25594,-21,16,-5,303,240
22003,003,22,2020,25440,-198,18,-180,297,269
22005,005,22,2010,107894,385,5,390,369,110
22005,005,22,2011,110084,1072,124,1196,1655,665
22005,005,22,2012,112238,1183,31,1214,1539,621
22005,005,22,2013,114665,1310,139,1449,1634,681
22005,005,22,2014,117318,1603,45,1648,1716,741
22005,005,22,2015,119417,1063,77,1140,1716,759
22005,005,22,2016,121646,1082,123,1205,1736,712
22005,005,22,2017,123237,553,57,610,1743,758
22005,005,22,2018,124961,718,57,775,1710,759
22005,005,22,2019,126798,1002,118,1120,1655,937
22005,005,22,2020,128665,1125,91,1216,1680,1029
22007,007,22,2010,23332,-62,1,-61,60,86
22007,007,22,2011,23186,-207,11,-196,252,203
22007,007,22,2012,23071,-174,4,-170,266,212
22007,007,22,2013,23201,48,22,70,276,214
22007,007,22,2014,23052,-195,22,-173,245,222
22007,007,22,2015,22902,-210,11,-199,267,218
22007,007,22,2016,22773,-183,18,-165,265,231
22007,007,22,2017,22586,-234,7,-227,259,220
22007,007,22,2018,22280,-318,5,-313,241,233
22007,007,22,2019,21921,-408,18,-390,243,212
22007,007,22,2020,21621,-299,10,-289,231,240
22009,009,22,2010,42115,-7,2,-5,127,81
22009,009,22,2011,41805,-390,26,-364,568,515
22009,009,22,2012,41584,-310,22,-288,581,515
22009,009,22,2013,41288,-341,34,-307,530,520
22009,009,22,2014,41101,-231,22,-209,561,537
22009,009,22,2015,40992,-220,5,-215,560,450
22009,009,22,2016,40970,-117,15,-102,537,455
22009,009,22,2017,40840,-182,6,-176,542,494
22009,009,22,2018,40410,-451,3,-448,551,536
22009,009,22,2019,40138,-309,14,-295,500,477
22009,009,22,2020,39966,-191,12,-179,497,490
22011,011,22,2010,35832,139,7,146,137,113
22011,011,22,2011,36101,103,20,123,460,313
22011,011,22,2012,36346,10,50,60,509,317
22011,011,22,2013,36281,-242,36,-206,484,344
22011,011,22,2014,36264,-137,26,-111,491,391
22011,011,22,2015,36557,105,55,160,497,360
22011,011,22,2016,37028,261,41,302,532,361
22011,011,22,2017,36885,-224,31,-193,482,433
22011,011,22,2018,37491,387,36,423,554,370
22011,011,22,2019,37649,34,33,67,501,411
22011,011,22,2020,37881,136,30,166,513,449
22013,013,22,2010,14307,-6,0,-6,29,71
22013,013,22,2011,14262,-12,-2,-14,190,219
22013,013,22,2012,14195,-71,-1,-72,211,206
22013,013,22,2013,13966,-190,1,-189,172,215
22013,013,22,2014,13789,-119,0,-119,158,216
22013,013,22,2015,13828,66,2,68,179,207
22013,013,22,2016,13796,-29,7,-22,174,185
22013,013,22,2017,13640,-130,4,-126,151,181
22013,013,22,2018,13303,-306,5,-301,170,206
22013,013,22,2019,13234,-65,5,-60,155,165
22013,013,22,2020,12983,-196,5,-191,155,213
22015,015,22,2010,117637,305,63,368,433,170
22015,015,22,2011,120122,1510,157,1667,1754,944
22015,015,22,2012,123177,1743,323,2066,1852,935
22015,015,22,2013,124049,-286,339,53,1802,970
22015,015,22,2014,124922,-177,241,64,1837,1015
22015,015,22,2015,125634,-347,263,-84,1837,1026
22015,015,22,2016,125946,-560,161,-399,1790,1078
22015,015,22,2017,127011,394,28,422,1700,1054
22015,015,22,2018,127153,-411,-44,-455,1672,1075
22015,015,22,2019,127377,-455,117,-338,1676,1118
22015,015,22,2020,127275,-633,100,-533,1635,1207
22017,017,22,2010,255652,255,52,307,981,597
22017,017,22,2011,257058,32,151,183,3871,2639
22017,017,22,2012,257367,-1094,193,-901,3863,2625
22017,017,22,2013,255248,-3289,177,-3112,3800,2864
22017,017,22,2014,252740,-3712,157,-3555,3767,2782
22017,017,22,2015,251499,-2308,171,-2137,3628,2735
22017,017,22,2016,249024,-3343,170,-3173,3452,2758
22017,017,22,2017,246177,-3437,56,-3381,3308,2785
22017,017,22,2018,243105,-3525,47,-3478,3202,2798
22017,017,22,2019,240431,-2991,132,-2859,2976,2786
22017,017,22,2020,237479,-3032,103,-2929,2918,2925
22019,019,22,2010,193023,137,37,174,597,498
22019,019,22,2011,193881,-85,200,115,2610,1857
22019,019,22,2012,194516,-374,114,-260,2727,1810
22019,019,22,2013,195550,59,195,254,2741,1928
22019,019,22,2014,196641,241,113,354,2771,1991
22019,019,22,2015,198542,1001,168,1169,2764,2023
22019,019,22,2016,200780,1004,255,1259,3014,2033
22019,019,22,2017,202653,779,133,912,3011,2044
22019,019,22,2018,203507,-189,141,-48,3022,2115
22019,019,22,2019,204038,-650,194,-456,3008,2027
22019,019,22,2020,203310,-1655,173,-1482,2969,2214
22021,021,22,2010,10148,1,0,1,38,15
22021,021,22,2011,10123,-55,4,-51,140,115
22021,021,22,2012,10040,-34,1,-33,103,151
22021,021,22,2013,9986,-50,17,-33,103,124
22021,021,22,2014,9953,-54,12,-42,135,124
22021,021,22,2015,10048,75,0,75,144,124
22021,021,22,2016,10069,11,12,23,115,116
22021,021,22,2017,9962,-129,0,-129,140,119
22021,021,22,2018,9979,46,-1,45,124,153
22021,021,22,2019,9946,-41,5,-36,122,118
22021,021,22,2020,9839,-96,5,-91,122,137
22023,023,22,2010,6915,44,0,44,18,18
22023,023,22,2011,6672,-281,-1,-282,76,40
22023,023,22,2012,6630,-54,-1,-55,52,39
22023,023,22,2013,6711,70,0,70,53,44
22023,023,22,2014,6724,-20,0,-20,70,35
22023,023,22,2015,6821,78,-2,76,70,50
22023,023,22,2016,6888,59,-4,55,70,57
22023,023,22,2017,6935,18,-3,15,77,45
22023,023,22,2018,7008,60,-2,58,72,56
22023,023,22,2019,6981,-45,-6,-51,78,55
22023,023,22,2020,7003,29,-3,26,74,77
22025,025,22,2010,10379,-17,1,-16,30,43
22025,025,22,2011,10289,-104,20,-84,125,131
22025,025,22,2012,10243,-46,5,-41,111,114
22025,025,22,2013,10254,4,20,24,141,153
22025,025,22,2014,10133,-121,11,-110,128,139
22025,025,22,2015,10034,-84,21,-63,118,155
22025,025,22,2016,9863,-155,1,-154,127,143
22025,025,22,2017,9812,-54,1,-53,129,127
22025,025,22,2018,9571,-218,1,-217,108,132
22025,025,22,2019,9459,-111,1,-110,100,101
22025,025,22,2020,9226,-205,1,-204,99,127
22027,027,22,2010,17174,-46,2,-44,40,18
22027,027,22,2011,16940,-219,22,-197,163,202
22027,027,22,2012,16869,-59,4,-55,180,193
22027,027,22,2013,16665,-174,5,-169,162,201
22027,027,22,2014,16406,-258,0,-258,184,190
22027,027,22,2015,16271,-118,1,-117,160,178
22027,027,22,2016,16168,-85,4,-81,181,203
22027,027,22,2017,15964,-154,1,-153,150,200
22027,027,22,2018,15912,-4,0,-4,133,181
22027,027,22,2019,15718,-142,2,-140,123,177
22027,027,22,2020,15508,-118,1,-117,118,209
22029,029,22,2010,20840,-19,1,-18,70,33
22029,029,22,2011,20844,1,0,1,247,244
22029,029,22,2012,20502,-438,-4,-442,301,211
22029,029,22,2013,20504,5,-4,1,258,255
22029,029,22,2014,20484,0,1,1,253,270
22029,029,22,2015,20233,-263,-4,-267,266,251
22029,029,22,2016,19971,-261,1,-260,260,263
22029,029,22,2017,19850,-145,-4,-149,267,240
22029,029,22,2018,19618,-235,-4,-239,266,259
22029,029,22,2019,19314,-304,-4,-308,245,242
22029,029,22,2020,18914,-381,-2,-383,243,256
22031,031,22,2010,26670,54,2,56,57,100
22031,031,22,2011,26782,44,3,47,338,273
22031,031,22,2012,27028,150,1,151,398,298
22031,031,22,2013,27096,4,2,6,348,282
22031,031,22,2014,27069,-74,2,-72,331,283
22031,031,22,2015,27112,-22,-1,-23,363,296
22031,031,22,2016,27194,49,0,49,332,296
22031,031,22,2017,27281,62,-2,60,338,309
22031,031,22,2018,27412,136,-1,135,307,308
22031,031,22,2019,27440,6,-1,5,318,297
22031,031,22,2020,27650,210,0,210,316,316
22033,033,22,2010,440937,-216,184,-32,1412,936
22033,033,22,2011,441627,-2830,973,-1857,5998,3457
22033,033,22,2012,443075,-1563,602,-961,6017,3544
22033,033,22,2013,444345,-1872,735,-1137,6131,3696
22033,033,22,2014,445334,-2176,697,-1479,6196,3695
22033,033,22,2015,445776,-2981,1060,-1921,6198,3834
22033,033,22,2016,447020,-2325,1130,-1195,6212,3763
22033,033,22,2017,444848,-4970,691,-4279,5965,3874
22033,033,22,2018,442720,-4770,692,-4078,5916,3974
22033,033,22,2019,441471,-4074,1078,-2996,5704,3969
22033,033,22,2020,439729,-4013,862,-3151,5610,4199
22035,035,22,2010,7737,-40,0,-40,23,6
22035,035,22,2011,7658,-122,-2,-124,126,82
22035,035,22,2012,7578,-145,-1,-146,127,65
22035,035,22,2013,7499,-84,-1,-85,115,108
22035,035,22,2014,7444,-113,-1,-114,139,83
22035,035,22,2015,7279,-197,-1,-198,114,83
22035,035,22,2016,7230,-57,-1,-58,94,85
22035,035,22,2017,7117,-144,-2,-146,119,86
22035,035,22,2018,6971,-128,-2,-130,71,87
22035,035,22,2019,6829,-148,-2,-150,73,64
22035,035,22,2020,6589,-228,-2,-230,69,76
22037,037,22,2010,20150,-86,0,-86,62,83
22037,037,22,2011,20079,-87,-2,-89,202,184
22037,037,22,2012,19852,-202,-1,-203,209,237
22037,037,22,2013,19596,-205,-2,-207,213,261
22037,037,22,2014,19672,100,-2,98,221,239
22037,037,22,2015,19534,-110,0,-110,218,244
22037,037,22,2016,19500,-1,4,3,197,232
22037,037,22,2017,19383,-66,3,-63,220,273
22037,037,22,2018,19272,-65,3,-62,209,257
22037,037,22,2019,19103,-122,4,-118,167,218
22037,037,22,2020,18882,-150,4,-146,172,246
22039,039,22,2010,33954,-17,2,-15,119,131
22039,039,22,2011,33840,-276,58,-218,465,361
22039,039,22,2012,33745,-303,44,-259,504,346
22039,039,22,2013,33824,-78,70,-8,466,375
22039,039,22,2014,33759,-269,79,-190,486,362
22039,039,22,2015,33728,-223,71,-152,493,372
22039,039,22,2016,33671,-248,77,-171,505,390
22039,039,22,2017,33655,-197,53,-144,473,346
22039,039,22,2018,33457,-338,57,-281,470,386
22039,039,22,2019,33396,-246,77,-169,508,401
22039,039,22,2020,33276,-240,62,-178,480,422
22041,041,22,2010,20810,10,0,10,79,44
22041,041,22,2011,20774,-65,1,-64,292,263
22041,041,22,2012,20580,-237,0,-237,297,262
22041,041,22,2013,20519,-38,2,-36,263,283
22041,041,22,2014,20441,-66,1,-65,283,292
22041,041,22,2015,20397,-51,1,-50,278,270
22041,041,22,2016,20393,-39,1,-38,322,287
22041,041,22,2017,20265,-133,1,-132,275,271
22041,041,22,2018,20170,-112,1,-111,266,250
22041,041,22,2019,19996,-141,1,-140,255,289
22041,041,22,2020,19723,-222,1,-221,245,294
22043,043,22,2010,22346,33,3,36,69,78
22043,043,22,2011,22397,-12,17,5,241,195
22043,043,22,2012,22402,-36,0,-36,255,208
22043,043,22,2013,22317,-107,21,-86,234,231
22043,043,22,2014,22377,-32,12,-20,288,204
22043,043,22,2015,22327,-86,7,-79,238,207
22043,043,22,2016,22324,-51,19,-32,259,229
22043,043,22,2017,22330,-38,5,-33,229,188
22043,043,22,2018,22430,85,4,89,262,252
22043,043,22,2019,22352,-114,10,-104,246,220
22043,043,22,2020,22254,-140,9,-131,242,209
22045,045,22,2010,72882,-100,14,-86,253,141
22045,045,22,2011,73216,-317,216,-101,1090,656
22045,045,22,2012,73446,-100,38,-62,984,675
22045,045,22,2013,73628,-303,154,-149,1089,756
22045,045,22,2014,73518,-532,89,-443,1072,744
22045,045,22,2015,73548,-438,39,-399,1160,731
22045,045,22,2016,72753,-1183,70,-1113,1051,737
22045,045,22,2017,71805,-1287,18,-1269,1055,738
22045,045,22,2018,70627,-1342,11,-1331,952,803
22045,045,22,2019,69638,-1214,50,-1164,917,741
22045,045,22,2020,68991,-736,41,-695,888,836
22047,047,22,2010,33389,-62,5,-57,85,42
22047,047,22,2011,33364,-191,25,-166,425,284
22047,047,22,2012,33332,-208,9,-199,451,284
22047,047,22,2013,33395,-50,22,-28,432,335
22047,047,22,2014,33142,-271,-4,-275,375,356
22047,047,22,2015,33149,-29,-4,-33,398,354
22047,047,22,2016,32865,-302,-1,-303,367,348
22047,047,22,2017,32927,20,-1,19,388,344
22047,047,22,2018,32719,-243,-2,-245,379,341
22047,047,22,2019,32549,-221,0,-221,383,332
22047,047,22,2020,32070,-514,0,-514,377,339
22049,049,22,2010,16309,13,0,13,47,23
22049,049,22,2011,16362,29,0,29,205,180
22049,049,22,2012,16280,-96,-1,-97,173,157
22049,049,22,2013,16150,-96,-2,-98,169,200
22049,049,22,2014,16013,-90,2,-88,166,213
22049,049,22,2015,15971,-65,2,-63,200,177
22049,049,22,2016,15903,-35,5,-30,156,193
22049,049,22,2017,15927,44,2,46,174,195
22049,049,22,2018,15944,51,1,52,163,198
22049,049,22,2019,15761,-124,-1,-125,140,199
22049,049,22,2020,15574,-79,1,-78,133,242
22051,051,22,2010,432618,-732,320,-412,1358,902
22051,051,22,2011,434133,-2159,1777,-382,5833,3931
22051,051,22,2012,434049,-2635,950,-1685,5616,3993
22051,051,22,2013,434394,-2306,1338,-968,5616,4267
22051,051,22,2014,434235,-3024,1206,-1818,5806,4117
22051,051,22,2015,435358,-2569,1738,-831,6001,4024
22051,051,22,2016,436865,-2161,1777,-384,6033,4126
22051,051,22,2017,436571,-3070,1265,-1805,5816,4291
22051,051,22,2018,434637,-4690,1375,-3315,5738,4356
22051,051,22,2019,434096,-3646,1872,-1774,5588,4349
22051,051,22,2020,432346,-4000,1474,-2526,5467,4679
22053,053,22,2010,31629,-1,2,1,98,56
22053,053,22,2011,31595,-99,9,-90,396,339
22053,053,22,2012,31452,-236,3,-233,453,363
22053,053,22,2013,31305,-186,4,-182,427,394
22053,053,22,2014,31462,95,5,100,440,376
22053,053,22,2015,31449,-110,4,-106,457,363
22053,053,22,2016,31399,-131,13,-118,436,367
22053,053,22,2017,31502,62,9,71,425,391
22053,053,22,2018,31574,69,8,77,413,417
22053,053,22,2019,31444,-168,11,-157,411,384
22053,053,22,2020,31208,-212,9,-203,398,432
22055,055,22,2010,222513,65,79,144,754,336
22055,055,22,2011,224898,333,611,944,3084,1638
22055,055,22,2012,227554,924,237,1161,3130,1626
22055,055,22,2013,231757,2058,386,2444,3407,1693
22055,055,22,2014,235999,2078,292,2370,3492,1655
22055,055,22,2015,239654,1580,354,1934,3482,1760
22055,055,22,2016,241611,-148,378,230,3477,1738
22055,055,22,2017,242039,-1359,162,-1197,3369,1748
22055,055,22,2018,243493,-193,158,-35,3283,1791
22055,055,22,2019,244798,-196,323,127,3194,2026
22055,055,22,2020,246518,471,260,731,3157,2188
22057,057,22,2010,96693,-63,32,-31,293,156
22057,057,22,2011,97031,-258,224,-34,1169,795
22057,057,22,2012,97131,-352,83,-269,1232,855
22057,057,22,2013,97235,-335,137,-198,1211,903
22057,057,22,2014,97849,220,97,317,1253,939
22057,057,22,2015,98279,-110,108,-2,1325,881
22057,057,22,2016,98493,-348,109,-239,1331,877
22057,057,22,2017,98078,-764,49,-715,1207,907
22057,057,22,2018,97910,-471,48,-423,1211,958
22057,057,22,2019,97618,-624,96,-528,1141,905
22057,057,22,2020,97596,-233,74,-159,1116,984
22059,059,22,2010,14909,32,1,33,46,58
22059,059,22,2011,14941,11,11,22,170,160
22059,059,22,2012,14860,-73,4,-69,150,160
22059,059,22,2013,14819,-51,24,-27,181,192
22059,059,22,2014,14873,23,15,38,185,166
22059,059,22,2015,14975,64,10,74,170,141
22059,059,22,2016,15028,9,17,26,186,158
22059,059,22,2017,14893,-146,6,-140,190,186
22059,059,22,2018,14900,-12,6,-6,188,174
22059,059,22,2019,14910,-22,12,-10,170,150
22059,059,22,2020,15021,119,7,126,176,191
22061,061,22,2010,46854,14,44,58,126,67
22061,061,22,2011,47068,-232,229,-3,574,359
22061,061,22,2012,47039,-407,117,-290,570,309
22061,061,22,2013,47257,-124,139,15,591,388
22061,061,22,2014,47227,-334,132,-202,565,397
22061,061,22,2015,47469,-109,156,47,588,390
22061,061,22,2016,47520,-370,166,-204,595,341
22061,061,22,2017,47494,-277,73,-204,573,398
22061,061,22,2018,47174,-514,70,-444,543,420
22061,061,22,2019,46851,-536,117,-419,504,410
22061,061,22,2020,46552,-439,91,-348,502,452
22063,063,22,2010,128351,369,15,384,445,190
22063,063,22,2011,129858,581,69,650,1769,912
22063,063,22,2012,131521,808,-12,796,1792,921
22063,063,22,2013,133726,1386,31,1417,1826,1058
22063,063,22,2014,135241,689,5,694,1894,1067
22063,063,22,2015,137202,1158,22,1180,1865,1086
22063,063,22,2016,139822,1655,75,1730,1967,1079
22063,063,22,2017,137907,-2692,59,-2633,1777,1072
22063,063,22,2018,139594,882,71,953,1872,1137
22063,063,22,2019,141561,1290,59,1349,1753,1135
22063,063,22,2020,143737,1622,55,1677,1775,1269
22065,065,22,2010,12107,-8,0,-8,33,17
22065,065,22,2011,11978,-172,-1,-173,187,144
22065,065,22,2012,12215,167,-1,166,192,128
22065,065,22,2013,11912,-370,0,-370,168,112
22065,065,22,2014,11826,-133,0,-133,180,135
22065,065,22,2015,11560,-300,0,-300,176,144
22065,065,22,2016,11497,-89,0,-89,158,131
22065,065,22,2017,11349,-164,0,-164,142,128
22065,065,22,2018,11212,-173,0,-173,174,139
22065,065,22,2019,10994,-244,0,-244,146,120
22065,065,22,2020,10635,-335,0,-335,137,157
22067,067,22,2010,27873,-67,1,-66,92,135
22067,067,22,2011,27482,-398,8,-390,384,386
22067,067,22,2012,27378,-110,6,-104,365,365
22067,067,22,2013,26938,-412,8,-404,335,376
22067,067,22,2014,26654,-286,5,-281,374,382
22067,067,22,2015,26307,-337,-1,-338,377,388
22067,067,22,2016,25911,-409,0,-409,371,357
22067,067,22,2017,25664,-256,-1,-257,353,344
22067,067,22,2018,25304,-285,-1,-286,328,402
22067,067,22,2019,24839,-426,-1,-427,305,343
22067,067,22,2020,24227,-538,0,-538,293,363
22069,069,22,2010,39523,-29,1,-28,117,124
22069,069,22,2011,39385,-346,20,-326,565,378
22069,069,22,2012,39341,-196,-2,-198,530,370
22069,069,22,2013,39122,-422,28,-394,557,387
22069,069,22,2014,39131,-154,12,-142,529,374
22069,069,22,2015,39018,-251,31,-220,507,397
22069,069,22,2016,39016,-109,31,-78,505,428
22069,069,22,2017,39051,-82,18,-64,539,438
22069,069,22,2018,38623,-507,17,-490,458,398
22069,069,22,2019,38179,-535,26,-509,456,391
22069,069,22,2020,37655,-557,21,-536,440,424
22071,071,22,2010,347789,3094,171,3265,1034,646
22071,071,22,2011,360822,10269,863,11132,4667,2858
22071,071,22,2012,369947,6476,679,7155,4699,2978
22071,071,22,2013,378863,6336,750,7086,4729,3113
22071,071,22,2014,384228,2786,689,3475,4974,3162
22071,071,22,2015,390094,2995,972,3967,5047,3189
22071,071,22,2016,392265,-472,792,320,5030,3166
22071,071,22,2017,391819,-2197,434,-1763,4690,3360
22071,071,22,2018,391506,-1950,441,-1509,4695,3488
22071,071,22,2019,391172,-2053,696,-1357,4514,3491
22071,071,22,2020,389476,-2741,561,-2180,4445,3961
22073,073,22,2010,153966,-12,28,16,502,272
22073,073,22,2011,154654,-245,143,-102,2303,1508
22073,073,22,2012,155265,-328,51,-277,2334,1425
22073,073,22,2013,156075,15,103,118,2202,1482
22073,073,22,2014,156383,-561,86,-475,2357,1557
22073,073,22,2015,156916,-314,95,-219,2303,1534
22073,073,22,2016,156948,-705,93,-612,2243,1594
22073,073,22,2017,155913,-1726,61,-1665,2181,1553
22073,073,22,2018,154694,-1753,56,-1697,2119,1649
22073,073,22,2019,153401,-1719,95,-1624,2013,1681
22073,073,22,2020,152439,-1256,86,-1170,1985,1777
22075,075,22,2010,23120,30,-1,29,68,12
22075,075,22,2011,23588,348,-3,345,298,176
22075,075,22,2012,23836,130,24,154,278,182
22075,075,22,2013,23520,-462,16,-446,318,196
22075,075,22,2014,23323,-372,28,-344,312,175
22075,075,22,2015,23462,-38,45,7,311,178
22075,075,22,2016,23360,-261,37,-224,296,176
22075,075,22,2017,23376,-89,12,-77,286,192
22075,075,22,2018,23411,-54,12,-42,277,200
22075,075,22,2019,23264,-272,29,-243,263,168
22075,075,22,2020,23113,-225,24,-201,257,206
22077,077,22,2010,22814,-26,5,-21,60,24
22077,077,22,2011,22804,-118,25,-93,294,212
22077,077,22,2012,22676,-195,3,-192,306,245
22077,077,22,2013,22424,-262,6,-256,278,277
22077,077,22,2014,22309,-113,5,-108,268,272
22077,077,22,2015,22197,-92,-3,-95,280,295
22077,077,22,2016,22126,-126,8,-118,294,243
22077,077,22,2017,22170,60,-2,58,245,259
22077,077,22,2018,21856,-299,-4,-303,267,276
22077,077,22,2019,21735,-143,2,-141,260,240
22077,077,22,2020,21529,-192,2,-190,254,270
22079,079,22,2010,131742,5,19,24,431,292
22079,079,22,2011,132019,-354,115,-239,1802,1282
22079,079,22,2012,132022,-473,93,-380,1771,1377
22079,079,22,2013,132337,-82,139,57,1774,1497
22079,079,22,2014,132229,-696,94,-602,1857,1357
22079,079,22,2015,131821,-849,54,-795,1880,1489
22079,079,22,2016,131838,-452,67,-385,1804,1398
22079,079,22,2017,131272,-927,16,-911,1846,1502
22079,079,22,2018,130404,-1038,14,-1024,1715,1560
22079,079,22,2019,129800,-863,57,-806,1689,1490
22079,079,22,2020,128567,-1410,50,-1360,1662,1533
22081,081,22,2010,9099,-6,0,-6,20,5
22081,081,22,2011,9082,-61,1,-60,145,103
22081,081,22,2012,9071,-56,5,-51,134,93
22081,081,22,2013,8956,-134,7,-127,131,120
22081,081,22,2014,8758,-226,7,-219,117,102
22081,081,22,2015,8710,-57,11,-46,121,121
22081,081,22,2016,8618,-93,10,-83,105,113
22081,081,22,2017,8523,-102,9,-93,99,100
22081,081,22,2018,8496,-35,9,-26,111,113
22081,081,22,2019,8380,-106,13,-93,95,117
22081,081,22,2020,8286,-56,10,-46,98,145
22083,083,22,2010,20757,-2,0,-2,63,23
22083,083,22,2011,20887,130,2,132,266,268
22083,083,22,2012,20917,-11,4,-7,280,240
22083,083,22,2013,20918,-56,0,-56,307,246
22083,083,22,2014,20763,-249,0,-249,297,206
22083,083,22,2015,20552,-222,0,-222,244,235
22083,083,22,2016,20458,-128,0,-128,259,223
22083,083,22,2017,20421,-50,0,-50,244,229
22083,083,22,2018,20215,-225,0,-225,272,255
22083,083,22,2019,20147,-106,0,-106,290,251
22083,083,22,2020,20014,-142,0,-142,274,266
22085,085,22,2010,24230,-19,0,-19,67,44
22085,085,22,2011,24426,171,0,171,297,274
22085,085,22,2012,24328,-143,0,-143,323,276
22085,085,22,2013,24264,-62,14,-48,310,322
22085,085,22,2014,24118,-167,6,-161,290,276
22085,085,22,2015,24213,95,4,99,285,286
22085,085,22,2016,24054,-174,4,-170,278,266
22085,085,22,2017,23913,-118,0,-118,292,314
22085,085,22,2018,23909,-2,-1,-3,282,282
22085,085,22,2019,23895,-42,0,-42,263,233
22085,085,22,2020,23803,-105,0,-105,269,257
22087,087,22,2010,36821,749,6,755,143,41
22087,087,22,2011,39520,2309,26,2335,613,268
22087,087,22,2012,41495,1621,14,1635,625,344
22087,087,22,2013,43446,1520,52,1572,649,309
22087,087,22,2014,44451,588,63,651,672,327
22087,087,22,2015,45436,601,73,674,652,344
22087,087,22,2016,45789,-13,73,60,658,363
22087,087,22,2017,46120,44,49,93,628,389
22087,087,22,2018,46724,337,48,385,613,395
22087,087,22,2019,47192,205,73,278,579,392
22087,087,22,2020,47647,274,61,335,556,438
22089,089,22,2010,52817,-91,5,-86,150,142
22089,089,22,2011,52394,-689,68,-621,605,411
22089,089,22,2012,52429,-261,37,-224,600,349
22089,089,22,2013,52623,-150,58,-92,679,389
22089,089,22,2014,52690,-194,35,-159,672,444
22089,089,22,2015,52587,-378,38,-340,658,425
22089,089,22,2016,52809,-85,38,-47,670,399
22089,089,22,2017,52629,-407,23,-384,625,425
22089,089,22,2018,52774,-54,30,-24,601,432
22089,089,22,2019,53083,140,44,184,575,450
22089,089,22,2020,52987,-216,36,-180,576,494
22091,091,22,2010,11206,-21,0,-21,24,9
22091,091,22,2011,10967,-221,-1,-222,120,139
22091,091,22,2012,10988,5,0,5,115,100
22091,091,22,2013,10781,-188,4,-184,115,142
22091,091,22,2014,10527,-259,8,-251,111,120
22091,091,22,2015,10465,-60,3,-57,118,122
22091,091,22,2016,10402,-56,0,-56,120,127
22091,091,22,2017,10333,-47,-1,-48,117,137
22091,091,22,2018,10174,-146,-1,-147,119,131
22091,091,22,2019,10145,-55,-1,-56,107,80
22091,091,22,2020,10081,-68,-1,-69,115,109
22093,093,22,2010,22051,-99,3,-96,55,18
22093,093,22,2011,21787,-381,12,-369,284,181
22093,093,22,2012,21638,-269,2,-267,293,179
22093,093,22,2013,21609,-48,1,-47,230,208
22093,093,22,2014,21518,-218,1,-217,318,194
22093,093,22,2015,21483,-105,4,-101,269,201
22093,093,22,2016,21428,-84,8,-76,236,213
22093,093,22,2017,21377,-91,-2,-93,255,212
22093,093,22,2018,21131,-287,-2,-289,264,221
22093,093,22,2019,21045,-118,0,-118,250,219
22093,093,22,2020,20727,-298,0,-298,238,255
22095,095,22,2010,45588,-222,4,-218,110,128
22095,095,22,2011,45065,-836,91,-745,634,417
22095,095,22,2012,44716,-658,32,-626,628,370
22095,095,22,2013,43565,-1428,94,-1334,556,406
22095,095,22,2014,43712,-117,60,-57,574,367
22095,095,22,2015,43527,-420,52,-368,581,400
22095,095,22,2016,43441,-329,58,-271,586,403
22095,095,22,2017,43356,-256,23,-233,555,409
22095,095,22,2018,43140,-312,31,-281,511,447
22095,095,22,2019,42824,-419,29,-390,505,431
22095,095,22,2020,42516,-380,27,-353,493,449
22097,097,22,2010,83503,0,0,0,302,190
22097,097,22,2011,83458,-514,6,-508,1344,880
22097,097,22,2012,83487,-305,-4,-309,1248,901
22097,097,22,2013,83448,-389,8,-381,1289,941
22097,097,22,2014,83720,-98,3,-95,1325,948
22097,097,22,2015,83693,-298,6,-292,1275,1002
22097,097,22,2016,83885,-249,15,-234,1411,982
22097,097,22,2017,83582,-513,9,-504,1218,1017
22097,097,22,2018,82827,-897,14,-883,1179,1050
22097,097,22,2019,82196,-749,18,-731,1134,1034
22097,097,22,2020,81440,-804,15,-789,1119,1083
22099,099,22,2010,52263,7,3,10,158,60
22099,099,22,2011,52804,224,49,273,692,424
22099,099,22,2012,52664,-462,26,-436,710,416
22099,099,22,2013,52950,-77,88,11,747,463
22099,099,22,2014,53309,73,44,117,746,499
22099,099,22,2015,53891,240,38,278,781,474
22099,099,22,2016,53829,-372,56,-316,745,492
22099,099,22,2017,54125,78,11,89,717,505
22099,099,22,2018,53629,-677,10,-667,702,532
22099,099,22,2019,53497,-294,41,-253,657,536
22099,099,22,2020,52954,-636,31,-605,649,584
22101,101,22,2010,54553,-142,7,-135,192,155
22101,101,22,2011,54199,-630,106,-524,720,553
22101,101,22,2012,53583,-919,53,-866,740,518
22101,101,22,2013,53608,-227,93,-134,758,596
22101,101,22,2014,53302,-680,73,-607,812,524
22101,101,22,2015,52908,-720,68,-652,805,553
22101,101,22,2016,52064,-1073,47,-1026,750,573
22101,101,22,2017,50673,-1573,16,-1557,710,553
22101,101,22,2018,49739,-1009,19,-990,659,605
22101,101,22,2019,49294,-562,34,-528,624,542
22101,101,22,2020,48330,-991,26,-965,602,595
22103,103,22,2010,234564,562,37,599,649,453
22103,103,22,2011,236900,1264,281,1545,2706,1909
22103,103,22,2012,239154,1411,145,1556,2675,1948
22103,103,22,2013,242074,2142,203,2345,2687,2120
22103,103,22,2014,245390,2283,143,2426,2990,2104
22103,103,22,2015,249116,2732,203,2935,2953,2166
22103,103,22,2016,252676,2383,282,2665,3018,2118
22103,103,22,2017,256212,2555,167,2722,3002,2176
22103,103,22,2018,258598,1698,188,1886,2888,2374
22103,103,22,2019,261303,1969,263,2232,2944,2462
22103,103,22,2020,263446,1692,215,1907,2892,2656
22105,105,22,2010,121463,165,13,178,395,200
22105,105,22,2011,122694,318,140,458,1848,1074
22105,105,22,2012,123656,189,45,234,1896,1143
22105,105,22,2013,125550,948,180,1128,1930,1171
22105,105,22,2014,127058,655,92,747,1956,1193
22105,105,22,2015,128774,957,33,990,1925,1204
22105,105,22,2016,130759,1009,90,1099,2055,1170
22105,105,22,2017,132445,1041,32,1073,1935,1323
22105,105,22,2018,133951,789,26,815,1981,1294
22105,105,22,2019,134845,280,85,365,1879,1354
22105,105,22,2020,136765,1485,63,1548,1874,1503
22107,107,22,2010,5229,-27,0,-27,12,7
22107,107,22,2011,5091,-151,0,-151,70,58
22107,107,22,2012,4998,-121,0,-121,72,49
22107,107,22,2013,4932,-60,0,-60,54,59
22107,107,22,2014,4852,-89,0,-89,68,61
22107,107,22,2015,4773,-88,0,-88,57,49
22107,107,22,2016,4652,-117,0,-117,53,57
22107,107,22,2017,4572,-70,0,-70,57,68
22107,107,22,2018,4454,-107,0,-107,40,50
22107,107,22,2019,4319,-127,0,-127,45,53
22107,107,22,2020,4178,-111,0,-111,38,67
22109,109,22,2010,111552,-213,11,-202,393,234
22109,109,22,2011,111690,-678,102,-576,1673,961
22109,109,22,2012,111762,-687,54,-633,1662,960
22109,109,22,2013,112773,336,161,497,1571,1045
22109,109,22,2014,113553,59,70,129,1710,1032
22109,109,22,2015,113894,-378,59,-319,1757,1090
22109,109,22,2016,113071,-1650,115,-1535,1665,961
22109,109,22,2017,111880,-1764,19,-1745,1585,1036
22109,109,22,2018,111265,-1054,25,-1029,1509,1099
22109,109,22,2019,110615,-1046,55,-991,1473,1133
22109,109,22,2020,109859,-1037,54,-983,1437,1207
22111,111,22,2010,22842,27,2,29,70,39
22111,111,22,2011,22766,-148,21,-127,296,245
22111,111,22,2012,22528,-305,2,-303,303,244
22111,111,22,2013,22460,-101,33,-68,264,261
22111,111,22,2014,22560,107,13,120,276,296
22111,111,22,2015,22490,-90,6,-84,277,262
22111,111,22,2016,22514,12,7,19,274,267
22111,111,22,2017,22391,-110,-1,-111,277,288
22111,111,22,2018,22209,-130,-4,-134,241,287
22111,111,22,2019,22068,-134,17,-117,234,258
22111,111,22,2020,22170,121,15,136,232,266
22113,113,22,2010,58083,19,9,28,200,96
22113,113,22,2011,58198,-107,52,-55,759,586
22113,113,22,2012,58637,117,34,151,813,513
22113,113,22,2013,59286,306,64,370,803,520
22113,113,22,2014,59539,-22,38,16,770,520
22113,113,22,2015,59928,132,22,154,832,592
22113,113,22,2016,60120,-101,15,-86,840,560
22113,113,22,2017,59937,-348,3,-345,737,576
22113,113,22,2018,59928,-189,3,-186,769,591
22113,113,22,2019,59573,-492,12,-480,737,613
22113,113,22,2020,59378,-292,15,-277,732,653
22115,115,22,2010,52737,104,103,207,260,100
22115,115,22,2011,52297,-1281,67,-1214,1120,354
22115,115,22,2012,54173,660,524,1184,1015,355
22115,115,22,2013,52884,-2471,313,-2158,1192,375
22115,115,22,2014,52900,-761,213,-548,1005,435
22115,115,22,2015,51535,-2321,312,-2009,1019,401
22115,115,22,2016,51666,-723,185,-538,1066,396
22115,115,22,2017,49941,-2281,75,-2206,900,430
22115,115,22,2018,48679,-1808,30,-1778,934,421
22115,115,22,2019,48394,-690,57,-633,766,413
22115,115,22,2020,47894,-963,60,-903,809,399
22117,117,22,2010,47083,-96,1,-95,127,82
22117,117,22,2011,47125,21,-4,17,577,551
22117,117,22,2012,46675,-430,-11,-441,545,560
22117,117,22,2013,46412,-223,-11,-234,531,558
22117,117,22,2014,46320,-80,-13,-93,599,588
22117,117,22,2015,46365,38,-8,30,619,599
22117,117,22,2016,46414,16,4,20,643,611
22117,117,22,2017,46678,199,-6,193,657,581
22117,117,22,2018,46601,8,-5,3,554,632
22117,117,22,2019,46158,-331,5,-326,526,642
22117,117,22,2020,45773,-223,6,-217,513,682
22119,119,22,2010,41202,29,3,32,105,139
22119,119,22,2011,41248,23,-2,21,519,492
22119,119,22,2012,40914,-403,-3,-406,522,458
22119,119,22,2013,40669,-202,13,-189,498,553
22119,119,22,2014,40292,-325,8,-317,510,573
22119,119,22,2015,40067,-270,16,-254,507,475
22119,119,22,2016,39750,-303,7,-296,511,532
22119,119,22,2017,39268,-419,4,-415,494,562
22119,119,22,2018,38780,-407,4,-403,487,571
22119,119,22,2019,38323,-379,5,-374,433,515
22119,119,22,2020,37943,-224,5,-219,420,581
22121,121,22,2010,23964,93,2,95,78,13
22121,121,22,2011,24125,-13,18,5,349,192
22121,121,22,2012,24170,-107,2,-105,312,161
22121,121,22,2013,24682,318,36,354,365,216
22121,121,22,2014,25229,401,-3,398,349,210
22121,121,22,2015,25596,205,-3,202,396,231
22121,121,22,2016,25942,174,-3,171,383,208
22121,121,22,2017,26238,140,-2,138,370,213
22121,121,22,2018,26451,75,-2,73,362,221
22121,121,22,2019,26550,-60,-1,-61,355,195
22121,121,22,2020,26792,129,0,129,351,240
22123,123,22,2010,11577,-11,0,-11,31,46
22123,123,22,2011,11521,-82,0,-82,150,125
22123,123,22,2012,11500,-35,0,-35,133,116
22123,123,22,2013,11452,-12,1,-11,124,159
22123,123,22,2014,11526,65,2,67,149,140
22123,123,22,2015,11287,-247,8,-239,146,146
22123,123,22,2016,11144,-161,11,-150,146,139
22123,123,22,2017,10967,-131,4,-127,102,153
22123,123,22,2018,11008,59,3,62,119,139
22123,123,22,2019,10906,-81,8,-73,112,142
22123,123,22,2020,10646,-221,7,-214,115,159
22125,125,22,2010,15636,-6,4,-2,30,11
22125,125,22,2011,15511,-149,13,-136,126,117
22125,125,22,2012,15471,-69,1,-68,137,109
22125,125,22,2013,15455,-7,3,-4,107,118
22125,125,22,2014,15372,-89,-1,-90,138,131
22125,125,22,2015,15376,3,8,11,113,120
22125,125,22,2016,15322,-36,14,-22,110,142
22125,125,22,2017,15373,66,12,78,113,139
22125,125,22,2018,15474,101,13,114,145,158
22125,125,22,2019,15570,74,19,93,115,111
22125,125,22,2020,15465,-108,16,-92,124,136
22127,127,22,2010,15302,-35,0,-35,43,21
22127,127,22,2011,15155,-188,1,-187,190,151
22127,127,22,2012,15105,-76,-3,-79,173,143
22127,127,22,2013,14852,-227,0,-227,165,194
22127,127,22,2014,14823,-20,-2,-22,160,165
22127,127,22,2015,14646,-171,-3,-174,166,170
22127,127,22,2016,14539,-99,-2,-101,177,183
22127,127,22,2017,14355,-189,-2,-191,166,158
22127,127,22,2018,14132,-179,-2,-181,145,187
22127,127,22,2019,13961,-141,-2,-143,162,189
22127,127,22,2020,13839,-37,-2,-39,141,224
23001,001,23,2010,107712,-156,39,-117,370,251
23001,001,23,2011,107458,-694,115,-579,1340,1015
23001,001,23,2012,107517,-280,55,-225,1317,1021
23001,001,23,2013,107267,-665,179,-486,1287,1051
23001,001,23,2014,107411,-369,277,-92,1258,1010
23001,001,23,2015,107189,-469,107,-362,1266,1120
23001,001,23,2016,107389,-106,190,84,1264,1145
23001,001,23,2017,107507,-68,103,35,1254,1164
23001,001,23,2018,107987,309,132,441,1204,1164
23001,001,23,2019,108361,52,211,263,1255,1145
23001,001,23,2020,108547,-10,158,148,1211,1176
23003,003,23,2010,71699,-124,6,-118,157,212
23003,003,23,2011,71394,-142,38,-104,655,854
23003,003,23,2012,70786,-400,4,-396,645,857
23003,003,23,2013,70100,-569,37,-532,688,850
23003,003,23,2014,69565,-519,85,-434,694,796
23003,003,23,2015,68869,-478,38,-440,652,909
23003,003,23,2016,68319,-440,77,-363,709,894
23003,003,23,2017,67638,-418,25,-393,599,887
23003,003,23,2018,67302,-149,38,-111,638,860
23003,003,23,2019,67092,-33,69,36,629,873
23003,003,23,2020,66804,-16,55,39,613,942
23005,005,23,2010,281481,-545,165,-380,743,578
23005,005,23,2011,282753,385,637,1022,2715,2455
23005,005,23,2012,283742,410,357,767,2697,2412
23005,005,23,2013,285681,824,847,1671,2892,2589
23005,005,23,2014,288274,850,1487,2337,2825,2533
23005,005,23,2015,289704,921,405,1326,2768,2641
23005,005,23,2016,291522,622,1055,1677,2831,2678
23005,005,23,2017,292549,584,434,1018,2717,2696
23005,005,23,2018,294363,1189,559,1748,2753,2683
23005,005,23,2019,296052,811,948,1759,2729,2806
23005,005,23,2020,298111,1531,740,2271,2737,2958
23007,007,23,2010,30719,-53,12,-41,75,81
23007,007,23,2011,30740,48,35,83,239,301
23007,007,23,2012,30648,-80,15,-65,292,313
23007,007,23,2013,30476,-164,27,-137,245,283
23007,007,23,2014,30206,-244,22,-222,267,316
23007,007,23,2015,30024,-103,-3,-106,259,331
23007,007,23,2016,29995,29,6,35,252,314
23007,007,23,2017,29808,-52,-1,-53,234,367
23007,007,23,2018,29831,159,0,159,222,358
23007,007,23,2019,30046,322,3,325,248,358
23007,007,23,2020,29986,67,5,72,232,364
23009,009,23,2010,54351,-76,25,-51,132,136
23009,009,23,2011,54533,182,77,259,453,529
23009,009,23,2012,54494,14,56,70,445,539
23009,009,23,2013,54589,103,84,187,488,572
23009,009,23,2014,54512,-51,112,61,476,600
23009,009,23,2015,54280,-153,50,-103,481,607
23009,009,23,2016,54540,287,98,385,453,574
23009,009,23,2017,54584,196,29,225,459,637
23009,009,23,2018,54849,400,36,436,451,622
23009,009,23,2019,55098,402,69,471,428,649
23009,009,23,2020,55088,232,56,288,418,715
23011,011,23,2010,122074,-30,9,-21,311,354
23011,011,23,2011,121801,-212,35,-177,1193,1286
23011,011,23,2012,121610,-216,23,-193,1203,1191
23011,011,23,2013,121167,-430,88,-342,1201,1293
23011,011,23,2014,121277,143,205,348,1127,1339
23011,011,23,2015,121063,-138,29,-109,1246,1335
23011,011,23,2016,121538,528,89,617,1195,1333
23011,011,23,2017,121970,602,31,633,1123,1315
23011,011,23,2018,122086,298,40,338,1151,1367
23011,011,23,2019,122241,299,84,383,1156,1385
23011,011,23,2020,122955,1007,72,1079,1141,1503
23013,013,23,2010,39727,-26,2,-24,96,75
23013,013,23,2011,39674,46,14,60,332,442
23013,013,23,2012,39613,-28,14,-14,352,393
23013,013,23,2013,39693,91,104,195,361,468
23013,013,23,2014,39897,143,129,272,362,423
23013,013,23,2015,39797,33,9,42,351,489
23013,013,23,2016,39769,153,14,167,333,526
23013,013,23,2017,39774,183,9,192,322,505
23013,013,23,2018,39760,146,10,156,302,471
23013,013,23,2019,39792,185,21,206,320,492
23013,013,23,2020,39951,319,17,336,305,481
23015,015,23,2010,34384,-53,4,-49,70,78
23015,015,23,2011,34271,-46,31,-15,296,392
23015,015,23,2012,34155,13,17,30,273,413
23015,015,23,2013,34091,81,34,115,251,425
23015,015,23,2014,34052,82,37,119,270,421
23015,015,23,2015,33789,-102,11,-91,258,428
23015,015,23,2016,33992,299,39,338,280,412
23015,015,23,2017,34228,342,9,351,305,422
23015,015,23,2018,34396,310,14,324,289,442
23015,015,23,2019,34685,391,22,413,297,418
23015,015,23,2020,34775,236,18,254,292,454
23017,017,23,2010,57777,-64,2,-62,124,113
23017,017,23,2011,57770,73,21,94,516,613
23017,017,23,2012,57486,-172,0,-172,509,620
23017,017,23,2013,57420,-48,15,-33,576,604
23017,017,23,2014,57348,44,40,84,506,653
23017,017,23,2015,57195,11,15,26,477,648
23017,017,23,2016,57353,267,34,301,521,660
23017,017,23,2017,57549,348,10,358,490,650
23017,017,23,2018,57777,438,13,451,490,711
23017,017,23,2019,57895,356,15,371,460,710
23017,017,23,2020,58132,530,15,545,471,775
23019,019,23,2010,153864,-127,27,-100,417,374
23019,019,23,2011,153781,-212,124,-88,1445,1437
23019,019,23,2012,153392,-436,70,-366,1482,1488
23019,019,23,2013,153289,-90,144,54,1463,1594
23019,019,23,2014,153288,-178,213,35,1452,1463
23019,019,23,2015,152029,-1142,33,-1109,1435,1587
23019,019,23,2016,151419,-598,183,-415,1405,1597
23019,019,23,2017,151785,486,65,551,1475,1651
23019,019,23,2018,151798,197,87,284,1432,1697
23019,019,23,2019,151823,166,170,336,1371,1683
23019,019,23,2020,151655,83,120,203,1350,1728
23021,021,23,2010,17550,17,0,17,35,35
23021,021,23,2011,17366,-94,1,-93,142,232
23021,021,23,2012,17269,-5,1,-4,132,221
23021,021,23,2013,17176,-22,2,-20,157,230
23021,021,23,2014,17042,-45,1,-44,137,226
23021,021,23,2015,16940,-3,7,4,132,235
23021,021,23,2016,16919,41,21,62,152,233
23021,021,23,2017,16809,-7,9,2,142,253
23021,021,23,2018,16714,32,10,42,124,260
23021,021,23,2019,16880,123,136,259,134,227
23021,021,23,2020,16996,118,107,225,140,247
23023,023,23,2010,35229,-116,5,-111,96,49
23023,023,23,2011,35127,-102,12,-90,326,336
23023,023,23,2012,35124,-55,11,-44,349,306
23023,023,23,2013,35031,-72,7,-65,320,348
23023,023,23,2014,35090,42,2,44,355,332
23023,023,23,2015,35137,97,-1,96,345,390
23023,023,23,2016,35206,93,21,114,345,388
23023,023,23,2017,35471,346,2,348,304,387
23023,023,23,2018,35821,379,3,382,303,332
23023,023,23,2019,36057,309,8,317,311,391
23023,023,23,2020,36044,123,5,128,305,445
23025,025,23,2010,52217,32,6,38,136,171
23025,025,23,2011,51937,-221,18,-203,493,568
23025,025,23,2012,51821,-78,8,-70,497,532
23025,025,23,2013,51715,-70,20,-50,478,531
23025,025,23,2014,51254,-404,26,-378,506,594
23025,025,23,2015,50749,-367,0,-367,446,586
23025,025,23,2016,50562,-18,1,-17,456,622
23025,025,23,2017,50373,-31,-5,-36,483,632
23025,025,23,2018,50568,382,-3,379,451,633
23025,025,23,2019,50729,232,-3,229,488,555
23025,025,23,2020,50635,16,-1,15,475,585
23027,027,23,2010,38824,28,7,35,111,112
23027,027,23,2011,38865,-7,48,41,374,371
23027,027,23,2012,38934,13,30,43,398,366
23027,027,23,2013,39041,4,91,95,378,358
23027,027,23,2014,39056,-21,75,54,349,380
23027,027,23,2015,39143,151,18,169,330,411
23027,027,23,2016,39468,283,60,343,359,375
23027,027,23,2017,39791,410,17,427,331,432
23027,027,23,2018,39678,-39,19,-20,345,435
23027,027,23,2019,39755,118,38,156,355,435
23027,027,23,2020,39923,282,27,309,346,485
23029,029,23,2010,32828,-20,2,-18,87,92
23029,029,23,2011,32724,1,8,9,294,405
23029,029,23,2012,32553,-79,8,-71,311,407
23029,029,23,2013,32268,-187,53,-134,304,448
23029,029,23,2014,31971,-221,81,-140,284,443
23029,029,23,2015,31783,-118,22,-96,328,418
23029,029,23,2016,31608,-105,62,-43,290,420
23029,029,23,2017,31370,-84,25,-59,273,450
23029,029,23,2018,31152,-90,36,-54,286,451
23029,029,23,2019,31286,166,84,250,310,425
23029,029,23,2020,31473,264,71,335,302,447
23031,031,23,2010,197215,1,11,12,488,391
23031,031,23,2011,198279,990,51,1041,1815,1788
23031,031,23,2012,198950,505,-13,492,1894,1674
23031,031,23,2013,199539,434,178,612,1777,1761
23031,031,23,2014,200974,1058,380,1438,1837,1819
23031,031,23,2015,201407,593,30,623,1870,2039
23031,031,23,2016,202749,1322,168,1490,1859,2002
23031,031,23,2017,204537,1992,12,2004,1885,2104
23031,031,23,2018,206041,1740,30,1770,1824,2091
23031,031,23,2019,207978,2000,182,2182,1899,2140
23031,031,23,2020,209066,1332,140,1472,1871,2257
24001,001,24,2010,74968,-96,11,-85,194,181
24001,001,24,2011,74580,-239,57,-182,703,908
24001,001,24,2012,73966,-462,81,-381,674,908
24001,001,24,2013,73602,-209,71,-138,676,896
24001,001,24,2014,73051,-432,80,-352,709,909
24001,001,24,2015,72501,-301,83,-218,635,963
24001,001,24,2016,72084,-204,48,-156,658,916
24001,001,24,2017,71363,-469,51,-418,643,944
24001,001,24,2018,70977,-164,30,-134,653,904
24001,001,24,2019,70527,-284,36,-248,649,851
24001,001,24,2020,70057,-225,33,-192,650,931
24003,003,24,2010,539305,399,369,768,1813,892
24003,003,24,2011,544863,1636,724,2360,6951,3745
24003,003,24,2012,550476,1211,1435,2646,6920,3876
24003,003,24,2013,555638,1421,985,2406,6770,3981
24003,003,24,2014,559421,-18,1070,1052,6873,4026
24003,003,24,2015,563133,-497,1516,1019,6962,4197
24003,003,24,2016,567434,521,874,1395,7072,4146
24003,003,24,2017,571359,769,737,1506,6845,4407
24003,003,24,2018,575641,1689,380,2069,6850,4625
24003,003,24,2019,579895,1626,391,2017,6859,4634
24003,003,24,2020,582777,779,317,1096,6775,5025
24005,005,24,2010,806654,22,884,906,2409,1872
24005,005,24,2011,813021,1142,2900,4042,9951,7591
24005,005,24,2012,818218,-65,3290,3225,9665,7512
24005,005,24,2013,822426,24,2642,2666,9538,7846
24005,005,24,2014,825201,-2179,2863,684,9851,7651
24005,005,24,2015,827796,-2598,3324,726,10070,8131
24005,005,24,2016,828941,-2996,2512,-484,9874,8227
24005,005,24,2017,828956,-3871,2733,-1138,9701,8543
24005,005,24,2018,828547,-3737,1831,-1906,9871,8382
24005,005,24,2019,828503,-3111,1941,-1170,9746,8640
24005,005,24,2020,826017,-4509,1500,-3009,9563,9067
24009,009,24,2010,88989,92,20,112,232,90
24009,009,24,2011,89346,27,46,73,933,651
24009,009,24,2012,89746,-13,126,113,908,612
24009,009,24,2013,90486,366,74,440,953,641
24009,009,24,2014,90595,-251,84,-167,908,639
24009,009,24,2015,90542,-380,109,-271,880,665
24009,009,24,2016,91116,258,56,314,923,658
24009,009,24,2017,91492,128,51,179,927,726
24009,009,24,2018,92131,440,10,450,888,693
24009,009,24,2019,92660,359,31,390,891,747
24009,009,24,2020,93072,341,16,357,888,830
24011,011,24,2010,33054,-34,4,-30,101,97
24011,011,24,2011,32890,-320,28,-292,418,291
24011,011,24,2012,32636,-389,51,-338,398,322
24011,011,24,2013,32651,-95,61,-34,379,327
24011,011,24,2014,32542,-191,61,-130,366,347
24011,011,24,2015,32601,-74,68,-6,412,343
24011,011,24,2016,32834,135,64,199,368,334
24011,011,24,2017,33122,177,72,249,383,342
24011,011,24,2018,33341,128,58,186,390,355
24011,011,24,2019,33509,17,62,79,445,358
24011,011,24,2020,33492,-109,45,-64,425,381
24013,013,24,2010,167230,12,17,29,412,356
24013,013,24,2011,167072,-343,35,-308,1549,1399
24013,013,24,2012,167085,-320,86,-234,1588,1339
24013,013,24,2013,167264,30,60,90,1579,1478
24013,013,24,2014,167383,4,61,65,1571,1502
24013,013,24,2015,167201,-368,79,-289,1659,1549
24013,013,24,2016,167189,-276,79,-197,1700,1510
24013,013,24,2017,167687,400,82,482,1639,1611
24013,013,24,2018,168421,676,63,739,1709,1702
24013,013,24,2019,168774,171,64,235,1708,1587
24013,013,24,2020,169092,266,47,313,1713,1704
24015,015,24,2010,101161,-5,16,11,299,227
24015,015,24,2011,101583,31,83,114,1154,842
24015,015,24,2012,101780,-247,94,-153,1165,806
24015,015,24,2013,101940,-100,82,-18,1101,907
24015,015,24,2014,102252,48,90,138,1058,865
24015,015,24,2015,102453,10,98,108,1016,912
24015,015,24,2016,102609,-109,67,-42,1168,967
24015,015,24,2017,102509,-286,69,-217,1102,983
24015,015,24,2018,102816,119,47,166,1165,1019
24015,015,24,2019,103092,100,7,107,1165,995
24015,015,24,2020,103419,250,16,266,1152,1096
24017,017,24,2010,147159,258,82,340,439,185
24017,017,24,2011,149215,986,173,1159,1843,948
24017,017,24,2012,150700,237,241,478,1916,891
24017,017,24,2013,152710,984,186,1170,1839,992
24017,017,24,2014,154448,695,195,890,1812,941
24017,017,24,2015,155775,182,217,399,1903,961
24017,017,24,2016,157474,699,203,902,1825,1020
24017,017,24,2017,159718,1356,180,1536,1832,1113
24017,017,24,2018,161879,1373,102,1475,1800,1109
24017,017,24,2019,163733,1036,123,1159,1922,1225
24017,017,24,2020,164436,50,101,151,1847,1297
24019,019,24,2010,32689,33,6,39,80,54
24019,019,24,2011,32702,-47,16,-31,373,328
24019,019,24,2012,32483,-220,17,-203,361,378
24019,019,24,2013,32563,48,13,61,403,379
24019,019,24,2014,32502,-119,33,-86,400,370
24019,019,24,2015,32431,-135,70,-65,382,386
24019,019,24,2016,32268,-163,49,-114,365,412
24019,019,24,2017,32093,-122,35,-87,358,444
24019,019,24,2018,31894,-206,47,-159,367,405
24019,019,24,2019,31864,12,3,15,356,400
24019,019,24,2020,31853,29,13,42,355,407
24021,021,24,2010,234239,288,199,487,710,370
24021,021,24,2011,237326,1212,535,1747,2852,1512
24021,021,24,2012,239705,528,757,1285,2723,1576
24021,021,24,2013,241215,-59,601,542,2704,1710
24021,021,24,2014,243487,446,669,1115,2785,1587
24021,021,24,2015,245145,-97,774,677,2829,1823
24021,021,24,2016,247269,451,635,1086,2843,1792
24021,021,24,2017,251037,2209,694,2903,2811,1940
24021,021,24,2018,255698,3216,474,3690,2831,1855
24021,021,24,2019,260609,3404,475,3879,2939,1898
24021,021,24,2020,265161,3195,387,3582,2994,2013
24023,023,24,2010,30144,-13,4,-9,73,55
24023,023,24,2011,30158,29,14,43,271,301
24023,023,24,2012,29976,-192,15,-177,301,306
24023,023,24,2013,29981,0,10,10,293,294
24023,023,24,2014,29669,-306,15,-291,288,312
24023,023,24,2015,29451,-223,3,-220,285,282
24023,023,24,2016,29395,-16,3,-13,310,353
24023,023,24,2017,29276,-72,2,-70,288,336
24023,023,24,2018,29202,-18,2,-16,276,333
24023,023,24,2019,29049,-49,-2,-51,264,365
24023,023,24,2020,28852,-81,0,-81,262,378
24025,025,24,2010,245236,102,117,219,683,466
24025,025,24,2011,246746,339,246,585,2776,1842
24025,025,24,2012,248609,771,362,1133,2613,1845
24025,025,24,2013,248961,-505,237,-268,2654,2017
24025,025,24,2014,249415,-525,272,-253,2658,1927
24025,025,24,2015,249690,-883,362,-521,2820,2017
24025,025,24,2016,250448,-106,279,173,2675,2080
24025,025,24,2017,251948,875,268,1143,2607,2231
24025,025,24,2018,253884,1330,184,1514,2634,2199
24025,025,24,2019,255594,1087,166,1253,2716,2255
24025,025,24,2020,256805,796,156,952,2659,2401
24027,027,24,2010,288618,569,417,986,912,393
24027,027,24,2011,293596,1874,1210,3084,3315,1421
24027,027,24,2012,299223,2217,1505,3722,3391,1472
24027,027,24,2013,303590,1198,1266,2464,3452,1503
24027,027,24,2014,306989,34,1462,1496,3456,1544
24027,027,24,2015,311417,871,1569,2440,3645,1626
24027,027,24,2016,315581,1001,1212,2213,3597,1632
24027,027,24,2017,319409,675,1284,1959,3519,1632
24027,027,24,2018,322895,953,815,1768,3431,1693
24027,027,24,2019,325951,646,857,1503,3428,1867
24027,027,24,2020,328200,255,689,944,3370,2067
24029,029,24,2010,20213,18,5,23,41,43
24029,029,24,2011,20258,109,6,115,163,235
24029,029,24,2012,19987,-238,11,-227,183,229
24029,029,24,2013,19833,-92,-1,-93,183,243
24029,029,24,2014,19801,61,6,67,164,260
24029,029,24,2015,19745,22,19,41,159,252
24029,029,24,2016,19708,60,17,77,160,273
24029,029,24,2017,19486,-127,15,-112,138,246
24029,029,24,2018,19467,84,12,96,156,271
24029,029,24,2019,19426,95,5,100,150,289
24029,029,24,2020,19192,-65,6,-59,147,321
24031,031,24,2010,975619,311,2181,2492,3424,1476
24031,031,24,2011,991325,577,7635,8212,13192,5665
24031,031,24,2012,1005310,-2466,9207,6741,13031,5661
24031,031,24,2013,1015534,-5053,8109,3056,13112,5916
24031,031,24,2014,1025063,-6787,8693,1906,13161,5606
24031,031,24,2015,1033370,-8786,10003,1217,13177,6115
24031,031,24,2016,1039327,-9309,7803,-1506,13082,5647
24031,031,24,2017,1047239,-7405,8384,979,12799,5881
24031,031,24,2018,1048794,-11041,5924,-5117,12663,6036
24031,031,24,2019,1051129,-9554,6099,-3455,12184,6414
24031,031,24,2020,1051816,-9065,4680,-4385,11964,6906
24033,033,24,2010,866442,-780,1546,766,3019,1296
24033,033,24,2011,874594,-3677,4858,1181,12137,5162
24033,033,24,2012,882787,-4417,5701,1284,12014,4986
24033,033,24,2013,891020,-3023,4724,1701,11948,5278
24033,033,24,2014,900372,-2598,5244,2646,12054,5226
24033,033,24,2015,906754,-6873,6391,-482,12496,5611
24033,033,24,2016,909262,-9430,5456,-3974,12289,5823
24033,033,24,2017,910946,-10047,5995,-4052,12309,6572
24033,033,24,2018,911372,-10030,4492,-5538,12385,6426
24033,033,24,2019,911562,-9498,4617,-4881,11971,6889
24033,033,24,2020,909612,-9475,3520,-5955,11802,7791
24035,035,24,2010,47809,32,2,34,114,123
24035,035,24,2011,48267,324,1,325,483,349
24035,035,24,2012,48506,197,25,222,447,424
24035,035,24,2013,48535,-48,59,11,438,413
24035,035,24,2014,48803,135,66,201,476,400
24035,035,24,2015,49012,127,65,192,437,415
24035,035,24,2016,49135,-19,52,33,509,415
24035,035,24,2017,49648,439,57,496,462,443
24035,035,24,2018,50279,499,44,543,501,412
24035,035,24,2019,50585,194,42,236,505,434
24035,035,24,2020,51167,487,35,522,500,437
24037,037,24,2010,105772,372,69,441,363,202
24037,037,24,2011,107589,888,90,978,1484,648
24037,037,24,2012,108847,261,323,584,1389,699
24037,037,24,2013,109284,-393,207,-186,1381,752
24037,037,24,2014,109998,-71,167,96,1390,756
24037,037,24,2015,111092,150,226,376,1512,781
24037,037,24,2016,111886,-11,140,129,1456,788
24037,037,24,2017,112627,106,128,234,1322,810
24037,037,24,2018,112948,-249,69,-180,1382,881
24037,037,24,2019,113764,275,82,357,1347,890
24037,037,24,2020,114687,462,62,524,1344,949
24039,039,24,2010,26464,10,14,24,65,96
24039,039,24,2011,26268,-182,29,-153,244,287
24039,039,24,2012,26044,-307,38,-269,274,235
24039,039,24,2013,25968,-147,38,-109,279,248
24039,039,24,2014,25581,-461,42,-419,261,241
24039,039,24,2015,25705,100,51,151,247,274
24039,039,24,2016,25873,117,34,151,265,247
24039,039,24,2017,25922,63,40,103,242,294
24039,039,24,2018,25637,-268,29,-239,238,285
24039,039,24,2019,25609,24,25,49,211,290
24039,039,24,2020,25453,-108,25,-83,223,295
24041,041,24,2010,37876,74,5,79,94,72
24041,041,24,2011,37952,112,34,146,356,423
24041,041,24,2012,37995,121,31,152,317,417
24041,041,24,2013,37909,9,40,49,331,459
24041,041,24,2014,37533,-281,1,-280,346,441
24041,041,24,2015,37431,27,13,40,314,453
24041,041,24,2016,37170,-198,21,-177,337,418
24041,041,24,2017,37057,8,21,29,325,464
24041,041,24,2018,37052,53,19,72,355,429
24041,041,24,2019,37186,280,14,294,325,482
24041,041,24,2020,36972,-12,13,1,323,538
24043,043,24,2010,147727,193,54,247,427,364
24043,043,24,2011,148807,563,182,745,1739,1402
24043,043,24,2012,149090,-247,229,-18,1742,1421
24043,043,24,2013,149055,-449,213,-236,1728,1522
24043,043,24,2014,149128,-385,214,-171,1770,1520
24043,043,24,2015,149160,-371,217,-154,1739,1544
24043,043,24,2016,149715,132,184,316,1719,1471
24043,043,24,2017,150247,314,190,504,1619,1580
24043,043,24,2018,150699,232,179,411,1680,1632
24043,043,24,2019,151066,233,94,327,1683,1642
24043,043,24,2020,151146,-53,102,49,1667,1641
24045,045,24,2010,98974,-38,113,75,327,153
24045,045,24,2011,100086,266,435,701,1284,872
24045,045,24,2012,100593,-241,421,180,1228,891
24045,045,24,2013,100890,-331,355,24,1198,917
24045,045,24,2014,101416,-49,331,282,1213,948
24045,045,24,2015,101820,-201,330,129,1199,915
24045,045,24,2016,102246,-191,312,121,1313,1005
24045,045,24,2017,102471,-334,337,3,1210,985
24045,045,24,2018,103398,401,285,686,1260,1018
24045,045,24,2019,104005,176,236,412,1269,1076
24045,045,24,2020,103990,-324,191,-133,1253,1140
24047,047,24,2010,51500,48,19,67,112,118
24047,047,24,2011,51504,128,44,172,438,604
24047,047,24,2012,51578,183,25,208,462,590
24047,047,24,2013,51551,110,48,158,422,599
24047,047,24,2014,51581,138,43,181,437,584
24047,047,24,2015,51472,57,59,116,439,656
24047,047,24,2016,51508,203,51,254,428,643
24047,047,24,2017,51721,370,61,431,423,638
24047,047,24,2018,51940,431,35,466,414,662
24047,047,24,2019,52261,560,35,595,393,663
24047,047,24,2020,52403,457,33,490,409,754
24510,510,24,2010,620942,-1016,555,-461,2115,1429
24510,510,24,2011,620493,-4915,1779,-3136,8949,6269
24510,510,24,2012,623035,-2390,2101,-289,9008,6073
24510,510,24,2013,622591,-4690,1694,-2996,9008,6407
24510,510,24,2014,623833,-3204,1990,-1214,8741,6166
24510,510,24,2015,622831,-5880,2289,-3591,8928,6319
24510,510,24,2016,616542,-10248,1864,-8384,8562,6479
24510,510,24,2017,610853,-9241,1964,-7277,8266,6664
24510,510,24,2018,603241,-10149,1498,-8651,7796,6744
24510,510,24,2019,594601,-10854,1354,-9500,7678,6780
24510,510,24,2020,586131,-9720,1091,-8629,7468,7266
25001,001,25,2010,215909,201,105,306,445,707
25001,001,25,2011,215389,475,236,711,1650,2868
25001,001,25,2012,214854,236,377,613,1592,2683
25001,001,25,2013,214609,865,249,1114,1542,2884
25001,001,25,2014,214398,766,362,1128,1549,2859
25001,001,25,2015,214015,723,439,1162,1483,3004
25001,001,25,2016,213805,644,496,1140,1566,2898
25001,001,25,2017,213856,1012,541,1553,1556,3041
25001,001,25,2018,213779,897,396,1293,1541,2899
25001,001,25,2019,212923,335,343,678,1479,3004
25001,001,25,2020,213164,1593,277,1870,1459,3077
25003,003,25,2010,131318,38,52,90,263,289
25003,003,25,2011,130565,-691,181,-510,1187,1429
25003,003,25,2012,130321,-300,286,-14,1185,1399
25003,003,25,2013,129542,-551,278,-273,1066,1566
25003,003,25,2014,128928,-565,320,-245,1102,1460
25003,003,25,2015,127950,-909,337,-572,1078,1483
25003,003,25,2016,127182,-596,333,-263,1008,1507
25003,003,25,2017,126518,-490,360,-130,994,1525
25003,003,25,2018,126146,-91,304,213,1024,1602
25003,003,25,2019,125217,-601,178,-423,975,1480
25003,003,25,2020,124571,-303,174,-129,975,1494
25005,005,25,2010,549175,391,177,568,1478,1088
25005,005,25,2011,549355,-1401,874,-527,5826,5108
25005,005,25,2012,551204,-1,1088,1087,5802,4921
25005,005,25,2013,552495,-271,1125,854,5647,5132
25005,005,25,2014,555212,1036,1438,2474,5558,5194
25005,005,25,2015,557104,202,1533,1735,5662,5427
25005,005,25,2016,558413,-919,1823,904,5663,5237
25005,005,25,2017,561449,988,2003,2991,5590,5505
25005,005,25,2018,564780,1418,1836,3254,5740,5643
25005,005,25,2019,565096,-662,932,270,5503,5466
25005,005,25,2020,566765,997,951,1948,5442,5745
25007,007,25,2010,16573,12,6,18,42,19
25007,007,25,2011,16706,99,5,104,174,146
25007,007,25,2012,16838,122,-4,118,151,134
25007,007,25,2013,17173,312,0,312,161,146
25007,007,25,2014,17312,126,1,127,153,142
25007,007,25,2015,17290,-58,1,-57,173,138
25007,007,25,2016,17349,36,44,80,133,152
25007,007,25,2017,17422,-11,51,40,193,158
25007,007,25,2018,17459,-11,38,27,165,154
25007,007,25,2019,17461,-60,39,-21,170,146
25007,007,25,2020,17461,-50,31,-19,166,148
25009,009,25,2010,745469,645,969,1614,2178,1390
25009,009,25,2011,751553,347,3563,3910,8483,6275
25009,009,25,2012,757409,-458,4248,3790,8349,6140
25009,009,25,2013,764684,1114,4265,5379,8365,6363
25009,009,25,2014,771803,315,4993,5308,8419,6420
25009,009,25,2015,777228,-822,4622,3800,8550,6837
25009,009,25,2016,780222,-3825,4950,1125,8433,6548
25009,009,25,2017,785156,-2273,5598,3325,8507,6879
25009,009,25,2018,788823,-2285,4568,2283,8617,7227
25009,009,25,2019,789725,-4161,3669,-492,8333,6956
25009,009,25,2020,791263,-2518,3052,534,8291,7321
25011,011,25,2010,71372,-50,34,-16,154,144
25011,011,25,2011,71711,262,114,376,635,670
25011,011,25,2012,71714,-188,169,-19,676,643
25011,011,25,2013,71399,-424,178,-246,621,692
25011,011,25,2014,71344,-151,231,80,587,708
25011,011,25,2015,70911,-458,154,-304,600,727
25011,011,25,2016,70706,-292,168,-124,615,694
25011,011,25,2017,70674,-54,186,132,587,745
25011,011,25,2018,70722,113,156,269,505,721
25011,011,25,2019,70276,-331,118,-213,473,707
25011,011,25,2020,70267,202,104,306,461,774
25013,013,25,2010,464248,-147,582,435,1328,1071
25013,013,25,2011,466191,-2103,2744,641,5536,4231
25013,013,25,2012,467009,-3213,2772,-441,5427,4197
25013,013,25,2013,467828,-2539,2447,-92,5363,4444
25013,013,25,2014,469561,-1918,2726,808,5331,4353
25013,013,25,2015,469251,-3513,2480,-1033,5178,4461
25013,013,25,2016,467874,-4496,2406,-2090,5025,4322
25013,013,25,2017,467552,-3155,2541,-614,4938,4653
25013,013,25,2018,468075,-3030,3205,175,5034,4696
25013,013,25,2019,465749,-2937,327,-2610,4846,4571
25013,013,25,2020,463986,-2925,961,-1964,4843,4654
25015,015,25,2010,159331,932,189,1121,302,270
25015,015,25,2011,160192,234,706,940,1123,1201
25015,015,25,2012,160497,-388,731,343,1124,1148
25015,015,25,2013,160969,-69,751,682,1088,1279
25015,015,25,2014,161060,-554,790,236,1111,1243
25015,015,25,2015,160885,-613,661,48,1046,1268
25015,015,25,2016,161613,138,779,917,1011,1194
25015,015,25,2017,161070,-1087,817,-270,990,1271
25015,015,25,2018,161126,-193,584,391,984,1318
25015,015,25,2019,161596,293,546,839,974,1345
25015,015,25,2020,161401,-159,432,273,932,1404
25017,017,25,2010,1507694,-247,2863,2616,4696,2525
25017,017,25,2011,1524996,107,10660,10767,17637,11054
25017,017,25,2012,1543163,-35,11845,11810,17368,10690
25017,017,25,2013,1560625,-154,11115,10961,17640,10877
25017,017,25,2014,1575520,-4615,13098,8483,17657,10996
25017,017,25,2015,1586107,-7156,11813,4657,17507,11465
25017,017,25,2016,1595581,-9606,13271,3665,17147,11328
25017,017,25,2017,1604762,-10340,14052,3712,17076,11607
25017,017,25,2018,1608509,-10994,9733,-1261,16674,11688
25017,017,25,2019,1611263,-11160,9400,-1760,16512,12030
25017,017,25,2020,1609379,-12784,7426,-5358,16438,13015
25019,019,25,2010,10165,-60,18,-42,45,9
25019,019,25,2011,10133,-156,53,-103,134,66
25019,019,25,2012,10313,59,55,114,136,70
25019,019,25,2013,10564,55,84,139,147,38
25019,019,25,2014,10833,115,98,213,122,70
25019,019,25,2015,10933,-35,75,40,141,80
25019,019,25,2016,11081,-11,57,46,170,69
25019,019,25,2017,11156,-58,55,-3,148,68
25019,019,25,2018,11118,-152,38,-114,152,77
25019,019,25,2019,11330,79,42,121,154,63
25019,019,25,2020,11376,-84,33,-51,158,61
25021,021,25,2010,673059,859,693,1552,1891,1322
25021,021,25,2011,677823,431,2738,3169,7121,5494
25021,021,25,2012,682984,256,3216,3472,7240,5387
25021,021,25,2013,688518,1163,2995,4158,7179,5688
25021,021,25,2014,692439,-1451,3877,2426,7248,5643
25021,021,25,2015,694774,-2448,3432,984,7337,5954
25021,021,25,2016,697452,-2846,4055,1209,7235,5754
25021,021,25,2017,701046,-1878,4292,2414,7171,5970
25021,021,25,2018,703628,-1590,2769,1179,7222,5805
25021,021,25,2019,707164,-374,2871,2497,7044,6011
25021,021,25,2020,709409,-689,2243,1554,7058,6404
25023,023,25,2010,495937,357,352,709,1292,955
25023,023,25,2011,498212,182,1152,1334,5180,4222
25023,023,25,2012,499545,-909,1362,453,4914,3983
25023,023,25,2013,502895,1217,1268,2485,5181,4230
25023,023,25,2014,506634,1619,1456,3075,5129,4374
25023,023,25,2015,509413,761,1506,2267,5243,4663
25023,023,25,2016,512535,679,1843,2522,5218,4583
25023,023,25,2017,515984,1165,1995,3160,5121,4794
25023,023,25,2018,518888,959,1509,2468,5182,4719
25023,023,25,2019,521841,1312,1487,2799,5013,4855
25023,023,25,2020,523738,933,1142,2075,5023,5223
25025,025,25,2010,725786,127,2197,2324,2264,1031
25025,025,25,2011,737285,-1751,8183,6432,9696,4633
25025,025,25,2012,751371,-90,9117,9027,9550,4509
25025,025,25,2013,762863,-2643,9308,6665,9578,4663
25025,025,25,2014,774113,-4282,10942,6660,9273,4542
25025,025,25,2015,783177,-5639,10035,4396,9482,4768
25025,025,25,2016,793020,-5601,10711,5110,9434,4677
25025,025,25,2017,801269,-8033,11678,3645,9318,4679
25025,025,25,2018,804023,-10154,8705,-1449,9053,4833
25025,025,25,2019,805915,-9771,7928,-1843,8987,5222
25025,025,25,2020,801582,-13632,6332,-7300,8976,5967
25027,027,25,2010,800404,487,788,1275,2263,1484
25027,027,25,2011,804107,-1636,3151,1515,8805,6599
25027,027,25,2012,807047,-2805,3581,776,8714,6492
25027,027,25,2013,810994,-1149,3384,2235,8582,6780
25027,027,25,2014,815707,-1288,4153,2865,8713,6725
25027,027,25,2015,818446,-2174,3728,1554,8450,7213
25027,027,25,2016,820447,-3557,3898,341,8687,7022
25027,027,25,2017,825646,-510,4414,3904,8585,7256
25027,027,25,2018,828644,-1922,3899,1977,8560,7532
25027,027,25,2019,829327,-2300,2142,-158,8257,7441
25027,027,25,2020,829212,-2745,2089,-656,8280,7785
26001,001,26,2010,10879,-17,0,-17,20,65
26001,001,26,2011,10742,-22,2,-20,60,176
26001,001,26,2012,10571,-32,5,-27,58,200
26001,001,26,2013,10550,91,4,95,65,182
26001,001,26,2014,10447,8,2,10,66,179
26001,001,26,2015,10327,25,1,26,52,198
26001,001,26,2016,10355,149,2,151,58,183
26001,001,26,2017,10305,73,1,74,67,192
26001,001,26,2018,10364,171,1,172,51,163
26001,001,26,2019,10453,192,1,193,72,174
26001,001,26,2020,10505,150,1,151,82,180
26003,003,26,2010,9578,-21,0,-21,13,15
26003,003,26,2011,9516,-22,4,-18,53,97
26003,003,26,2012,9456,-1,3,2,61,121
26003,003,26,2013,9445,32,1,33,59,104
26003,003,26,2014,9370,-19,2,-17,61,117
26003,003,26,2015,9265,-28,3,-25,59,138
26003,003,26,2016,9138,-73,3,-70,61,117
26003,003,26,2017,9152,63,1,64,64,114
26003,003,26,2018,9105,5,3,8,57,112
26003,003,26,2019,9078,20,5,25,58,109
26003,003,26,2020,9015,-9,4,-5,57,114
26005,005,26,2010,111521,-41,25,-16,339,192
26005,005,26,2011,111167,-862,58,-804,1356,908
26005,005,26,2012,111506,-155,74,-81,1348,915
26005,005,26,2013,112020,80,77,157,1301,929
26005,005,26,2014,113361,828,66,894,1367,918
26005,005,26,2015,114122,395,41,436,1391,1052
26005,005,26,2016,115018,349,102,451,1399,949
26005,005,26,2017,116393,988,57,1045,1380,1045
26005,005,26,2018,117137,356,45,401,1336,988
26005,005,26,2019,118045,495,42,537,1375,1005
26005,005,26,2020,118927,437,38,475,1423,1021
26007,007,26,2010,29511,-38,4,-34,66,113
26007,007,26,2011,29342,-96,10,-86,280,363
26007,007,26,2012,29168,-48,5,-43,243,368
26007,007,26,2013,28964,-85,-1,-86,257,372
26007,007,26,2014,28888,-17,5,-12,275,332
26007,007,26,2015,28728,-73,9,-64,275,368
26007,007,26,2016,28670,53,15,68,259,382
26007,007,26,2017,28434,-113,10,-103,273,406
26007,007,26,2018,28422,82,8,90,292,392
26007,007,26,2019,28391,89,7,96,235,362
26007,007,26,2020,28238,-24,3,-21,233,365
26009,009,26,2010,23492,-43,0,-43,40,81
26009,009,26,2011,23324,-116,4,-112,210,265
26009,009,26,2012,23251,-30,2,-28,204,243
26009,009,26,2013,23128,-21,7,-14,156,261
26009,009,26,2014,23147,72,5,77,224,282
26009,009,26,2015,23036,-33,6,-27,209,290
26009,009,26,2016,23090,99,8,107,214,267
26009,009,26,2017,23267,279,4,283,154,260
26009,009,26,2018,23339,169,5,174,183,285
26009,009,26,2019,23359,125,7,132,162,273
26009,009,26,2020,23449,204,4,208,186,300
26011,011,26,2010,15852,-9,0,-9,19,60
26011,011,26,2011,15635,-147,2,-145,143,213
26011,011,26,2012,15500,-53,2,-51,126,209
26011,011,26,2013,15411,23,-1,22,108,217
26011,011,26,2014,15317,10,1,11,117,217
26011,011,26,2015,15304,21,2,23,147,181
26011,011,26,2016,15126,-92,2,-90,118,206
26011,011,26,2017,15009,-4,0,-4,120,231
26011,011,26,2018,15033,102,-1,101,128,204
26011,011,26,2019,14944,-28,-1,-29,134,193
26011,011,26,2020,14953,92,-1,91,137,218
26013,013,26,2010,8861,-17,0,-17,22,11
26013,013,26,2011,8835,2,7,9,79,113
26013,013,26,2012,8725,-83,4,-79,88,120
26013,013,26,2013,8716,2,5,7,73,89
26013,013,26,2014,8649,-37,5,-32,77,110
26013,013,26,2015,8583,-57,6,-51,80,94
26013,013,26,2016,8532,-11,2,-9,60,102
26013,013,26,2017,8433,-62,2,-60,72,110
26013,013,26,2018,8313,-71,0,-71,62,111
26013,013,26,2019,8245,-24,0,-24,60,104
26013,013,26,2020,8164,-26,0,-26,70,125
26015,015,26,2010,59092,-148,2,-146,154,97
26015,015,26,2011,58921,-326,14,-312,629,489
26015,015,26,2012,59025,-42,14,-28,641,506
26015,015,26,2013,59094,2,9,11,624,557
26015,015,26,2014,59305,71,15,86,618,479
26015,015,26,2015,59434,5,29,34,656,551
26015,015,26,2016,59801,268,38,306,627,565
26015,015,26,2017,60689,790,30,820,637,569
26015,015,26,2018,61195,449,18,467,639,597
26015,015,26,2019,61481,239,12,251,625,589
26015,015,26,2020,62061,541,11,552,658,628
26017,017,26,2010,107678,-81,10,-71,297,311
26017,017,26,2011,107423,-323,78,-245,1153,1160
26017,017,26,2012,106980,-364,54,-310,1070,1190
26017,017,26,2013,106817,-76,33,-43,1030,1138
26017,017,26,2014,106073,-697,24,-673,1088,1158
26017,017,26,2015,105271,-544,14,-530,1030,1298
26017,017,26,2016,104421,-637,17,-620,1019,1247
26017,017,26,2017,104085,-115,11,-104,1051,1277
26017,017,26,2018,103674,-112,8,-104,939,1242
26017,017,26,2019,102964,-446,2,-444,971,1238
26017,017,26,2020,102387,-261,3,-258,921,1242
26019,019,26,2010,17495,0,0,0,37,58
26019,019,26,2011,17380,-59,-2,-61,146,200
26019,019,26,2012,17319,4,-3,1,147,204
26019,019,26,2013,17340,82,-2,80,145,207
26019,019,26,2014,17466,181,-2,179,169,224
26019,019,26,2015,17386,-22,-2,-24,155,209
26019,019,26,2016,17523,210,1,211,145,217
26019,019,26,2017,17625,107,1,108,175,181
26019,019,26,2018,17748,179,1,180,153,211
26019,019,26,2019,17767,89,1,90,142,213
26019,019,26,2020,17852,176,0,176,141,230
26021,021,26,2010,156740,-204,85,-119,482,426
26021,021,26,2011,156911,-514,353,-161,1946,1610
26021,021,26,2012,156669,-856,474,-382,1817,1672
26021,021,26,2013,156205,-1092,438,-654,1833,1653
26021,021,26,2014,156074,-707,419,-288,1869,1701
26021,021,26,2015,155136,-1237,353,-884,1791,1844
26021,021,26,2016,154451,-1121,437,-684,1720,1719
26021,021,26,2017,154264,-411,328,-83,1717,1816
26021,021,26,2018,153892,-454,223,-231,1670,1808
26021,021,26,2019,153352,-653,176,-477,1648,1711
26021,021,26,2020,153025,-312,154,-158,1644,1818
26023,023,26,2010,45173,-135,9,-126,131,77
26023,023,26,2011,43921,-1423,43,-1380,548,434
26023,023,26,2012,43790,-217,54,-163,479,447
26023,023,26,2013,43582,-362,49,-313,550,448
26023,023,26,2014,43733,-27,51,24,554,418
26023,023,26,2015,43635,-184,46,-138,518,475
26023,023,26,2016,43451,-310,47,-263,536,456
26023,023,26,2017,43345,-190,38,-152,536,489
26023,023,26,2018,43474,42,28,70,532,472
26023,023,26,2019,43444,-186,30,-156,561,436
26023,023,26,2020,43424,-162,22,-140,568,449
26025,025,26,2010,135953,-203,51,-152,409,453
26025,025,26,2011,135111,-1235,195,-1040,1662,1468
26025,025,26,2012,134755,-860,330,-530,1619,1449
26025,025,26,2013,134782,-485,296,-189,1683,1463
26025,025,26,2014,134845,-501,335,-166,1700,1457
26025,025,26,2015,134377,-984,308,-676,1670,1463
26025,025,26,2016,134343,-457,341,-116,1647,1561
26025,025,26,2017,134127,-498,242,-256,1617,1574
26025,025,26,2018,133858,-377,150,-227,1492,1531
26025,025,26,2019,133806,-154,98,-56,1509,1506
26025,025,26,2020,133580,-331,82,-249,1508,1489
26027,027,26,2010,52245,-53,8,-45,108,104
26027,027,26,2011,52210,-43,18,-25,471,479
26027,027,26,2012,51815,-385,13,-372,469,497
26027,027,26,2013,51601,-118,-2,-120,440,524
26027,027,26,2014,51585,-48,13,-35,537,511
26027,027,26,2015,51370,-171,12,-159,513,567
26027,027,26,2016,51326,-19,12,-7,484,515
26027,027,26,2017,51534,244,12,256,485,528
26027,027,26,2018,51773,290,2,292,489,541
26027,027,26,2019,51847,142,0,142,483,549
26027,027,26,2020,51584,-145,1,-144,463,582
26029,029,26,2010,25936,-35,5,-30,55,43
26029,029,26,2011,26106,151,55,206,248,284
26029,029,26,2012,26193,18,70,88,242,236
26029,029,26,2013,26258,75,24,99,257,290
26029,029,26,2014,26222,26,33,59,212,300
26029,029,26,2015,26219,20,28,48,239,287
26029,029,26,2016,26214,-7,28,21,245,269
26029,029,26,2017,26218,44,25,69,217,281
26029,029,26,2018,26247,84,22,106,223,300
26029,029,26,2019,26202,22,20,42,218,303
26029,029,26,2020,26105,-30,12,-18,240,319
26031,031,26,2010,26059,-34,0,-34,48,96
26031,031,26,2011,25884,-64,10,-54,169,289
26031,031,26,2012,25745,-38,7,-31,203,306
26031,031,26,2013,25573,-56,3,-53,190,304
26031,031,26,2014,25635,143,5,148,214,299
26031,031,26,2015,25399,-127,2,-125,214,324
26031,031,26,2016,25452,147,1,148,210,304
26031,031,26,2017,25448,111,0,111,231,345
26031,031,26,2018,25574,225,0,225,232,331
26031,031,26,2019,25331,-74,0,-74,187,355
26031,031,26,2020,25365,250,0,250,178,393
26033,033,26,2010,38623,-54,7,-47,86,96
26033,033,26,2011,38904,203,58,261,379,360
26033,033,26,2012,39006,56,69,125,347,368
26033,033,26,2013,38587,-492,59,-433,346,345
26033,033,26,2014,38275,-344,49,-295,354,373
26033,033,26,2015,37998,-304,21,-283,376,370
26033,033,26,2016,37724,-308,14,-294,355,335
26033,033,26,2017,37699,-16,11,-5,317,334
26033,033,26,2018,37423,-182,3,-179,305,404
26033,033,26,2019,37287,-63,0,-63,319,392
26033,033,26,2020,36958,-239,-1,-240,313,402
26035,035,26,2010,31005,60,0,60,91,72
26035,035,26,2011,31002,75,4,79,325,405
26035,035,26,2012,30796,-111,3,-108,314,406
26035,035,26,2013,30598,-132,5,-127,327,394
26035,035,26,2014,30727,177,3,180,315,366
26035,035,26,2015,30611,-18,7,-11,341,442
26035,035,26,2016,30382,-133,5,-128,331,431
26035,035,26,2017,30553,315,7,322,324,474
26035,035,26,2018,30684,224,1,225,338,432
26035,035,26,2019,30884,289,1,290,325,414
26035,035,26,2020,30771,23,0,23,301,437
26037,037,26,2010,75400,-23,21,-2,196,152
26037,037,26,2011,75902,175,92,267,804,566
26037,037,26,2012,76171,-60,120,60,749,542
26037,037,26,2013,76821,330,101,431,801,572
26037,037,26,2014,76973,-73,86,13,816,666
26037,037,26,2015,77037,-223,92,-131,807,611
26037,037,26,2016,77639,294,103,397,812,603
26037,037,26,2017,78550,654,87,741,829,655
26037,037,26,2018,79229,455,51,506,794,615
26037,037,26,2019,79615,161,23,184,825,623
26037,037,26,2020,79753,-75,25,-50,819,634
26039,039,26,2010,14054,-14,1,-13,34,46
26039,039,26,2011,14040,27,2,29,132,175
26039,039,26,2012,13952,-49,8,-41,109,153
26039,039,26,2013,13878,-19,9,-10,101,162
26039,039,26,2014,13740,-97,8,-89,126,174
26039,039,26,2015,13854,142,9,151,136,173
26039,039,26,2016,13754,-45,3,-42,114,172
26039,039,26,2017,13894,209,2,211,124,195
26039,039,26,2018,13881,54,2,56,124,192
26039,039,26,2019,14012,194,1,195,111,175
26039,039,26,2020,13981,51,1,52,104,187
26041,041,26,2010,37049,18,1,19,82,115
26041,041,26,2011,36946,-28,0,-28,371,445
26041,041,26,2012,36840,-38,3,-35,360,425
26041,041,26,2013,36806,-10,6,-4,388,414
26041,041,26,2014,36592,-190,7,-183,373,405
26041,041,26,2015,36431,-93,-1,-94,375,440
26041,041,26,2016,36217,-131,4,-127,351,435
26041,041,26,2017,35911,-184,2,-182,361,483
26041,041,26,2018,35887,83,-1,82,348,453
26041,041,26,2019,35744,10,0,10,314,465
26041,041,26,2020,35612,-4,2,-2,329,460
26043,043,26,2010,26156,-25,3,-22,56,44
26043,043,26,2011,26069,28,-1,27,220,334
26043,043,26,2012,26176,141,-1,140,263,293
26043,043,26,2013,26024,-90,4,-86,254,318
26043,043,26,2014,25910,-82,3,-79,254,288
26043,043,26,2015,25675,-126,7,-119,217,331
26043,043,26,2016,25531,-111,12,-99,270,316
26043,043,26,2017,25453,-49,10,-39,288,325
26043,043,26,2018,25431,24,7,31,236,288
26043,043,26,2019,25336,-36,3,-33,236,298
26043,043,26,2020,25112,-145,1,-144,255,334
26045,045,26,2010,107745,-99,50,-49,283,242
26045,045,26,2011,107927,-283,225,-58,1194,952
26045,045,26,2012,108013,-325,203,-122,1130,915
26045,045,26,2013,108288,-2,141,139,1180,1030
26045,045,26,2014,108668,18,152,170,1193,956
26045,045,26,2015,108701,-313,168,-145,1181,997
26045,045,26,2016,109220,137,194,331,1182,986
26045,045,26,2017,109479,-14,159,145,1161,1041
26045,045,26,2018,109684,38,103,141,1122,1053
26045,045,26,2019,110119,373,44,417,1100,1080
26045,045,26,2020,110148,-38,52,14,1090,1079
26047,047,26,2010,32655,-7,2,-5,64,97
26047,047,26,2011,32749,47,20,67,336,308
26047,047,26,2012,32813,83,20,103,312,344
26047,047,26,2013,32955,146,15,161,293,307
26047,047,26,2014,32980,110,13,123,299,391
26047,047,26,2015,32931,19,16,35,290,371
26047,047,26,2016,32910,3,19,22,322,363
26047,047,26,2017,33102,276,18,294,281,382
26047,047,26,2018,33168,170,12,182,269,382
26047,047,26,2019,33337,204,3,207,279,318
26047,047,26,2020,33342,61,5,66,279,341
26049,049,26,2010,424959,-1161,73,-1088,1316,1101
26049,049,26,2011,422062,-4263,268,-3995,5217,4138
26049,049,26,2012,418243,-4920,227,-4693,4966,4199
26049,049,26,2013,415713,-3460,203,-3257,4914,4227
26049,049,26,2014,412950,-3630,237,-3393,5031,4438
26049,049,26,2015,410574,-2709,213,-2496,4818,4693
26049,049,26,2016,409054,-2157,328,-1829,4753,4438
26049,049,26,2017,407673,-1735,239,-1496,4779,4659
26049,049,26,2018,406626,-1083,146,-937,4660,4765
26049,049,26,2019,405702,-988,64,-924,4630,4640
26049,049,26,2020,404794,-573,79,-494,4486,4916
26051,051,26,2010,25734,29,2,31,64,54
26051,051,26,2011,25873,214,11,225,245,331
26051,051,26,2012,25543,-211,12,-199,207,336
26051,051,26,2013,25562,118,0,118,244,342
26051,051,26,2014,25498,8,2,10,253,323
26051,051,26,2015,25227,-223,2,-221,296,346
26051,051,26,2016,25146,17,-1,16,268,363
26051,051,26,2017,25236,189,-1,188,239,337
26051,051,26,2018,25326,217,-1,216,271,398
26051,051,26,2019,25430,261,-1,260,234,389
26051,051,26,2020,25424,143,-1,142,263,410
26053,053,26,2010,16397,-22,3,-19,31,38
26053,053,26,2011,16113,-183,0,-183,140,242
26053,053,26,2012,16037,26,7,33,123,230
26053,053,26,2013,15905,-30,6,-24,115,221
26053,053,26,2014,15756,-68,5,-63,117,202
26053,053,26,2015,15537,-159,2,-157,129,191
26053,053,26,2016,15331,-110,3,-107,118,216
26053,053,26,2017,15337,69,2,71,132,197
26053,053,26,2018,15095,-166,1,-165,118,195
26053,053,26,2019,13971,-1068,4,-1064,127,188
26053,053,26,2020,13842,-39,2,-37,128,219
26055,055,26,2010,86975,-49,4,-45,233,190
26055,055,26,2011,88362,1264,11,1275,873,768
26055,055,26,2012,89238,670,51,721,926,776
26055,055,26,2013,90149,787,22,809,916,818
26055,055,26,2014,90908,553,31,584,990,811
26055,055,26,2015,91610,603,26,629,934,859
26055,055,26,2016,92076,321,62,383,944,857
26055,055,26,2017,91914,-226,34,-192,920,890
26055,055,26,2018,92587,711,25,736,870,932
26055,055,26,2019,93032,470,21,491,849,895
26055,055,26,2020,93592,629,17,646,870,953
26057,057,26,2010,42431,-38,5,-33,111,122
26057,057,26,2011,42121,-350,22,-328,439,422
26057,057,26,2012,41975,-196,19,-177,432,397
26057,057,26,2013,41937,11,16,27,404,467
26057,057,26,2014,41468,-454,9,-445,376,411
26057,057,26,2015,41333,-99,10,-89,421,465
26057,057,26,2016,40937,-331,14,-317,370,451
26057,057,26,2017,40978,122,8,130,385,473
26057,057,26,2018,40582,-354,4,-350,406,453
26057,057,26,2019,40681,153,5,158,406,467
26057,057,26,2020,40283,-326,3,-323,384,460
26059,059,26,2010,46646,-69,0,-69,139,115
26059,059,26,2011,46602,-131,-1,-132,568,478
26059,059,26,2012,46270,-388,7,-381,494,447
26059,059,26,2013,46138,-208,4,-204,544,469
26059,059,26,2014,45937,-340,5,-335,580,445
26059,059,26,2015,45894,-99,9,-90,543,492
26059,059,26,2016,45789,-170,10,-160,541,485
26059,059,26,2017,45831,6,5,11,552,517
26059,059,26,2018,45709,-137,0,-137,508,493
26059,059,26,2019,45548,-157,9,-148,477,490
26059,059,26,2020,45658,121,7,128,502,521
26061,061,26,2010,36729,22,42,64,108,64
26061,061,26,2011,36780,-181,193,12,403,362
26061,061,26,2012,36752,-264,204,-60,375,348
26061,061,26,2013,36691,-269,194,-75,377,368
26061,061,26,2014,36487,-410,173,-237,365,343
26061,061,26,2015,36248,-366,115,-251,362,354
26061,061,26,2016,36354,-65,156,91,385,369
26061,061,26,2017,36270,-210,138,-72,352,365
26061,061,26,2018,35993,-344,88,-256,356,378
26061,061,26,2019,35709,-355,41,-314,349,320
26061,061,26,2020,35126,-623,44,-579,372,372
26063,063,26,2010,33084,-38,0,-38,93,85
26063,063,26,2011,32765,-238,17,-221,316,415
26063,063,26,2012,32449,-145,18,-127,267,453
26063,063,26,2013,32251,-82,17,-65,297,426
26063,063,26,2014,32034,-72,11,-61,288,441
26063,063,26,2015,31761,-93,12,-81,299,488
26063,063,26,2016,31471,-170,14,-156,306,440
26063,063,26,2017,31304,-51,17,-34,334,465
26063,063,26,2018,31193,59,15,74,289,470
26063,063,26,2019,30904,-86,2,-84,265,471
26063,063,26,2020,30653,-19,4,-15,247,483
26065,065,26,2010,281122,-690,442,-248,824,374
26065,065,26,2011,282828,-1731,2153,422,3284,2006
26065,065,26,2012,283592,-2698,2077,-621,3265,1930
26065,065,26,2013,284226,-2657,2063,-594,3248,2062
26065,065,26,2014,285760,-1766,2077,311,3314,2094
26065,065,26,2015,287255,-1578,1946,368,3340,2207
26065,065,26,2016,289633,-868,2109,1241,3251,2107
26065,065,26,2017,291678,-856,1751,895,3244,2087
26065,065,26,2018,291267,-2658,1173,-1485,3190,2132
26065,065,26,2019,291426,-1429,747,-682,3062,2230
26065,065,26,2020,290609,-2031,615,-1416,3014,2426
26067,067,26,2010,63847,-87,1,-86,201,169
26067,067,26,2011,63865,-277,4,-273,747,457
26067,067,26,2012,63890,-272,13,-259,732,447
26067,067,26,2013,64001,-144,9,-135,755,504
26067,067,26,2014,64246,65,2,67,718,526
26067,067,26,2015,64073,-404,9,-395,739,518
26067,067,26,2016,64215,-81,17,-64,746,537
26067,067,26,2017,64293,-110,10,-100,724,545
26067,067,26,2018,64290,-181,9,-172,706,538
26067,067,26,2019,64654,212,13,225,674,536
26067,067,26,2020,64553,-187,12,-175,673,602
26069,069,26,2010,25841,-44,4,-40,59,69
26069,069,26,2011,25599,-80,9,-71,200,369
26069,069,26,2012,25455,17,17,34,227,403
26069,069,26,2013,25433,156,12,168,231,423
26069,069,26,2014,25445,141,11,152,233,377
26069,069,26,2015,25360,88,5,93,254,431
26069,069,26,2016,25307,122,21,143,213,408
26069,069,26,2017,25180,46,20,66,234,427
26069,069,26,2018,25195,167,18,185,239,408
26069,069,26,2019,25244,210,8,218,244,411
26069,069,26,2020,25140,51,7,58,260,421
26071,071,26,2010,11811,0,0,0,20,24
26071,071,26,2011,11767,59,1,60,87,191
26071,071,26,2012,11569,-91,2,-89,101,210
26071,071,26,2013,11506,32,2,34,83,178
26071,071,26,2014,11352,-48,2,-46,91,196
26071,071,26,2015,11327,50,1,51,97,171
26071,071,26,2016,11168,-42,1,-41,85,203
26071,071,26,2017,11112,39,0,39,98,193
26071,071,26,2018,11094,79,0,79,110,206
26071,071,26,2019,11053,49,0,49,82,171
26071,071,26,2020,11066,126,0,126,79,189
26073,073,26,2010,70297,-88,32,-56,178,136
26073,073,26,2011,70624,-69,217,148,646,466
26073,073,26,2012,70679,-377,246,-131,629,436
26073,073,26,2013,70240,-898,234,-664,650,451
26073,073,26,2014,70116,-625,257,-368,680,452
26073,073,26,2015,70798,229,207,436,722,475
26073,073,26,2016,71247,120,197,317,639,507
26073,073,26,2017,71035,-512,145,-367,648,495
26073,073,26,2018,70392,-920,93,-827,690,516
26073,073,26,2019,69635,-886,51,-835,589,517
26073,073,26,2020,69504,-273,48,-225,597,503
26075,075,26,2010,160109,-213,34,-179,481,424
26075,075,26,2011,159666,-876,107,-769,1827,1501
26075,075,26,2012,159988,40,92,132,1799,1579
26075,075,26,2013,159672,-536,93,-443,1787,1653
26075,075,26,2014,159464,-452,90,-362,1761,1589
26075,075,26,2015,159325,-388,82,-306,1828,1647
26075,075,26,2016,158345,-1105,111,-994,1757,1743
26075,075,26,2017,158653,244,93,337,1792,1810
26075,075,26,2018,158594,-90,77,-13,1714,1753
26075,075,26,2019,158357,-252,25,-227,1698,1711
26075,075,26,2020,156920,-1420,26,-1394,1701,1744
26077,077,26,2010,250754,-27,147,120,784,448
26077,077,26,2011,252634,317,597,914,3068,2093
26077,077,26,2012,255413,1020,626,1646,3050,1904
26077,077,26,2013,257399,240,617,857,3153,1986
26077,077,26,2014,259063,63,541,604,3191,2078
26077,077,26,2015,259816,-701,442,-259,3204,2173
26077,077,26,2016,261584,-73,758,685,3161,2065
26077,077,26,2017,263387,361,541,902,3119,2205
26077,077,26,2018,265120,484,382,866,3085,2213
26077,077,26,2019,265531,-676,306,-370,3019,2248
26077,077,26,2020,265988,-477,256,-221,3044,2383
26079,079,26,2010,17146,-25,2,-23,46,24
26079,079,26,2011,17175,44,13,57,161,187
26079,079,26,2012,17104,-60,12,-48,182,204
26079,079,26,2013,17296,173,7,180,191,180
26079,079,26,2014,17374,89,12,101,167,188
26079,079,26,2015,17254,-109,1,-108,177,188
26079,079,26,2016,17283,73,8,81,185,237
26079,079,26,2017,17582,326,7,333,158,194
26079,079,26,2018,17774,234,4,238,175,220
26079,079,26,2019,17984,194,4,198,191,179
26079,079,26,2020,18003,8,1,9,192,182
26081,081,26,2010,602994,-1079,241,-838,2233,1050
26081,081,26,2011,608543,-59,1207,1148,8659,4234
26081,081,26,2012,615871,1348,1663,3011,8865,4462
26081,081,26,2013,624409,2332,1659,3991,8921,4361
26081,081,26,2014,631464,1119,1658,2777,8843,4488
26081,081,26,2015,637333,372,1445,1817,8871,4754
26081,081,26,2016,644219,554,2206,2760,8861,4712
26081,081,26,2017,649722,-71,1653,1582,8752,4801
26081,081,26,2018,653636,-766,1187,421,8506,4992
26081,081,26,2019,656800,-1343,830,-513,8461,4800
26081,081,26,2020,658708,-2193,699,-1494,8596,5226
26083,083,26,2010,2170,11,0,11,2,1
26083,083,26,2011,2180,13,1,14,19,22
26083,083,26,2012,2169,-11,1,-10,18,19
26083,083,26,2013,2144,-18,0,-18,13,18
26083,083,26,2014,2175,33,0,33,25,30
26083,083,26,2015,2124,-53,0,-53,17,15
26083,083,26,2016,2143,20,1,21,22,23
26083,083,26,2017,2087,-34,1,-33,12,36
26083,083,26,2018,2076,4,0,4,17,29
26083,083,26,2019,2085,15,0,15,13,19
26083,083,26,2020,2119,47,1,48,12,26
26085,085,26,2010,11514,-4,0,-4,24,46
26085,085,26,2011,11456,7,-1,6,91,156
26085,085,26,2012,11462,41,0,41,99,136
26085,085,26,2013,11395,-12,3,-9,105,162
26085,085,26,2014,11399,65,13,78,89,164
26085,085,26,2015,11691,356,1,357,85,157
26085,085,26,2016,11861,187,6,193,118,145
26085,085,26,2017,11977,176,6,182,104,170
26085,085,26,2018,11850,-45,4,-41,110,194
26085,085,26,2019,11752,-12,1,-11,96,183
26085,085,26,2020,11587,-75,1,-74,87,177
26087,087,26,2010,88206,-179,14,-165,229,181
26087,087,26,2011,88095,-193,52,-141,808,781
26087,087,26,2012,88200,-78,73,-5,838,725
26087,087,26,2013,88299,5,54,59,817,774
26087,087,26,2014,88202,-136,38,-98,799,791
26087,087,26,2015,88376,153,25,178,857,853
26087,087,26,2016,88227,-174,85,-89,789,848
26087,087,26,2017,88218,81,61,142,774,918
26087,087,26,2018,87987,-122,55,-67,773,935
26087,087,26,2019,87808,-206,54,-152,848,876
26087,087,26,2020,87635,-63,43,-20,815,968
26089,089,26,2010,21718,38,4,42,38,72
26089,089,26,2011,21428,-273,19,-254,160,198
26089,089,26,2012,21380,-12,24,12,166,222
26089,089,26,2013,21475,157,10,167,173,243
26089,089,26,2014,21596,189,17,206,163,250
26089,089,26,2015,21633,96,15,111,173,245
26089,089,26,2016,21508,-98,16,-82,178,219
26089,089,26,2017,21638,202,6,208,167,243
26089,089,26,2018,21662,140,2,142,165,283
26089,089,26,2019,21692,104,2,106,162,238
26089,089,26,2020,21743,146,3,149,143,240
26091,091,26,2010,99642,-326,24,-302,261,236
26091,091,26,2011,99370,-407,52,-355,1025,943
26091,091,26,2012,99041,-554,33,-521,1059,872
26091,091,26,2013,98850,-247,23,-224,1052,1013
26091,091,26,2014,98774,-198,53,-145,1076,996
26091,091,26,2015,98432,-351,42,-309,1040,1069
26091,091,26,2016,98595,91,98,189,1055,1074
26091,091,26,2017,98511,-89,61,-28,1007,1058
26091,091,26,2018,98118,-375,80,-295,989,1087
26091,091,26,2019,98519,355,57,412,997,1008
26091,091,26,2020,97808,-684,54,-630,1012,1093
26093,093,26,2010,181065,-140,21,-119,478,257
26093,093,26,2011,182052,576,59,635,1708,1351
26093,093,26,2012,182805,314,77,391,1707,1315
26093,093,26,2013,184238,949,84,1033,1780,1352
26093,093,26,2014,185567,869,98,967,1757,1366
26093,093,26,2015,187221,1181,96,1277,1816,1425
26093,093,26,2016,188585,870,124,994,1795,1415
26093,093,26,2017,189923,947,74,1021,1825,1493
26093,093,26,2018,191259,1053,48,1101,1790,1546
26093,093,26,2019,192058,576,38,614,1776,1588
26093,093,26,2020,192335,296,35,331,1710,1766
26095,095,26,2010,6602,-30,0,-30,23,23
26095,095,26,2011,6524,-59,1,-58,50,71
26095,095,26,2012,6479,-38,4,-34,53,63
26095,095,26,2013,6505,42,1,43,54,73
26095,095,26,2014,6414,-77,6,-71,49,69
26095,095,26,2015,6431,17,2,19,60,61
26095,095,26,2016,6332,-45,3,-42,37,93
26095,095,26,2017,6372,48,3,51,57,68
26095,095,26,2018,6336,-15,1,-14,50,73
26095,095,26,2019,6266,-56,1,-55,58,72
26095,095,26,2020,6126,-98,1,-97,47,90
26097,097,26,2010,11104,-8,0,-8,26,22
26097,097,26,2011,11012,-33,8,-25,72,138
26097,097,26,2012,11066,72,15,87,85,120
26097,097,26,2013,11002,-18,13,-5,74,132
26097,097,26,2014,10990,11,27,38,90,139
26097,097,26,2015,10814,-136,29,-107,85,155
26097,097,26,2016,10713,-60,40,-20,79,158
26097,097,26,2017,10758,55,31,86,96,138
26097,097,26,2018,10790,85,25,110,76,153
26097,097,26,2019,10807,51,17,68,99,150
26097,097,26,2020,10839,78,11,89,95,151
26099,099,26,2010,841350,-636,498,-138,2354,1872
26099,099,26,2011,844159,-692,2538,1846,9003,8017
26099,099,26,2012,849761,1672,2988,4660,9111,7981
26099,099,26,2013,857146,3897,2875,6772,9125,8467
26099,099,26,2014,862914,2026,2708,4734,9452,8249
26099,099,26,2015,865031,-692,2420,1728,9357,8863
26099,099,26,2016,868329,-220,2679,2459,9448,8564
26099,099,26,2017,870867,117,2048,2165,9337,8912
26099,099,26,2018,872089,-213,1107,894,9311,8957
26099,099,26,2019,872389,-704,487,-217,9192,8693
26099,099,26,2020,870791,-2016,422,-1594,9123,9161
26101,101,26,2010,24587,-157,5,-152,67,89
26101,101,26,2011,24776,289,12,301,175,289
26101,101,26,2012,24675,9,16,25,179,299
26101,101,26,2013,24484,-39,11,-28,183,342
26101,101,26,2014,24415,49,8,57,186,304
26101,101,26,2015,24462,171,8,179,178,309
26101,101,26,2016,24452,51,19,70,236,313
26101,101,26,2017,24406,61,14,75,223,342
26101,101,26,2018,24479,204,15,219,198,346
26101,101,26,2019,24619,220,26,246,199,303
26101,101,26,2020,24738,231,18,249,198,326
26103,103,26,2010,67080,26,4,30,157,170
26103,103,26,2011,67462,381,17,398,636,652
26103,103,26,2012,67840,239,44,283,688,590
26103,103,26,2013,67792,-106,53,-53,650,639
26103,103,26,2014,67798,5,59,64,625,667
26103,103,26,2015,67357,-433,57,-376,621,684
26103,103,26,2016,66563,-829,65,-764,644,679
26103,103,26,2017,66524,29,55,84,599,718
26103,103,26,2018,66406,-46,32,-14,582,684
26103,103,26,2019,66689,411,10,421,574,714
26103,103,26,2020,65834,-711,13,-698,571,727
26105,105,26,2010,28719,3,3,6,81,53
26105,105,26,2011,28649,-34,16,-18,301,353
26105,105,26,2012,28667,78,19,97,279,354
26105,105,26,2013,28680,50,13,63,282,327
26105,105,26,2014,28748,141,13,154,278,362
26105,105,26,2015,28754,32,6,38,319,347
26105,105,26,2016,28846,83,14,97,313,317
26105,105,26,2017,29025,215,14,229,265,314
26105,105,26,2018,29121,135,9,144,314,360
26105,105,26,2019,29154,118,6,124,255,344
26105,105,26,2020,29164,92,7,99,244,333
26107,107,26,2010,42851,14,13,27,114,81
26107,107,26,2011,43454,482,73,555,410,364
26107,107,26,2012,43502,-75,68,-7,430,370
26107,107,26,2013,43266,-376,80,-296,445,392
26107,107,26,2014,43206,-144,66,-78,418,392
26107,107,26,2015,43013,-246,28,-218,413,387
26107,107,26,2016,43174,45,41,86,442,365
26107,107,26,2017,43271,87,39,126,405,432
26107,107,26,2018,43471,187,36,223,398,420
26107,107,26,2019,43583,48,17,65,417,369
26107,107,26,2020,43907,282,14,296,413,384
26109,109,26,2010,23968,-29,0,-29,48,80
26109,109,26,2011,23870,-37,8,-29,186,253
26109,109,26,2012,23736,-65,17,-48,207,287
26109,109,26,2013,23734,66,3,69,188,256
26109,109,26,2014,23535,-135,-2,-137,215,279
26109,109,26,2015,23494,-6,2,-4,250,284
26109,109,26,2016,23217,-177,0,-177,193,294
26109,109,26,2017,23003,-129,-1,-130,185,267
26109,109,26,2018,22908,46,-1,45,171,309
26109,109,26,2019,22772,-79,-1,-80,208,262
26109,109,26,2020,22608,-99,2,-97,190,257
26111,111,26,2010,83660,-88,43,-45,220,136
26111,111,26,2011,83825,-161,156,-5,861,688
26111,111,26,2012,83743,-432,176,-256,865,691
26111,111,26,2013,83683,-338,190,-148,824,737
26111,111,26,2014,83534,-484,133,-351,863,663
26111,111,26,2015,83706,-151,125,-26,893,692
26111,111,26,2016,83485,-455,186,-269,820,773
26111,111,26,2017,83442,-289,152,-137,913,818
26111,111,26,2018,83447,-138,91,-47,846,791
26111,111,26,2019,83412,-213,49,-164,869,740
26111,111,26,2020,83441,-46,39,-7,836,803
26113,113,26,2010,14818,-18,3,-15,38,55
26113,113,26,2011,14904,65,17,82,164,160
26113,113,26,2012,15009,32,16,48,192,134
26113,113,26,2013,15059,16,11,27,180,155
26113,113,26,2014,14978,-94,9,-85,183,179
26113,113,26,2015,14884,-83,5,-78,162,178
26113,113,26,2016,15028,120,5,125,185,165
26113,113,26,2017,15020,-54,5,-49,195,153
26113,113,26,2018,15094,64,3,67,164,157
26113,113,26,2019,15079,-8,3,-5,165,174
26113,113,26,2020,15152,67,3,70,178,176
26115,115,26,2010,151936,-190,22,-168,427,357
26115,115,26,2011,151511,-807,72,-735,1595,1289
26115,115,26,2012,150835,-937,91,-846,1536,1386
26115,115,26,2013,150193,-836,85,-751,1527,1425
26115,115,26,2014,149919,-420,68,-352,1543,1454
26115,115,26,2015,149439,-582,25,-557,1501,1418
26115,115,26,2016,149278,-297,23,-274,1504,1388
26115,115,26,2017,149523,281,0,281,1465,1490
26115,115,26,2018,150218,695,-7,688,1548,1531
26115,115,26,2019,150412,299,-9,290,1485,1580
26115,115,26,2020,150568,334,-7,327,1440,1611
26117,117,26,2010,63315,-99,11,-88,214,152
26117,117,26,2011,63264,-240,36,-204,751,597
26117,117,26,2012,63100,-368,24,-344,718,541
26117,117,26,2013,62801,-396,10,-386,714,640
26117,117,26,2014,62814,-156,12,-144,738,573
26117,117,26,2015,62778,-134,8,-126,682,588
26117,117,26,2016,62988,93,10,103,727,615
26117,117,26,2017,63553,460,3,463,726,623
26117,117,26,2018,63854,256,0,256,697,652
26117,117,26,2019,63708,-188,-1,-189,679,635
26117,117,26,2020,63476,-275,-1,-276,711,670
26119,119,26,2010,9778,21,0,21,16,19
26119,119,26,2011,9625,-60,0,-60,60,153
26119,119,26,2012,9515,-29,0,-29,77,156
26119,119,26,2013,9381,-25,1,-24,56,164
26119,119,26,2014,9324,54,4,58,64,180
26119,119,26,2015,9292,37,2,39,62,134
26119,119,26,2016,9210,-3,4,1,75,156
26119,119,26,2017,9237,121,2,123,66,163
26119,119,26,2018,9260,132,0,132,64,174
26119,119,26,2019,9304,122,0,122,85,162
26119,119,26,2020,9337,132,1,133,82,181
26121,121,26,2010,171923,-475,19,-456,551,395
26121,121,26,2011,170056,-2456,76,-2380,2135,1637
26121,121,26,2012,170191,-422,93,-329,2143,1661
26121,121,26,2013,172312,1597,63,1660,2102,1671
26121,121,26,2014,172304,-496,82,-414,2065,1637
26121,121,26,2015,172506,-173,74,-99,2101,1778
26121,121,26,2016,173342,279,118,397,2116,1666
26121,121,26,2017,173804,20,108,128,2080,1737
26121,121,26,2018,173719,-411,84,-327,2112,1867
26121,121,26,2019,173645,-402,69,-333,2009,1755
26121,121,26,2020,173883,51,60,111,2027,1909
26123,123,26,2010,48373,-73,6,-67,120,138
26123,123,26,2011,48325,-155,14,-141,565,471
26123,123,26,2012,47886,-568,31,-537,552,463
26123,123,26,2013,47880,-88,20,-68,552,483
26123,123,26,2014,47798,-162,17,-145,533,467
26123,123,26,2015,47900,12,11,23,575,491
26123,123,26,2016,47812,-102,19,-83,522,524
26123,123,26,2017,48332,428,14,442,575,496
26123,123,26,2018,48914,566,12,578,538,533
26123,123,26,2019,49027,110,6,116,510,513
26123,123,26,2020,49348,392,9,401,499,576
26125,125,26,2010,1203125,-1407,1039,-368,3349,2258
26125,125,26,2011,1212718,919,5355,6274,13196,9840
26125,125,26,2012,1223723,2217,5547,7764,13330,9797
26125,125,26,2013,1235656,3249,5763,9012,13244,10185
26125,125,26,2014,1243076,-1920,6042,4122,13499,9974
26125,125,26,2015,1244895,-6727,5748,-979,13486,10642
26125,125,26,2016,1251563,-3989,7493,3504,13720,10517
26125,125,26,2017,1256478,-3513,5604,2091,13424,10562
26125,125,26,2018,1257472,-5030,3706,-1324,13170,10844
26125,125,26,2019,1257726,-4720,2702,-2018,13086,10844
26125,125,26,2020,1253459,-7641,2175,-5466,13035,11862
26127,127,26,2010,26503,-57,2,-55,84,97
26127,127,26,2011,26454,-168,18,-150,340,239
26127,127,26,2012,26302,-261,40,-221,310,246
26127,127,26,2013,26296,-117,33,-84,320,241
26127,127,26,2014,26346,0,37,37,272,253
26127,127,26,2015,26316,-60,29,-31,300,295
26127,127,26,2016,26327,-94,69,-25,325,287
26127,127,26,2017,26438,68,59,127,267,282
26127,127,26,2018,26577,89,55,144,268,274
26127,127,26,2019,26562,-85,66,-19,259,254
26127,127,26,2020,26819,218,52,270,268,280
26129,129,26,2010,21604,-36,3,-33,49,96
26129,129,26,2011,21488,-28,13,-15,184,284
26129,129,26,2012,21356,-58,12,-46,190,272
26129,129,26,2013,21160,-79,15,-64,198,327
26129,129,26,2014,20955,-93,15,-78,188,311
26129,129,26,2015,20876,40,12,52,188,315
26129,129,26,2016,20857,104,14,118,184,322
26129,129,26,2017,20887,163,10,173,192,333
26129,129,26,2018,20876,96,6,102,205,318
26129,129,26,2019,20933,216,5,221,177,341
26129,129,26,2020,20923,119,2,121,175,306
26131,131,26,2010,6776,-1,0,-1,13,14
26131,131,26,2011,6629,-85,2,-83,37,102
26131,131,26,2012,6414,-163,1,-162,22,80
26131,131,26,2013,6322,-44,3,-41,31,83
26131,131,26,2014,6192,-67,5,-62,33,101
26131,131,26,2015,6037,-73,1,-72,28,112
26131,131,26,2016,5935,-32,2,-30,29,99
26131,131,26,2017,5888,23,1,24,35,107
26131,131,26,2018,5816,2,1,3,28,101
26131,131,26,2019,5713,-12,1,-11,24,115
26131,131,26,2020,5656,39,0,39,23,118
26133,133,26,2010,23505,-10,0,-10,67,79
26133,133,26,2011,23474,-60,7,-53,285,261
26133,133,26,2012,23327,-205,7,-198,275,226
26133,133,26,2013,23324,-102,15,-87,292,207
26133,133,26,2014,23219,-122,15,-107,249,246
26133,133,26,2015,23180,-69,5,-64,255,226
26133,133,26,2016,23179,3,14,17,246,263
26133,133,26,2017,23267,77,3,80,269,259
26133,133,26,2018,23310,55,4,59,229,245
26133,133,26,2019,23394,54,5,59,270,247
26133,133,26,2020,23466,53,4,57,293,277
26135,135,26,2010,8601,0,0,0,13,50
26135,135,26,2011,8614,56,2,58,80,125
26135,135,26,2012,8574,-6,1,-5,89,123
26135,135,26,2013,8369,-164,2,-162,78,126
26135,135,26,2014,8311,-7,1,-6,79,130
26135,135,26,2015,8275,-22,1,-21,96,108
26135,135,26,2016,8238,3,1,4,85,127
26135,135,26,2017,8236,36,1,37,102,141
26135,135,26,2018,8249,82,1,83,81,151
26135,135,26,2019,8318,94,2,96,83,110
26135,135,26,2020,8368,74,1,75,93,117
26137,137,26,2010,24150,-7,4,-3,65,76
26137,137,26,2011,24115,-67,14,-53,267,249
26137,137,26,2012,24043,-116,19,-97,248,223
26137,137,26,2013,24082,62,18,80,230,269
26137,137,26,2014,24115,21,23,44,234,239
26137,137,26,2015,24209,88,1,89,267,259
26137,137,26,2016,24420,228,3,231,256,277
26137,137,26,2017,24540,159,2,161,240,278
26137,137,26,2018,24675,119,1,120,267,251
26137,137,26,2019,24664,55,0,55,232,298
26137,137,26,2020,24765,188,0,188,229,315
26139,139,26,2010,264114,-278,111,-167,912,425
26139,139,26,2011,266918,692,491,1183,3287,1657
26139,139,26,2012,270868,1604,695,2299,3316,1652
26139,139,26,2013,274394,1414,505,1919,3415,1785
26139,139,26,2014,277888,1497,502,1999,3363,1832
26139,139,26,2015,280907,1241,376,1617,3332,1903
26139,139,26,2016,283686,805,490,1295,3374,1874
26139,139,26,2017,286452,1148,251,1399,3312,1933
26139,139,26,2018,289578,1699,219,1918,3280,2062
26139,139,26,2019,291460,400,301,701,3199,2020
26139,139,26,2020,294635,1937,255,2192,3119,2141
26141,141,26,2010,13317,-18,0,-18,25,68
26141,141,26,2011,13151,-61,2,-59,96,202
26141,141,26,2012,13084,11,2,13,85,164
26141,141,26,2013,13011,31,4,35,92,199
26141,141,26,2014,12961,48,4,52,93,194
26141,141,26,2015,12800,-68,2,-66,102,195
26141,141,26,2016,12718,19,4,23,84,188
26141,141,26,2017,12740,139,3,142,107,228
26141,141,26,2018,12712,63,3,66,100,194
26141,141,26,2019,12602,5,6,11,78,197
26141,141,26,2020,12665,163,4,167,93,196
26143,143,26,2010,24441,46,6,52,58,120
26143,143,26,2011,24327,75,37,112,174,398
26143,143,26,2012,24184,49,28,77,182,403
26143,143,26,2013,24021,44,11,55,166,383
26143,143,26,2014,24023,217,4,221,148,377
26143,143,26,2015,23910,115,1,116,179,405
26143,143,26,2016,23782,119,7,126,162,417
26143,143,26,2017,23738,229,5,234,156,435
26143,143,26,2018,23822,318,6,324,161,403
26143,143,26,2019,23986,385,7,392,167,392
26143,143,26,2020,23986,244,5,249,159,406
26145,145,26,2010,199871,-393,47,-346,586,546
26145,145,26,2011,198929,-1374,195,-1179,2229,1994
26145,145,26,2012,198409,-1134,244,-890,2373,2002
26145,145,26,2013,196859,-2067,231,-1836,2302,2048
26145,145,26,2014,195317,-2108,240,-1868,2296,2000
26145,145,26,2015,193384,-2235,218,-2017,2165,2094
26145,145,26,2016,192636,-1142,245,-897,2290,2139
26145,145,26,2017,192002,-800,172,-628,2173,2177
26145,145,26,2018,190841,-1309,108,-1201,2243,2207
26145,145,26,2019,190484,-376,88,-288,2139,2208
26145,145,26,2020,189868,-548,71,-477,2132,2276
26147,147,26,2010,162688,-383,33,-350,404,431
26147,147,26,2011,161586,-1170,113,-1057,1625,1676
26147,147,26,2012,160637,-1105,139,-966,1626,1633
26147,147,26,2013,160312,-289,132,-157,1551,1702
26147,147,26,2014,160103,-118,81,-37,1574,1719
26147,147,26,2015,159757,-168,52,-116,1568,1783
26147,147,26,2016,159477,-137,97,-40,1569,1802
26147,147,26,2017,159130,-94,67,-27,1517,1831
26147,147,26,2018,159186,285,46,331,1497,1763
26147,147,26,2019,159339,320,43,363,1540,1747
26147,147,26,2020,159293,260,42,302,1529,1877
26149,149,26,2010,61288,-118,9,-109,215,123
26149,149,26,2011,61068,-486,46,-440,843,625
26149,149,26,2012,60987,-415,76,-339,840,586
26149,149,26,2013,60987,-203,40,-163,804,638
26149,149,26,2014,61014,-137,41,-96,810,677
26149,149,26,2015,60809,-393,15,-378,835,660
26149,149,26,2016,60761,-175,36,-139,748,654
26149,149,26,2017,60703,-137,7,-130,756,680
26149,149,26,2018,60808,12,14,26,742,660
26149,149,26,2019,60826,-155,27,-128,764,618
26149,149,26,2020,60848,-137,27,-110,755,625
26151,151,26,2010,43087,-70,0,-70,133,84
26151,151,26,2011,42704,-421,4,-417,469,436
26151,151,26,2012,42306,-406,8,-398,427,435
26151,151,26,2013,41902,-392,11,-381,440,468
26151,151,26,2014,41663,-215,9,-206,446,477
26151,151,26,2015,41463,-136,11,-125,414,485
26151,151,26,2016,41438,-30,22,-8,460,474
26151,151,26,2017,41257,-68,15,-53,432,558
26151,151,26,2018,41233,94,14,108,417,545
26151,151,26,2019,41220,21,26,47,401,460
26151,151,26,2020,40747,-349,18,-331,384,525
26153,153,26,2010,8472,1,1,2,18,31
26153,153,26,2011,8476,39,1,40,70,106
26153,153,26,2012,8348,-108,3,-105,81,107
26153,153,26,2013,8259,-54,1,-53,64,99
26153,153,26,2014,8132,-50,0,-50,64,141
26153,153,26,2015,8118,33,0,33,57,103
26153,153,26,2016,7952,-117,0,-117,50,99
26153,153,26,2017,8010,107,0,107,74,122
26153,153,26,2018,8007,51,0,51,68,121
26153,153,26,2019,8081,112,0,112,70,108
26153,153,26,2020,8104,74,0,74,70,120
26155,155,26,2010,70635,-75,7,-68,177,145
26155,155,26,2011,70006,-674,13,-661,690,661
26155,155,26,2012,69345,-716,11,-705,699,676
26155,155,26,2013,68927,-417,15,-402,713,732
26155,155,26,2014,68841,-76,12,-64,717,733
26155,155,26,2015,68538,-276,15,-261,707,748
26155,155,26,2016,68589,27,10,37,735,716
26155,155,26,2017,68422,-106,8,-98,670,737
26155,155,26,2018,68064,-304,4,-300,687,745
26155,155,26,2019,68065,47,2,49,712,760
26155,155,26,2020,67738,-206,3,-203,674,797
26157,157,26,2010,55697,-78,2,-76,154,104
26157,157,26,2011,55400,-275,17,-258,505,544
26157,157,26,2012,54705,-746,17,-729,531,517
26157,157,26,2013,54214,-506,14,-492,569,578
26157,157,26,2014,53921,-298,10,-288,550,557
26157,157,26,2015,53723,-196,6,-190,585,591
26157,157,26,2016,53260,-414,14,-400,534,597
26157,157,26,2017,52817,-386,9,-377,537,601
26157,157,26,2018,52692,-72,10,-62,570,632
26157,157,26,2019,52355,-227,11,-216,528,649
26157,157,26,2020,52289,101,9,110,533,708
26159,159,26,2010,76154,-182,12,-170,233,189
26159,159,26,2011,75941,-469,13,-456,940,698
26159,159,26,2012,75312,-999,100,-899,965,721
26159,159,26,2013,75335,-184,45,-139,886,720
26159,159,26,2014,75251,-373,58,-315,915,685
26159,159,26,2015,75087,-319,42,-277,886,769
26159,159,26,2016,75283,-8,81,73,867,740
26159,159,26,2017,75296,-9,12,3,857,842
26159,159,26,2018,75434,17,11,28,892,781
26159,159,26,2019,75594,83,30,113,832,782
26159,159,26,2020,75474,-57,37,-20,769,873
26161,161,26,2010,345980,-386,528,142,975,548
26161,161,26,2011,350072,120,2218,2338,3824,2064
26161,161,26,2012,352685,-1330,2264,934,3780,2077
26161,161,26,2013,356474,-38,2362,2324,3665,2140
26161,161,26,2014,360523,247,2291,2538,3748,2165
26161,161,26,2015,363555,-491,2094,1603,3651,2183
26161,161,26,2016,366960,-808,2630,1822,3770,2179
26161,161,26,2017,369703,-719,2113,1394,3588,2226
26161,161,26,2018,370548,-1670,1326,-344,3578,2398
26161,161,26,2019,368242,-4171,738,-3433,3545,2439
26161,161,26,2020,366473,-3206,619,-2587,3455,2644
26163,163,26,2010,1814847,-8068,881,-7187,5918,4546
26163,163,26,2011,1803003,-22100,4304,-17796,23815,17969
26163,163,26,2012,1795797,-17876,4642,-13234,23271,17485
26163,163,26,2013,1780131,-25958,4519,-21439,23375,18145
26163,163,26,2014,1771626,-19183,4431,-14752,23724,17751
26163,163,26,2015,1764866,-16159,4440,-11719,23288,18398
26163,163,26,2016,1760835,-15286,6013,-9273,23210,17986
26163,163,26,2017,1757874,-12450,4603,-7847,23156,18277
26163,163,26,2018,1755868,-10075,2963,-7112,23338,18239
26163,163,26,2019,1750093,-11944,1732,-10212,22762,18351
26163,163,26,2020,1740623,-13795,1461,-12334,22477,19638
26165,165,26,2010,32735,-4,0,-4,110,97
26165,165,26,2011,32637,-183,4,-179,443,361
26165,165,26,2012,32518,-154,7,-147,374,345
26165,165,26,2013,32477,-77,13,-64,391,363
26165,165,26,2014,32848,276,12,288,425,345
26165,165,26,2015,32885,-19,12,-7,423,373
26165,165,26,2016,33086,148,19,167,404,368
26165,165,26,2017,33229,98,11,109,360,324
26165,165,26,2018,33452,184,6,190,391,358
26165,165,26,2019,33654,170,0,170,381,349
26165,165,26,2020,33743,81,1,82,369,362
27001,001,27,2010,16212,30,0,30,30,41
27001,001,27,2011,16170,54,3,57,114,211
27001,001,27,2012,16038,-77,4,-73,139,196
27001,001,27,2013,15874,-60,0,-60,104,207
27001,001,27,2014,15852,89,3,92,98,210
27001,001,27,2015,15857,106,0,106,107,208
27001,001,27,2016,15755,21,3,24,104,229
27001,001,27,2017,15798,156,2,158,118,231
27001,001,27,2018,15886,188,1,189,133,234
27001,001,27,2019,15841,56,2,58,113,215
27001,001,27,2020,15848,141,1,142,114,248
27003,003,27,2010,331441,-156,142,-14,1084,461
27003,003,27,2011,332921,-1236,424,-812,4068,1779
27003,003,27,2012,336119,512,427,939,4065,1729
27003,003,27,2013,339120,467,387,854,4062,1866
27003,003,27,2014,341923,-117,545,428,4318,1890
27003,003,27,2015,344244,-258,521,263,4123,2037
27003,003,27,2016,346813,-407,628,221,4353,1995
27003,003,27,2017,350598,1429,441,1870,4216,2280
27003,003,27,2018,354004,1006,388,1394,4265,2235
27003,003,27,2019,357538,1185,365,1550,4228,2245
27003,003,27,2020,359921,268,309,577,4224,2430
27005,005,27,2010,32554,13,3,16,100,68
27005,005,27,2011,32766,123,12,135,437,359
27005,005,27,2012,32995,118,31,149,427,341
27005,005,27,2013,33189,71,33,104,420,324
27005,005,27,2014,33267,-64,47,-17,427,326
27005,005,27,2015,33455,91,45,136,395,340
27005,005,27,2016,33728,179,37,216,422,363
27005,005,27,2017,34089,248,24,272,439,349
27005,005,27,2018,34403,260,20,280,401,366
27005,005,27,2019,34461,-40,20,-20,410,332
27005,005,27,2020,34456,-24,20,-4,398,399
27007,007,27,2010,44572,10,11,21,182,68
27007,007,27,2011,45057,161,29,190,725,429
27007,007,27,2012,45160,-247,23,-224,707,379
27007,007,27,2013,45505,6,46,52,739,439
27007,007,27,2014,45655,-214,64,-150,691,387
27007,007,27,2015,45629,-288,61,-227,621,418
27007,007,27,2016,46054,63,51,114,703,387
27007,007,27,2017,46497,173,30,203,662,422
27007,007,27,2018,46723,-19,28,9,636,419
27007,007,27,2019,47205,182,26,208,671,396
27007,007,27,2020,47442,-18,19,1,660,426
27009,009,27,2010,38465,-43,1,-42,153,97
27009,009,27,2011,38738,-7,9,2,583,311
27009,009,27,2012,38678,-315,6,-309,565,321
27009,009,27,2013,38985,74,9,83,549,319
27009,009,27,2014,39147,-78,52,-26,541,349
27009,009,27,2015,39433,-83,79,-4,625,333
27009,009,27,2016,39698,-64,99,35,573,343
27009,009,27,2017,40219,243,101,344,558,379
27009,009,27,2018,40569,88,98,186,550,385
27009,009,27,2019,40938,128,77,205,544,381
27009,009,27,2020,40958,-215,64,-151,535,365
27011,011,27,2010,5273,0,0,0,15,9
27011,011,27,2011,5206,-37,0,-37,57,85
27011,011,27,2012,5134,-44,0,-44,60,88
27011,011,27,2013,5069,-50,4,-46,55,73
27011,011,27,2014,5086,33,2,35,55,73
27011,011,27,2015,4993,-74,2,-72,52,74
27011,011,27,2016,5003,25,0,25,58,71
27011,011,27,2017,5003,21,0,21,56,78
27011,011,27,2018,4973,-19,-1,-20,72,80
27011,011,27,2019,4967,-6,-1,-7,61,60
27011,011,27,2020,4923,-37,0,-37,67,73
27013,013,27,2010,64091,-57,25,-32,207,95
27013,013,27,2011,64364,-119,101,-18,766,475
27013,013,27,2012,64979,244,80,324,763,464
27013,013,27,2013,64749,-578,87,-491,725,477
27013,013,27,2014,65320,104,204,308,740,466
27013,013,27,2015,65701,-26,203,177,699,485
27013,013,27,2016,66398,235,174,409,767,479
27013,013,27,2017,66931,207,119,326,720,512
27013,013,27,2018,67397,188,109,297,696,526
27013,013,27,2019,67874,127,97,224,737,485
27013,013,27,2020,68241,41,94,135,724,497
27015,015,27,2010,25844,-22,1,-21,58,85
27015,015,27,2011,25660,-159,6,-153,251,282
27015,015,27,2012,25413,-270,4,-266,290,277
27015,015,27,2013,25267,-88,8,-80,255,321
27015,015,27,2014,25274,1,19,20,292,302
27015,015,27,2015,25246,5,19,24,262,311
27015,015,27,2016,25278,-4,10,6,296,268
27015,015,27,2017,25173,-95,6,-89,300,314
27015,015,27,2018,25118,-14,6,-8,242,289
27015,015,27,2019,24965,-139,5,-134,275,294
27015,015,27,2020,24846,-71,5,-66,257,309
27017,017,27,2010,35413,3,0,3,103,74
27017,017,27,2011,35436,5,7,12,365,351
27017,017,27,2012,35264,-219,5,-214,385,345
27017,017,27,2013,35265,33,3,36,362,392
27017,017,27,2014,35357,116,14,130,357,387
27017,017,27,2015,35400,60,19,79,360,393
27017,017,27,2016,35550,171,12,183,362,392
27017,017,27,2017,35498,-30,7,-23,362,388
27017,017,27,2018,35816,331,4,335,361,378
27017,017,27,2019,35913,77,2,79,372,355
27017,017,27,2020,35769,-124,5,-119,367,393
27019,019,27,2010,91332,107,23,130,313,124
27019,019,27,2011,92752,662,77,739,1106,424
27019,019,27,2012,93804,316,55,371,1097,402
27019,019,27,2013,95562,1041,67,1108,1131,486
27019,019,27,2014,97321,942,87,1029,1164,435
27019,019,27,2015,98610,495,93,588,1176,465
27019,019,27,2016,100389,966,100,1066,1216,498
27019,019,27,2017,102120,1059,58,1117,1170,549
27019,019,27,2018,103605,772,45,817,1174,500
27019,019,27,2019,105128,914,40,954,1159,586
27019,019,27,2020,106565,857,42,899,1154,618
27021,021,27,2010,28654,44,0,44,96,53
27021,021,27,2011,28383,-295,11,-284,295,282
27021,021,27,2012,28412,-46,7,-39,363,290
27021,021,27,2013,28488,68,9,77,320,318
27021,021,27,2014,28559,11,12,23,370,322
27021,021,27,2015,28704,113,18,131,359,345
27021,021,27,2016,29030,307,7,314,323,311
27021,021,27,2017,29324,343,3,346,292,343
27021,021,27,2018,29405,111,4,115,304,337
27021,021,27,2019,29622,236,2,238,271,292
27021,021,27,2020,29928,381,1,382,275,347
27023,023,27,2010,12439,8,3,11,39,46
27023,023,27,2011,12308,-170,16,-154,157,135
27023,023,27,2012,12112,-222,23,-199,153,154
27023,023,27,2013,12060,-62,20,-42,148,161
27023,023,27,2014,12041,-74,28,-46,173,144
27023,023,27,2015,12069,-17,37,20,162,154
27023,023,27,2016,12035,-93,25,-68,183,149
27023,023,27,2017,11948,-121,32,-89,150,149
27023,023,27,2018,11879,-83,36,-47,163,186
27023,023,27,2019,11756,-146,23,-123,151,150
27023,023,27,2020,11758,-22,18,-4,147,141
27025,025,27,2010,53905,-62,6,-56,136,68
27025,025,27,2011,53762,-354,21,-333,549,361
27025,025,27,2012,53468,-540,14,-526,572,350
27025,025,27,2013,53665,31,13,44,539,383
27025,025,27,2014,53808,15,16,31,522,403
27025,025,27,2015,54144,190,26,216,564,438
27025,025,27,2016,54640,262,36,298,582,379
27025,025,27,2017,55261,459,22,481,589,445
27025,025,27,2018,55980,567,22,589,563,431
27025,025,27,2019,56543,379,16,395,627,459
27025,025,27,2020,56794,93,19,112,593,456
27027,027,27,2010,59144,47,20,67,201,117
27027,027,27,2011,59937,382,75,457,793,459
27027,027,27,2012,60229,-132,62,-70,791,423
27027,027,27,2013,60567,-11,74,63,781,503
27027,027,27,2014,61297,180,156,336,846,443
27027,027,27,2015,62235,376,161,537,869,462
27027,027,27,2016,63090,290,188,478,852,471
27027,027,27,2017,63844,209,128,337,937,516
27027,027,27,2018,64079,-228,108,-120,851,497
27027,027,27,2019,64441,-236,111,-125,864,379
27027,027,27,2020,64690,-266,94,-172,839,420
27029,029,27,2010,8705,0,0,0,23,12
27029,029,27,2011,8723,-8,2,-6,121,96
27029,029,27,2012,8679,-43,0,-43,94,94
27029,029,27,2013,8784,92,6,98,111,105
27029,029,27,2014,8787,7,6,13,95,104
27029,029,27,2015,8794,5,6,11,115,118
27029,029,27,2016,8838,20,8,28,113,98
27029,029,27,2017,8842,-21,5,-16,116,96
27029,029,27,2018,8815,-26,4,-22,108,111
27029,029,27,2019,8843,-11,5,-6,104,71
27029,029,27,2020,9017,153,3,156,106,87
27031,031,27,2010,5161,-4,0,-4,6,16
27031,031,27,2011,5210,39,5,44,46,41
27031,031,27,2012,5181,-47,7,-40,50,39
27031,031,27,2013,5188,7,10,17,42,52
27031,031,27,2014,5246,45,23,68,38,50
27031,031,27,2015,5249,-41,35,-6,51,43
27031,031,27,2016,5346,54,31,85,58,45
27031,031,27,2017,5413,57,20,77,50,61
27031,031,27,2018,5413,-3,16,13,43,55
27031,031,27,2019,5416,-6,16,10,34,40
27031,031,27,2020,5417,3,11,14,37,49
27033,033,27,2010,11715,19,1,20,33,23
27033,033,27,2011,11716,-34,12,-22,161,137
27033,033,27,2012,11578,-158,0,-158,160,142
27033,033,27,2013,11558,-42,5,-37,147,129
27033,033,27,2014,11513,-84,11,-73,160,134
27033,033,27,2015,11431,-97,3,-94,153,141
27033,033,27,2016,11382,-73,2,-71,155,133
27033,033,27,2017,11263,-117,5,-112,129,137
27033,033,27,2018,11274,4,6,10,146,143
27033,033,27,2019,11232,-47,1,-46,138,133
27033,033,27,2020,11242,24,2,26,137,152
27035,035,27,2010,62608,46,9,55,206,159
27035,035,27,2011,62679,-98,20,-78,752,601
27035,035,27,2012,62813,20,42,62,728,642
27035,035,27,2013,63008,131,30,161,720,678
27035,035,27,2014,63121,20,30,50,701,622
27035,035,27,2015,63255,63,24,87,705,650
27035,035,27,2016,63757,406,24,430,707,631
27035,035,27,2017,64324,573,23,596,714,744
27035,035,27,2018,64957,662,23,685,666,715
27035,035,27,2019,65191,288,22,310,625,701
27035,035,27,2020,65644,541,18,559,639,743
27037,037,27,2010,399214,-407,188,-219,1322,482
27037,037,27,2011,401804,-811,545,-266,5126,2268
27037,037,27,2012,404669,-771,578,-193,5220,2134
27037,037,27,2013,407974,8,506,514,5155,2317
27037,037,27,2014,411821,122,809,931,5294,2326
27037,037,27,2015,414245,-1318,915,-403,5307,2469
27037,037,27,2016,417783,-246,908,662,5310,2422
27037,037,27,2017,421840,930,635,1565,5191,2674
27037,037,27,2018,425472,580,570,1150,5087,2589
27037,037,27,2019,429453,1019,472,1491,5252,2764
27037,037,27,2020,431807,-221,385,164,5167,2995
27039,039,27,2010,20157,22,3,25,73,25
27039,039,27,2011,20204,-109,17,-92,264,125
27039,039,27,2012,20273,-82,18,-64,263,133
27039,039,27,2013,20341,-49,20,-29,236,138
27039,039,27,2014,20390,-69,19,-50,239,142
27039,039,27,2015,20417,-90,13,-77,268,163
27039,039,27,2016,20558,11,8,19,267,143
27039,039,27,2017,20708,71,9,80,226,154
27039,039,27,2018,20804,4,9,13,246,162
27039,039,27,2019,20976,69,8,77,252,158
27039,039,27,2020,20987,-92,6,-86,256,159
27041,041,27,2010,35990,-19,4,-15,100,101
27041,041,27,2011,36185,177,15,192,383,380
27041,041,27,2012,36297,84,11,95,401,379
27041,041,27,2013,36350,55,12,67,406,412
27041,041,27,2014,36579,185,2,187,418,373
27041,041,27,2015,36796,188,3,191,424,395
27041,041,27,2016,37162,382,15,397,420,449
27041,041,27,2017,37547,391,13,404,417,436
27041,041,27,2018,37987,407,10,417,467,442
27041,041,27,2019,38070,99,11,110,405,431
27041,041,27,2020,38328,310,8,318,415,473
27043,043,27,2010,14479,-42,0,-42,26,59
27043,043,27,2011,14460,24,0,24,150,193
27043,043,27,2012,14174,-224,1,-223,136,202
27043,043,27,2013,14098,-27,2,-25,154,204
27043,043,27,2014,14102,25,0,25,151,172
27043,043,27,2015,13977,-85,-1,-86,150,189
27043,043,27,2016,13864,-93,1,-92,157,178
27043,043,27,2017,13767,-58,0,-58,151,190
27043,043,27,2018,13732,25,0,25,136,195
27043,043,27,2019,13671,-54,0,-54,156,164
27043,043,27,2020,13601,-53,0,-53,143,160
27045,045,27,2010,20864,-40,0,-40,63,29
27045,045,27,2011,20836,-43,10,-33,251,244
27045,045,27,2012,20833,-14,12,-2,243,243
27045,045,27,2013,20753,-111,20,-91,237,226
27045,045,27,2014,20769,-46,21,-25,278,236
27045,045,27,2015,20737,-63,35,-28,242,244
27045,045,27,2016,20912,127,28,155,259,238
27045,045,27,2017,20976,2,19,21,271,227
27045,045,27,2018,21053,36,23,59,260,241
27045,045,27,2019,21081,-15,16,1,254,226
27045,045,27,2020,21135,36,15,51,245,242
27047,047,27,2010,31203,-39,3,-36,94,107
27047,047,27,2011,31070,-145,14,-131,360,362
27047,047,27,2012,31026,-26,17,-9,328,359
27047,047,27,2013,30924,-169,11,-158,365,313
27047,047,27,2014,30742,-186,20,-166,346,359
27047,047,27,2015,30519,-167,44,-123,323,421
27047,047,27,2016,30441,-111,36,-75,339,340
27047,047,27,2017,30584,146,37,183,336,375
27047,047,27,2018,30552,-6,34,28,325,383
27047,047,27,2019,30385,-147,30,-117,299,349
27047,047,27,2020,30364,7,24,31,309,360
27049,049,27,2010,46225,-1,7,6,150,120
27049,049,27,2011,46122,-162,13,-149,542,495
27049,049,27,2012,46167,-68,9,-59,553,448
27049,049,27,2013,46135,-20,20,0,486,515
27049,049,27,2014,46046,-137,32,-105,499,481
27049,049,27,2015,46092,-11,29,18,501,467
27049,049,27,2016,46245,133,10,143,488,475
27049,049,27,2017,46341,20,10,30,519,449
27049,049,27,2018,46348,30,13,43,483,516
27049,049,27,2019,46391,10,6,16,539,512
27049,049,27,2020,46318,-59,2,-57,502,519
27051,051,27,2010,6002,-2,0,-2,17,30
27051,051,27,2011,5991,0,1,1,70,82
27051,051,27,2012,5925,-63,0,-63,56,59
27051,051,27,2013,5953,40,0,40,67,80
27051,051,27,2014,5920,-39,0,-39,79,73
27051,051,27,2015,5865,-70,0,-70,82,68
27051,051,27,2016,5921,67,2,69,65,76
27051,051,27,2017,5916,2,2,4,61,69
27051,051,27,2018,5971,65,3,68,57,70
27051,051,27,2019,5977,-11,2,-9,65,49
27051,051,27,2020,6026,44,2,46,58,56
27053,053,27,2010,1154323,-1548,1221,-327,4037,1839
27053,053,27,2011,1169581,2078,5074,7152,15917,7802
27053,053,27,2012,1184545,2095,4679,6774,16029,7739
27053,053,27,2013,1198531,1184,4631,5815,16499,8233
27053,053,27,2014,1211635,-1706,6400,4694,16714,8068
27053,053,27,2015,1222868,-3411,6550,3139,16755,8511
27053,053,27,2016,1236183,-1294,6455,5161,16789,8588
27053,053,27,2017,1248707,178,4382,4560,16594,8596
27053,053,27,2018,1258021,-1537,3857,2320,15882,8852
27053,053,27,2019,1265159,-3180,3626,446,15712,9024
27053,053,27,2020,1268408,-5547,2749,-2798,15616,9617
27055,055,27,2010,19027,-5,2,-3,38,26
27055,055,27,2011,18877,-146,2,-144,164,172
27055,055,27,2012,18766,-138,1,-137,200,175
27055,055,27,2013,18780,-29,6,-23,182,146
27055,055,27,2014,18707,-100,7,-93,195,174
27055,055,27,2015,18695,-18,12,-6,206,211
27055,055,27,2016,18740,2,17,19,204,178
27055,055,27,2017,18705,-83,9,-74,199,159
27055,055,27,2018,18608,-113,8,-105,215,206
27055,055,27,2019,18667,30,9,39,179,158
27055,055,27,2020,18632,-50,5,-45,182,172
27057,057,27,2010,20427,0,1,1,59,58
27057,057,27,2011,20516,26,11,37,231,178
27057,057,27,2012,20453,-81,8,-73,208,193
27057,057,27,2013,20694,208,10,218,209,188
27057,057,27,2014,20631,-85,12,-73,233,222
27057,057,27,2015,20645,10,11,21,210,215
27057,057,27,2016,20709,32,22,54,209,198
27057,057,27,2017,20989,270,15,285,214,221
27057,057,27,2018,21350,364,13,377,198,214
27057,057,27,2019,21604,235,15,250,220,215
27057,057,27,2020,21783,175,10,185,202,205
27059,059,27,2010,37856,6,2,8,124,82
27059,059,27,2011,38200,93,16,109,500,266
27059,059,27,2012,38150,-213,22,-191,447,308
27059,059,27,2013,38066,-267,19,-248,446,284
27059,059,27,2014,38273,84,30,114,424,323
27059,059,27,2015,38281,-162,22,-140,454,307
27059,059,27,2016,38763,323,21,344,439,300
27059,059,27,2017,39537,663,10,673,438,339
27059,059,27,2018,39846,175,8,183,444,316
27059,059,27,2019,40447,472,7,479,477,354
27059,059,27,2020,41429,868,8,876,466,357
27061,061,27,2010,45034,-29,3,-26,101,91
27061,061,27,2011,45103,103,7,110,473,511
27061,061,27,2012,45150,76,3,79,467,489
27061,061,27,2013,45334,282,1,283,457,557
27061,061,27,2014,45327,63,6,69,445,508
27061,061,27,2015,45269,11,13,24,509,586
27061,061,27,2016,45171,-51,16,-35,471,531
27061,061,27,2017,45096,4,11,15,442,528
27061,061,27,2018,45139,47,10,57,475,485
27061,061,27,2019,45225,182,11,193,431,538
27061,061,27,2020,45268,126,6,132,433,520
27063,063,27,2010,10272,3,0,3,23,20
27063,063,27,2011,10198,-40,0,-40,98,131
27063,063,27,2012,10311,112,-1,111,104,101
27063,063,27,2013,10284,-66,0,-66,131,95
27063,063,27,2014,10274,-6,2,-4,109,113
27063,063,27,2015,10098,-203,13,-190,122,110
27063,063,27,2016,9962,-151,10,-141,104,99
27063,063,27,2017,9968,4,8,12,108,113
27063,063,27,2018,9866,-129,6,-123,111,90
27063,063,27,2019,9799,-63,6,-57,94,105
27063,063,27,2020,9768,-21,6,-15,96,110
27065,065,27,2010,16217,-14,1,-13,38,51
27065,065,27,2011,16227,-5,5,0,158,146
27065,065,27,2012,15977,-239,2,-237,114,132
27065,065,27,2013,16015,12,2,14,166,142
27065,065,27,2014,15978,-57,14,-43,151,144
27065,065,27,2015,15895,-113,14,-99,177,159
27065,065,27,2016,15896,16,16,32,134,165
27065,065,27,2017,16069,139,5,144,187,158
27065,065,27,2018,16288,159,4,163,186,129
27065,065,27,2019,16357,53,4,57,160,148
27065,065,27,2020,16416,76,4,80,169,190
27067,067,27,2010,42231,-42,20,-22,135,116
27067,067,27,2011,42205,-313,96,-217,576,386
27067,067,27,2012,42380,-93,104,11,541,373
27067,067,27,2013,42463,-249,134,-115,593,395
27067,067,27,2014,42502,-416,230,-186,578,359
27067,067,27,2015,42638,-298,264,-34,595,424
27067,067,27,2016,42672,-414,233,-181,603,387
27067,067,27,2017,42747,-343,195,-148,598,374
27067,067,27,2018,42850,-270,185,-85,577,390
27067,067,27,2019,43137,-61,187,126,560,398
27067,067,27,2020,43130,-320,144,-176,556,387
27069,069,27,2010,4553,0,0,0,9,7
27069,069,27,2011,4540,-12,0,-12,53,53
27069,069,27,2012,4497,-13,0,-13,48,77
27069,069,27,2013,4498,23,0,23,43,64
27069,069,27,2014,4455,-28,2,-26,62,80
27069,069,27,2015,4410,-21,4,-17,46,75
27069,069,27,2016,4323,-63,4,-59,39,65
27069,069,27,2017,4261,-47,3,-44,39,57
27069,069,27,2018,4276,11,2,13,65,63
27069,069,27,2019,4286,20,3,23,44,57
27069,069,27,2020,4214,-61,1,-60,47,58
27071,071,27,2010,13320,18,1,19,29,46
27071,071,27,2011,13238,-48,4,-44,124,163
27071,071,27,2012,13166,-30,5,-25,104,151
27071,071,27,2013,13091,-30,5,-25,104,152
27071,071,27,2014,12849,-200,6,-194,106,156
27071,071,27,2015,12798,-32,7,-25,102,126
27071,071,27,2016,12607,-140,7,-133,98,157
27071,071,27,2017,12505,-46,4,-42,96,156
27071,071,27,2018,12404,-74,4,-70,112,141
27071,071,27,2019,12202,-146,2,-144,90,148
27071,071,27,2020,12059,-78,2,-76,95,161
27073,073,27,2010,7245,-19,0,-19,23,17
27073,073,27,2011,7221,0,2,2,73,100
27073,073,27,2012,7123,-63,2,-61,66,105
27073,073,27,2013,7006,-100,5,-95,62,86
27073,073,27,2014,6901,-87,4,-83,67,90
27073,073,27,2015,6876,-21,8,-13,60,72
27073,073,27,2016,6743,-116,8,-108,62,87
27073,073,27,2017,6682,-30,7,-23,54,92
27073,073,27,2018,6644,-26,5,-21,66,85
27073,073,27,2019,6628,-12,5,-7,69,76
27073,073,27,2020,6527,-78,4,-74,65,93
27075,075,27,2010,10854,8,1,9,36,51
27075,075,27,2011,10779,-47,0,-47,113,141
27075,075,27,2012,10792,12,6,18,117,120
27075,075,27,2013,10706,-47,7,-40,112,155
27075,075,27,2014,10602,-81,15,-66,100,140
27075,075,27,2015,10540,-29,7,-22,103,141
27075,075,27,2016,10501,-3,4,1,98,137
27075,075,27,2017,10481,25,2,27,103,150
27075,075,27,2018,10609,157,2,159,105,137
27075,075,27,2019,10625,65,1,66,95,143
27075,075,27,2020,10639,43,1,44,95,126
27077,077,27,2010,4035,2,0,2,3,17
27077,077,27,2011,4011,-12,5,-7,31,46
27077,077,27,2012,3947,-47,4,-43,35,56
27077,077,27,2013,3911,-32,4,-28,35,44
27077,077,27,2014,3891,-18,4,-14,36,42
27077,077,27,2015,3870,-2,0,-2,28,46
27077,077,27,2016,3791,-80,0,-80,45,45
27077,077,27,2017,3730,-55,0,-55,40,44
27077,077,27,2018,3722,9,0,9,30,48
27077,077,27,2019,3736,4,0,4,36,26
27077,077,27,2020,3754,18,0,18,37,36
27079,079,27,2010,27732,-40,0,-40,103,30
27079,079,27,2011,27786,-85,10,-75,321,193
27079,079,27,2012,27666,-250,6,-244,314,198
27079,079,27,2013,27710,-18,4,-14,299,236
27079,079,27,2014,27819,17,12,29,295,211
27079,079,27,2015,27762,-170,33,-137,318,238
27079,079,27,2016,27752,-94,25,-69,302,242
27079,079,27,2017,28193,300,20,320,350,227
27079,079,27,2018,28583,244,18,262,327,199
27079,079,27,2019,28856,206,18,224,318,268
27079,079,27,2020,28741,-183,15,-168,317,265
27081,081,27,2010,5885,2,0,2,20,32
27081,081,27,2011,5808,-42,0,-42,56,90
27081,081,27,2012,5755,-47,0,-47,67,71
27081,081,27,2013,5755,-10,0,-10,76,67
27081,081,27,2014,5764,19,0,19,68,77
27081,081,27,2015,5707,-33,0,-33,71,95
27081,081,27,2016,5702,-8,0,-8,76,71
27081,081,27,2017,5662,-19,0,-19,59,80
27081,081,27,2018,5654,-10,0,-10,80,77
27081,081,27,2019,5619,-27,0,-27,66,74
27081,081,27,2020,5568,-39,0,-39,70,82
27083,083,27,2010,25852,-43,10,-33,92,67
27083,083,27,2011,25834,-249,58,-191,379,206
27083,083,27,2012,25639,-398,55,-343,343,209
27083,083,27,2013,25727,-124,64,-60,360,212
27083,083,27,2014,25779,-205,106,-99,365,220
27083,083,27,2015,25830,-223,133,-90,376,238
27083,083,27,2016,25996,-157,167,10,376,221
27083,083,27,2017,25974,-295,119,-176,374,221
27083,083,27,2018,25656,-566,110,-456,362,229
27083,083,27,2019,25579,-328,106,-222,343,197
27083,083,27,2020,25271,-492,83,-409,340,236
27085,085,27,2010,36592,-65,1,-64,114,105
27085,085,27,2011,36345,-401,15,-386,432,295
27085,085,27,2012,35933,-508,11,-497,393,323
27085,085,27,2013,35896,-190,31,-159,460,340
27085,085,27,2014,35772,-210,26,-184,393,332
27085,085,27,2015,35808,-98,22,-76,424,308
27085,085,27,2016,35746,-124,6,-118,426,370
27085,085,27,2017,35860,46,0,46,415,345
27085,085,27,2018,35798,-78,0,-78,352,335
27085,085,27,2019,35826,-20,-1,-21,396,345
27085,085,27,2020,35710,-131,0,-131,390,376
27087,087,27,2010,5440,4,0,4,28,5
27087,087,27,2011,5473,-20,0,-20,121,68
27087,087,27,2012,5503,-14,0,-14,99,53
27087,087,27,2013,5468,-63,0,-63,101,73
27087,087,27,2014,5496,-1,1,0,95,66
27087,087,27,2015,5428,-114,1,-113,106,63
27087,087,27,2016,5472,11,1,12,96,63
27087,087,27,2017,5563,50,1,51,108,69
27087,087,27,2018,5492,-87,1,-86,91,76
27087,087,27,2019,5540,1,1,2,99,52
27087,087,27,2020,5473,-107,0,-107,95,53
27089,089,27,2010,9440,-19,0,-19,34,13
27089,089,27,2011,9458,8,1,9,94,84
27089,089,27,2012,9471,-29,1,-28,112,72
27089,089,27,2013,9429,-63,0,-63,105,81
27089,089,27,2014,9419,-51,1,-50,111,72
27089,089,27,2015,9410,-41,3,-38,116,87
27089,089,27,2016,9369,-81,2,-79,113,73
27089,089,27,2017,9359,-46,2,-44,115,81
27089,089,27,2018,9373,-15,2,-13,111,85
27089,089,27,2019,9345,-74,1,-73,108,63
27089,089,27,2020,9321,-41,2,-39,102,85
27091,091,27,2010,20805,-2,0,-2,47,81
27091,091,27,2011,20627,-148,-1,-149,220,250
27091,091,27,2012,20461,-146,0,-146,216,238
27091,091,27,2013,20424,-36,-2,-38,222,218
27091,091,27,2014,20247,-128,4,-124,222,275
27091,091,27,2015,20041,-151,6,-145,217,279
27091,091,27,2016,19920,-113,7,-106,240,254
27091,091,27,2017,19867,-44,-1,-45,236,244
27091,091,27,2018,19772,-86,-1,-87,233,241
27091,091,27,2019,19641,-129,-1,-130,243,244
27091,091,27,2020,19484,-169,1,-168,247,235
27093,093,27,2010,23333,-15,1,-14,78,32
27093,093,27,2011,23198,-219,10,-209,279,207
27093,093,27,2012,23041,-245,15,-230,286,215
27093,093,27,2013,23091,7,19,26,257,231
27093,093,27,2014,23129,-44,24,-20,285,225
27093,093,27,2015,23048,-133,24,-109,270,244
27093,093,27,2016,23081,-62,12,-50,297,211
27093,093,27,2017,23037,-67,8,-59,258,243
27093,093,27,2018,23122,61,8,69,264,245
27093,093,27,2019,23166,-24,8,-16,278,217
27093,093,27,2020,23341,124,4,128,280,233
27095,095,27,2010,26073,-26,1,-25,93,87
27095,095,27,2011,25842,-260,12,-248,295,279
27095,095,27,2012,25629,-283,3,-280,338,279
27095,095,27,2013,25651,-29,5,-24,343,294
27095,095,27,2014,25553,-130,9,-121,310,284
27095,095,27,2015,25482,-86,10,-76,309,301
27095,095,27,2016,25595,82,9,91,336,312
27095,095,27,2017,25845,226,5,231,331,311
27095,095,27,2018,26062,181,4,185,301,269
27095,095,27,2019,26166,98,5,103,308,308
27095,095,27,2020,26146,-15,4,-11,294,302
27097,097,27,2010,33244,-16,4,-12,105,44
27097,097,27,2011,33259,-102,17,-85,387,286
27097,097,27,2012,33101,-212,6,-206,369,320
27097,097,27,2013,32862,-256,7,-249,366,361
27097,097,27,2014,32811,-141,8,-133,391,306
27097,097,27,2015,32770,-105,8,-97,385,329
27097,097,27,2016,32907,62,3,65,405,330
27097,097,27,2017,33075,83,2,85,379,292
27097,097,27,2018,33098,-23,2,-21,362,317
27097,097,27,2019,33329,214,2,216,364,347
27097,097,27,2020,33187,-122,1,-121,363,382
27099,099,27,2010,39209,-30,11,-19,126,61
27099,099,27,2011,39349,-30,37,7,503,370
27099,099,27,2012,39397,-170,80,-90,527,383
27099,099,27,2013,39328,-218,77,-141,477,405
27099,099,27,2014,39415,-170,159,-11,476,374
27099,099,27,2015,39497,-318,242,-76,531,373
27099,099,27,2016,39555,-191,185,-6,490,423
27099,099,27,2017,39789,1,147,148,520,431
27099,099,27,2018,40122,84,137,221,527,411
27099,099,27,2019,40040,-360,125,-235,561,409
27099,099,27,2020,40150,-108,98,-10,535,416
27101,101,27,2010,8697,-23,0,-23,32,38
27101,101,27,2011,8631,-59,9,-50,70,86
27101,101,27,2012,8573,-38,11,-27,91,123
27101,101,27,2013,8509,-65,10,-55,89,100
27101,101,27,2014,8437,-58,9,-49,83,105
27101,101,27,2015,8395,-47,9,-38,84,88
27101,101,27,2016,8308,-90,7,-83,100,103
27101,101,27,2017,8329,38,4,42,83,104
27101,101,27,2018,8247,-70,4,-66,86,100
27101,101,27,2019,8197,-65,4,-61,88,77
27101,101,27,2020,8155,-42,4,-38,86,89
27103,103,27,2010,32758,-18,3,-15,95,49
27103,103,27,2011,32971,-4,0,-4,404,186
27103,103,27,2012,33030,-147,23,-124,382,200
27103,103,27,2013,32996,-212,42,-170,372,237
27103,103,27,2014,33392,163,70,233,386,222
27103,103,27,2015,33545,-74,56,-18,404,230
27103,103,27,2016,33766,-16,56,40,394,213
27103,103,27,2017,34081,125,44,169,369,220
27103,103,27,2018,34234,-5,41,36,381,263
27103,103,27,2019,34311,1,37,38,317,280
27103,103,27,2020,34482,94,33,127,339,296
27105,105,27,2010,21424,-74,45,-29,101,27
27105,105,27,2011,21617,-209,190,-19,374,164
27105,105,27,2012,21736,-237,189,-48,353,190
27105,105,27,2013,21799,-262,168,-94,347,193
27105,105,27,2014,21701,-455,193,-262,351,198
27105,105,27,2015,21754,-280,153,-127,363,186
27105,105,27,2016,21895,-253,138,-115,405,150
27105,105,27,2017,21659,-506,108,-398,345,185
27105,105,27,2018,21737,-223,99,-124,396,195
27105,105,27,2019,21645,-395,89,-306,385,169
27105,105,27,2020,21400,-513,64,-449,377,171
27107,107,27,2010,6832,6,0,6,16,34
27107,107,27,2011,6806,8,2,10,67,102
27107,107,27,2012,6602,-182,2,-180,65,96
27107,107,27,2013,6598,12,3,15,68,85
27107,107,27,2014,6583,-15,12,-3,83,93
27107,107,27,2015,6623,42,15,57,65,82
27107,107,27,2016,6539,-70,14,-56,76,105
27107,107,27,2017,6590,72,8,80,83,110
27107,107,27,2018,6477,-87,6,-81,81,114
27107,107,27,2019,6388,-93,5,-88,72,75
27107,107,27,2020,6338,-44,4,-40,75,85
27109,109,27,2010,144535,-228,158,-70,553,218
27109,109,27,2011,145849,-394,469,75,2185,944
27109,109,27,2012,146944,-528,479,-49,2092,925
27109,109,27,2013,148911,297,496,793,2156,967
27109,109,27,2014,150127,-666,696,30,2192,991
27109,109,27,2015,151492,-634,764,130,2230,989
27109,109,27,2016,153446,78,774,852,2161,1051
27109,109,27,2017,154883,-116,500,384,2103,1040
27109,109,27,2018,156413,182,450,632,2070,1168
27109,109,27,2019,158188,419,412,831,2042,1100
27109,109,27,2020,159298,-127,326,199,2049,1147
27111,111,27,2010,57291,-16,12,-4,166,165
27111,111,27,2011,57283,61,56,117,560,679
27111,111,27,2012,57227,-32,55,23,622,692
27111,111,27,2013,57503,238,60,298,631,648
27111,111,27,2014,57496,-44,60,16,672,683
27111,111,27,2015,57539,31,53,84,655,688
27111,111,27,2016,57840,243,39,282,714,690
27111,111,27,2017,58213,264,29,293,712,629
27111,111,27,2018,58602,454,25,479,621,708
27111,111,27,2019,58684,63,24,87,627,631
27111,111,27,2020,58741,109,20,129,615,686
27113,113,27,2010,13971,-4,4,0,54,15
27113,113,27,2011,14075,62,22,84,185,165
27113,113,27,2012,14130,0,16,16,183,140
27113,113,27,2013,14155,-39,21,-18,185,139
27113,113,27,2014,14129,-79,20,-59,170,135
27113,113,27,2015,14258,43,21,64,191,125
27113,113,27,2016,14242,-96,11,-85,196,126
27113,113,27,2017,14192,-81,7,-74,154,129
27113,113,27,2018,14175,-63,6,-57,178,139
27113,113,27,2019,14069,-133,5,-128,153,130
27113,113,27,2020,13874,-218,6,-212,152,133
27115,115,27,2010,29715,-12,2,-10,64,85
27115,115,27,2011,29621,-181,5,-176,331,249
27115,115,27,2012,29197,-490,4,-486,290,241
27115,115,27,2013,29077,-129,3,-126,269,261
27115,115,27,2014,29082,-26,3,-23,297,263
27115,115,27,2015,29051,-2,5,3,287,317
27115,115,27,2016,28873,-134,3,-131,263,308
27115,115,27,2017,29159,330,3,333,269,316
27115,115,27,2018,29449,299,3,302,249,262
27115,115,27,2019,29430,38,3,41,231,290
27115,115,27,2020,29359,16,2,18,230,320
27117,117,27,2010,9606,-12,0,-12,35,14
27117,117,27,2011,9528,-88,0,-88,117,106
27117,117,27,2012,9398,-141,5,-136,114,113
27117,117,27,2013,9306,-110,11,-99,116,111
27117,117,27,2014,9327,3,11,14,121,113
27117,117,27,2015,9302,-85,41,-44,122,103
27117,117,27,2016,9249,-73,36,-37,112,128
27117,117,27,2017,9168,-119,28,-91,130,120
27117,117,27,2018,9127,-70,25,-45,125,122
27117,117,27,2019,9152,-30,19,-11,143,107
27117,117,27,2020,9121,-69,13,-56,131,105
27119,119,27,2010,31639,12,7,19,86,62
27119,119,27,2011,31545,-162,42,-120,382,356
27119,119,27,2012,31524,-98,32,-66,408,360
27119,119,27,2013,31652,26,29,55,419,341
27119,119,27,2014,31511,-267,66,-201,398,342
27119,119,27,2015,31519,-127,65,-62,424,355
27119,119,27,2016,31692,30,47,77,424,325
27119,119,27,2017,31636,-166,32,-134,436,359
27119,119,27,2018,31364,-383,26,-357,438,353
27119,119,27,2019,31330,-173,26,-147,406,292
27119,119,27,2020,30900,-517,19,-498,394,325
27121,121,27,2010,10971,-21,0,-21,22,21
27121,121,27,2011,10906,-41,0,-41,129,151
27121,121,27,2012,10886,-27,0,-27,130,123
27121,121,27,2013,10876,-14,1,-13,131,128
27121,121,27,2014,10922,47,3,50,122,124
27121,121,27,2015,10930,7,6,13,128,131
27121,121,27,2016,10971,42,6,48,123,131
27121,121,27,2017,10985,7,5,12,118,115
27121,121,27,2018,11088,93,4,97,129,123
27121,121,27,2019,11216,136,3,139,118,128
27121,121,27,2020,11277,72,3,75,125,138
27123,123,27,2010,509364,-897,707,-190,1844,920
27123,123,27,2011,515856,-192,3143,2951,7475,3920
27123,123,27,2012,521091,-1342,2936,1594,7523,3806
27123,123,27,2013,527261,-159,2624,2465,7829,4032
27123,123,27,2014,532966,-1906,3654,1748,8010,3963
27123,123,27,2015,536838,-3141,3502,361,7794,4245
27123,123,27,2016,541635,-2291,3402,1111,7797,4090
27123,123,27,2017,544919,-2370,2175,-195,7723,4214
27123,123,27,2018,548900,-1033,1852,819,7696,4511
27123,123,27,2019,549632,-3987,1797,-2190,7276,4351
27123,123,27,2020,547903,-5835,1396,-4439,7283,4563
27125,125,27,2010,4078,-17,0,-17,16,12
27125,125,27,2011,4083,3,2,5,49,50
27125,125,27,2012,4058,-49,2,-47,60,38
27125,125,27,2013,4029,-37,0,-37,60,51
27125,125,27,2014,3993,-49,2,-47,45,36
27125,125,27,2015,4027,9,2,11,50,26
27125,125,27,2016,3983,-56,0,-56,46,34
27125,125,27,2017,4002,11,0,11,38,30
27125,125,27,2018,3961,-48,0,-48,45,38
27125,125,27,2019,4032,49,0,49,44,22
27125,125,27,2020,4046,-1,0,-1,45,29
27127,127,27,2010,16079,-4,0,-4,50,23
27127,127,27,2011,16028,-55,6,-49,189,190
27127,127,27,2012,15820,-209,7,-202,181,192
27127,127,27,2013,15687,-106,3,-103,180,210
27127,127,27,2014,15532,-183,4,-179,200,178
27127,127,27,2015,15427,-98,6,-92,182,195
27127,127,27,2016,15222,-214,8,-206,203,202
27127,127,27,2017,15250,14,5,19,195,185
27127,127,27,2018,15254,-16,5,-11,204,187
27127,127,27,2019,15158,-122,3,-119,183,159
27127,127,27,2020,15079,-110,4,-106,197,170
27129,129,27,2010,15685,-53,0,-53,52,43
27129,129,27,2011,15429,-247,11,-236,184,206
27129,129,27,2012,15283,-153,9,-144,197,202
27129,129,27,2013,15070,-222,13,-209,186,195
27129,129,27,2014,14933,-141,14,-127,156,171
27129,129,27,2015,14797,-131,17,-114,167,189
27129,129,27,2016,14598,-187,5,-182,176,192
27129,129,27,2017,14681,61,7,68,192,176
27129,129,27,2018,14629,-65,8,-57,184,177
27129,129,27,2019,14551,-71,6,-65,165,179
27129,129,27,2020,14403,-133,5,-128,168,188
27131,131,27,2010,64231,3,28,31,150,79
27131,131,27,2011,64458,-211,117,-94,761,440
27131,131,27,2012,64438,-369,98,-271,698,454
27131,131,27,2013,64645,-126,122,-4,739,524
27131,131,27,2014,65002,-108,217,109,707,455
27131,131,27,2015,65336,-123,260,137,698,499
27131,131,27,2016,65862,-35,241,206,770,447
27131,131,27,2017,66199,-62,200,138,764,565
27131,131,27,2018,66583,-26,189,163,733,511
27131,131,27,2019,67016,38,172,210,744,522
27131,131,27,2020,67084,-275,138,-137,731,528
27133,133,27,2010,9658,-13,0,-13,36,50
27133,133,27,2011,9601,-28,1,-27,104,136
27133,133,27,2012,9483,-108,0,-108,107,117
27133,133,27,2013,9430,-47,0,-47,110,117
27133,133,27,2014,9386,-41,-2,-43,124,124
27133,133,27,2015,9456,73,0,73,100,102
27133,133,27,2016,9405,-40,-1,-41,105,115
27133,133,27,2017,9481,73,-1,72,115,109
27133,133,27,2018,9411,-39,-1,-40,98,128
27133,133,27,2019,9334,-80,-1,-81,100,95
27133,133,27,2020,9301,-7,0,-7,89,115
27135,135,27,2010,15561,-97,1,-96,62,41
27135,135,27,2011,15517,-114,21,-93,196,148
27135,135,27,2012,15512,-61,16,-45,172,134
27135,135,27,2013,15497,-94,7,-87,202,131
27135,135,27,2014,15676,99,9,108,217,143
27135,135,27,2015,15619,-111,8,-103,183,137
27135,135,27,2016,15553,-121,9,-112,178,133
27135,135,27,2017,15302,-295,7,-288,183,148
27135,135,27,2018,15147,-179,7,-172,151,135
27135,135,27,2019,15176,-47,7,-40,183,113
27135,135,27,2020,15117,-93,5,-88,167,138
27137,137,27,2010,200143,-120,44,-76,494,485
27137,137,27,2011,200437,197,164,361,2058,2117
27137,137,27,2012,200397,-111,154,43,2046,2087
27137,137,27,2013,200503,-16,158,142,2081,2080
27137,137,27,2014,200720,49,188,237,2054,2037
27137,137,27,2015,200383,-509,206,-303,2062,2071
27137,137,27,2016,200023,-375,184,-191,1942,2102
27137,137,27,2017,199872,-124,96,-28,1971,2082
27137,137,27,2018,199850,92,78,170,1940,2124
27137,137,27,2019,199212,-481,74,-407,1857,2091
27137,137,27,2020,198538,-369,64,-305,1847,2225
27139,139,27,2010,130514,123,66,189,511,107
27139,139,27,2011,132581,482,228,710,1918,560
27139,139,27,2012,135140,946,206,1152,1953,548
27139,139,27,2013,137280,587,200,787,1936,571
27139,139,27,2014,139198,353,291,644,1888,584
27139,139,27,2015,141372,734,267,1001,1837,651
27139,139,27,2016,143393,547,284,831,1894,699
27139,139,27,2017,145581,927,163,1090,1818,712
27139,139,27,2018,147339,565,139,704,1743,684
27139,139,27,2019,149004,516,110,626,1754,719
27139,139,27,2020,150689,651,99,750,1704,776
27141,141,27,2010,88800,43,11,54,328,68
27141,141,27,2011,89279,-267,71,-196,1173,498
27141,141,27,2012,89474,-581,60,-521,1135,430
27141,141,27,2013,90086,-110,42,-68,1187,502
27141,141,27,2014,90908,80,82,162,1135,455
27141,141,27,2015,91441,-243,69,-174,1226,519
27141,141,27,2016,93247,1105,53,1158,1191,544
27141,141,27,2017,94527,555,37,592,1215,523
27141,141,27,2018,96067,861,31,892,1225,573
27141,141,27,2019,97424,670,27,697,1208,548
27141,141,27,2020,98811,766,27,793,1202,607
27143,143,27,2010,15257,-3,0,-3,47,21
27143,143,27,2011,15167,-121,4,-117,190,163
27143,143,27,2012,15082,-137,12,-125,179,140
27143,143,27,2013,15057,-76,29,-47,169,148
27143,143,27,2014,14933,-197,23,-174,178,130
27143,143,27,2015,14893,-63,19,-44,155,150
27143,143,27,2016,14832,-70,17,-53,160,169
27143,143,27,2017,14916,53,12,65,163,142
27143,143,27,2018,15024,70,11,81,169,141
27143,143,27,2019,14868,-186,11,-175,160,141
27143,143,27,2020,14715,-193,10,-183,168,137
27145,145,27,2010,150768,-194,53,-141,487,226
27145,145,27,2011,151372,-645,226,-419,1944,921
27145,145,27,2012,151919,-656,329,-327,1865,993
27145,145,27,2013,152612,-701,402,-299,1932,941
27145,145,27,2014,154025,-321,691,370,1999,937
27145,145,27,2015,156068,261,826,1087,2011,1036
27145,145,27,2016,157279,-627,896,269,1938,994
27145,145,27,2017,158512,-479,699,220,2048,1035
27145,145,27,2018,160034,-150,666,516,2078,1070
27145,145,27,2019,161076,-509,644,135,2040,1136
27145,145,27,2020,162038,-420,494,74,2024,1143
27147,147,27,2010,36497,-124,3,-121,123,91
27147,147,27,2011,36576,-178,28,-150,489,262
27147,147,27,2012,36324,-426,22,-404,443,302
27147,147,27,2013,36379,-136,14,-122,466,287
27147,147,27,2014,36505,-78,12,-66,497,301
27147,147,27,2015,36628,-61,2,-59,493,310
27147,147,27,2016,36671,-80,-1,-81,445,320
27147,147,27,2017,36814,35,-3,32,431,318
27147,147,27,2018,36783,-104,-4,-108,396,318
27147,147,27,2019,36687,-171,-3,-174,398,320
27147,147,27,2020,36596,-156,1,-155,396,332
27149,149,27,2010,9705,-17,5,-12,33,38
27149,149,27,2011,9707,-17,9,-8,103,94
27149,149,27,2012,9734,-33,9,-24,129,76
27149,149,27,2013,9753,-35,28,-7,115,87
27149,149,27,2014,9862,25,40,65,126,82
27149,149,27,2015,9886,-64,57,-7,121,91
27149,149,27,2016,9804,-152,49,-103,90,69
27149,149,27,2017,9710,-177,45,-132,121,85
27149,149,27,2018,9751,-46,48,2,117,78
27149,149,27,2019,9822,-5,27,22,134,83
27149,149,27,2020,9765,-115,27,-88,123,92
27151,151,27,2010,9759,-14,0,-14,25,38
27151,151,27,2011,9681,-79,4,-75,120,122
27151,151,27,2012,9637,-59,6,-53,111,102
27151,151,27,2013,9557,-91,12,-79,97,99
27151,151,27,2014,9490,-94,18,-76,112,102
27151,151,27,2015,9379,-111,14,-97,100,115
27151,151,27,2016,9462,62,12,74,119,110
27151,151,27,2017,9405,-64,21,-43,112,126
27151,151,27,2018,9319,-84,23,-61,107,133
27151,151,27,2019,9294,-60,17,-43,116,97
27151,151,27,2020,9176,-140,12,-128,113,103
27153,153,27,2010,24894,-42,1,-41,79,33
27153,153,27,2011,24882,-121,7,-114,306,204
27153,153,27,2012,24641,-395,3,-392,335,194
27153,153,27,2013,24476,-292,-2,-294,331,204
27153,153,27,2014,24339,-211,-2,-213,297,225
27153,153,27,2015,24318,-101,1,-100,318,239
27153,153,27,2016,24408,-36,19,-17,342,231
27153,153,27,2017,24539,-7,17,10,327,204
27153,153,27,2018,24613,-58,22,-36,310,200
27153,153,27,2019,24725,8,5,13,310,210
27153,153,27,2020,24732,-81,5,-76,308,225
27155,155,27,2010,3535,-12,0,-12,10,21
27155,155,27,2011,3490,-10,0,-10,30,66
27155,155,27,2012,3405,-61,0,-61,32,57
27155,155,27,2013,3403,17,1,18,30,50
27155,155,27,2014,3382,-2,1,-1,33,54
27155,155,27,2015,3376,10,4,14,34,52
27155,155,27,2016,3330,-35,5,-30,29,46
27155,155,27,2017,3308,-8,4,-4,38,56
27155,155,27,2018,3289,12,4,16,35,70
27155,155,27,2019,3260,-29,3,-26,37,42
27155,155,27,2020,3218,-45,3,-42,33,33
27157,157,27,2010,21672,-28,2,-26,61,28
27157,157,27,2011,21609,-144,12,-132,262,193
27157,157,27,2012,21542,-130,8,-122,219,164
27157,157,27,2013,21567,-21,7,-14,233,191
27157,157,27,2014,21464,-145,3,-142,230,192
27157,157,27,2015,21392,-97,6,-91,227,206
27157,157,27,2016,21445,-1,7,6,243,195
27157,157,27,2017,21595,87,7,94,233,175
27157,157,27,2018,21591,-50,8,-42,235,195
27157,157,27,2019,21548,-86,4,-82,235,197
27157,157,27,2020,21642,73,5,78,223,206
27159,159,27,2010,13816,-10,0,-10,47,64
27159,159,27,2011,13650,-152,2,-150,174,191
27159,159,27,2012,13606,-46,1,-45,178,173
27159,159,27,2013,13637,70,2,72,158,199
27159,159,27,2014,13587,-44,3,-41,184,191
27159,159,27,2015,13664,85,3,88,184,193
27159,159,27,2016,13552,-76,3,-73,181,220
27159,159,27,2017,13643,105,1,106,180,192
27159,159,27,2018,13739,117,1,118,205,226
27159,159,27,2019,13662,-45,0,-45,177,210
27159,159,27,2020,13807,149,1,150,178,183
27161,161,27,2010,19145,-25,2,-23,53,23
27161,161,27,2011,19186,-27,2,-25,229,164
27161,161,27,2012,19177,-54,6,-48,220,176
27161,161,27,2013,19040,-192,13,-179,212,172
27161,161,27,2014,18935,-164,1,-163,210,157
27161,161,27,2015,18932,-43,1,-42,206,166
27161,161,27,2016,18808,-168,-1,-169,230,186
27161,161,27,2017,18722,-107,-3,-110,192,170
27161,161,27,2018,18653,-89,-3,-92,207,183
27161,161,27,2019,18558,-119,-4,-123,203,174
27161,161,27,2020,18550,-46,0,-46,201,165
27163,163,27,2010,238933,294,108,402,768,336
27163,163,27,2011,241428,565,375,940,2879,1319
27163,163,27,2012,243720,658,292,950,2718,1337
27163,163,27,2013,246002,591,268,859,2860,1400
27163,163,27,2014,248580,817,368,1185,2900,1469
27163,163,27,2015,250482,300,277,577,2852,1512
27163,163,27,2016,252655,576,396,972,2790,1577
27163,163,27,2017,255717,1766,223,1989,2822,1724
27163,163,27,2018,258969,2021,184,2205,2738,1672
27163,163,27,2019,262541,2375,167,2542,2733,1694
27163,163,27,2020,265476,1959,155,2114,2729,1903
27165,165,27,2010,11195,-10,6,-4,28,40
27165,165,27,2011,11168,-88,25,-63,161,125
27165,165,27,2012,11114,-102,6,-96,153,112
27165,165,27,2013,11046,-96,20,-76,134,127
27165,165,27,2014,10978,-131,49,-82,136,124
27165,165,27,2015,11013,-91,80,-11,162,116
27165,165,27,2016,11002,-109,44,-65,169,114
27165,165,27,2017,10911,-151,33,-118,143,118
27165,165,27,2018,10964,-29,32,3,168,117
27165,165,27,2019,10846,-183,25,-158,166,125
27165,165,27,2020,10792,-128,22,-106,166,114
27167,167,27,2010,6591,0,0,0,20,6
27167,167,27,2011,6577,-1,-1,-2,71,82
27167,167,27,2012,6594,20,0,20,70,74
27167,167,27,2013,6499,-69,0,-69,56,82
27167,167,27,2014,6470,-19,-1,-20,78,86
27167,167,27,2015,6369,-99,0,-99,69,72
27167,167,27,2016,6337,-19,-1,-20,69,81
27167,167,27,2017,6342,-11,0,-11,87,71
27167,167,27,2018,6255,-68,0,-68,74,92
27167,167,27,2019,6223,-33,0,-33,70,69
27167,167,27,2020,6161,-53,0,-53,67,76
27169,169,27,2010,51432,-97,16,-81,118,69
27169,169,27,2011,51359,-170,61,-109,425,387
27169,169,27,2012,51353,-159,83,-76,471,395
27169,169,27,2013,51349,-190,71,-119,496,382
27169,169,27,2014,51085,-453,92,-361,499,413
27169,169,27,2015,50859,-333,83,-250,470,447
27169,169,27,2016,50912,-84,83,-1,484,428
27169,169,27,2017,50787,-212,59,-153,456,429
27169,169,27,2018,50877,-6,44,38,481,428
27169,169,27,2019,50659,-308,47,-261,460,419
27169,169,27,2020,50485,-211,34,-177,462,461
27171,171,27,2010,125093,77,12,89,500,185
27171,171,27,2011,126239,-93,63,-30,1881,702
27171,171,27,2012,127273,-221,80,-141,1831,637
27171,171,27,2013,128235,-229,77,-152,1831,707
27171,171,27,2014,129845,511,84,595,1776,738
27171,171,27,2015,131029,98,86,184,1754,740
27171,171,27,2016,132392,317,61,378,1792,800
27171,171,27,2017,134280,904,72,976,1745,826
27171,171,27,2018,136471,1164,89,1253,1761,819
27171,171,27,2019,138542,1202,35,1237,1721,882
27171,171,27,2020,140249,887,42,929,1731,956
27173,173,27,2010,10429,-6,0,-6,23,33
27173,173,27,2011,10293,-117,1,-116,101,120
27173,173,27,2012,10163,-129,0,-129,137,142
27173,173,27,2013,10089,-71,2,-69,117,121
27173,173,27,2014,9992,-98,3,-95,104,107
27173,173,27,2015,9847,-145,2,-143,115,118
27173,173,27,2016,9903,36,3,39,125,107
27173,173,27,2017,9848,-41,3,-38,112,129
27173,173,27,2018,9806,-52,3,-49,113,106
27173,173,27,2019,9736,-92,3,-89,105,84
27173,173,27,2020,9580,-157,2,-155,104,105
28001,001,28,2010,32581,223,10,233,79,66
28001,001,28,2011,32436,-182,47,-135,402,413
28001,001,28,2012,32208,-301,74,-227,396,399
28001,001,28,2013,32127,-16,74,58,312,445
28001,001,28,2014,32081,-219,202,-17,394,424
28001,001,28,2015,31574,-700,177,-523,409,403
28001,001,28,2016,31604,-103,131,28,389,386
28001,001,28,2017,31653,-573,667,94,366,412
28001,001,28,2018,31248,-510,194,-316,351,442
28001,001,28,2019,30736,-412,-23,-435,341,418
28001,001,28,2020,30275,-340,-8,-348,324,436
28003,003,28,2010,37109,21,0,21,108,78
28003,003,28,2011,37292,168,9,177,447,441
28003,003,28,2012,37224,-62,10,-52,441,448
28003,003,28,2013,37299,95,12,107,436,465
28003,003,28,2014,37276,-6,19,13,437,466
28003,003,28,2015,37302,36,14,50,456,474
28003,003,28,2016,37266,5,1,6,443,482
28003,003,28,2017,37216,-30,25,-5,424,468
28003,003,28,2018,36877,-316,18,-298,423,464
28003,003,28,2019,37043,206,8,214,416,465
28003,003,28,2020,36889,-66,2,-64,414,505
28005,005,28,2010,13137,-18,0,-18,31,11
28005,005,28,2011,13141,-4,-1,-5,143,132
28005,005,28,2012,12937,-216,-1,-217,146,141
28005,005,28,2013,12856,-56,0,-56,127,152
28005,005,28,2014,12605,-250,-1,-251,139,143
28005,005,28,2015,12553,-6,-1,-7,125,168
28005,005,28,2016,12442,-66,-2,-68,127,170
28005,005,28,2017,12450,54,-1,53,117,161
28005,005,28,2018,12322,-111,-1,-112,140,155
28005,005,28,2019,12286,8,-1,7,122,165
28005,005,28,2020,12205,-44,-1,-45,127,164
28007,007,28,2010,19483,-32,1,-31,54,101
28007,007,28,2011,19386,-113,2,-111,287,274
28007,007,28,2012,19148,-223,-4,-227,237,253
28007,007,28,2013,19116,-29,-1,-30,255,252
28007,007,28,2014,18829,-241,0,-241,244,293
28007,007,28,2015,18674,-105,0,-105,244,293
28007,007,28,2016,18556,-54,-2,-56,239,300
28007,007,28,2017,18478,-55,-1,-56,256,278
28007,007,28,2018,18330,-140,0,-140,248,254
28007,007,28,2019,18173,-134,0,-134,207,233
28007,007,28,2020,18004,-126,0,-126,230,271
28009,009,28,2010,8696,-17,0,-17,20,38
28009,009,28,2011,8720,21,-3,18,99,92
28009,009,28,2012,8651,-62,-4,-66,81,87
28009,009,28,2013,8503,-142,-3,-145,95,99
28009,009,28,2014,8305,-186,-1,-187,106,122
28009,009,28,2015,8164,-127,-2,-129,94,107
28009,009,28,2016,8246,106,-2,104,87,108
28009,009,28,2017,8267,31,-4,27,109,115
28009,009,28,2018,8234,-18,-4,-22,102,114
28009,009,28,2019,8278,38,-4,34,88,78
28009,009,28,2020,8351,94,-2,92,85,104
28011,011,28,2010,34104,-103,2,-101,124,74
28011,011,28,2011,33807,-483,-2,-485,589,404
28011,011,28,2012,34002,45,8,53,570,425
28011,011,28,2013,33986,-163,11,-152,544,404
28011,011,28,2014,33824,-225,20,-205,489,442
28011,011,28,2015,33233,-706,23,-683,482,396
28011,011,28,2016,32533,-780,7,-773,473,404
28011,011,28,2017,31722,-810,10,-800,417,431
28011,011,28,2018,31154,-622,16,-606,434,399
28011,011,28,2019,30714,-481,14,-467,426,398
28011,011,28,2020,30142,-558,9,-549,405,426
28013,013,28,2010,14965,-18,1,-17,46,19
28013,013,28,2011,14903,-52,1,-51,176,187
28013,013,28,2012,14828,-52,-3,-55,176,195
28013,013,28,2013,14707,-111,-1,-112,183,192
28013,013,28,2014,14695,-7,5,-2,171,179
28013,013,28,2015,14636,-48,12,-36,181,203
28013,013,28,2016,14552,-79,7,-72,173,185
28013,013,28,2017,14506,-67,30,-37,154,161
28013,013,28,2018,14420,-89,9,-80,165,171
28013,013,28,2019,14365,-71,-3,-74,183,164
28013,013,28,2020,14241,-103,0,-103,170,189
28015,015,28,2010,10606,-3,0,-3,16,7
28015,015,28,2011,10437,-170,0,-170,96,96
28015,015,28,2012,10403,1,-1,0,79,111
28015,015,28,2013,10326,-64,0,-64,100,113
28015,015,28,2014,10239,-64,0,-64,94,117
28015,015,28,2015,10209,2,-1,1,92,121
28015,015,28,2016,10199,11,-1,10,90,108
28015,015,28,2017,10100,-59,-1,-60,77,116
28015,015,28,2018,9902,-168,-1,-169,85,113
28015,015,28,2019,9928,23,-1,22,92,88
28015,015,28,2020,9732,-163,0,-163,88,120
28017,017,28,2010,17436,-13,0,-13,84,23
28017,017,28,2011,17497,-10,12,2,250,192
28017,017,28,2012,17497,-96,11,-85,240,153
28017,017,28,2013,17381,-210,17,-193,245,170
28017,017,28,2014,17399,-58,29,-29,236,187
28017,017,28,2015,17389,-109,13,-96,281,193
28017,017,28,2016,17208,-216,0,-216,239,207
28017,017,28,2017,17100,-136,0,-136,231,203
28017,017,28,2018,17013,-117,-2,-119,240,208
28017,017,28,2019,17026,-55,-3,-58,236,165
28017,017,28,2020,16951,-93,0,-93,228,209
28019,019,28,2010,8571,2,1,3,28,11
28019,019,28,2011,8449,-133,1,-132,95,85
28019,019,28,2012,8427,-30,0,-30,81,74
28019,019,28,2013,8460,20,2,22,96,85
28019,019,28,2014,8388,-64,3,-61,90,100
28019,019,28,2015,8372,-24,3,-21,97,91
28019,019,28,2016,8297,-51,0,-51,84,106
28019,019,28,2017,8242,-19,1,-18,78,116
28019,019,28,2018,8237,23,3,26,93,123
28019,019,28,2019,8192,-34,2,-32,77,89
28019,019,28,2020,8063,-88,1,-87,76,118
28021,021,28,2010,9579,-47,1,-46,35,9
28021,021,28,2011,9779,162,7,169,120,89
28021,021,28,2012,9352,-468,1,-467,109,90
28021,021,28,2013,9144,-236,11,-225,112,99
28021,021,28,2014,9169,-11,14,3,134,112
28021,021,28,2015,9211,30,12,42,111,111
28021,021,28,2016,9173,-60,2,-58,130,110
28021,021,28,2017,9033,-151,3,-148,102,95
28021,021,28,2018,9096,38,5,43,132,111
28021,021,28,2019,8998,-104,4,-100,110,107
28021,021,28,2020,8911,-95,4,-91,115,112
28023,023,28,2010,16723,-26,0,-26,46,21
28023,023,28,2011,16692,-10,3,-7,185,209
28023,023,28,2012,16526,-164,2,-162,195,200
28023,023,28,2013,16414,-91,2,-89,176,199
28023,023,28,2014,16273,-119,6,-113,184,213
28023,023,28,2015,16021,-224,2,-222,190,221
28023,023,28,2016,15897,-78,-3,-81,195,237
28023,023,28,2017,15798,-59,-3,-62,187,223
28023,023,28,2018,15558,-216,-3,-219,211,231
28023,023,28,2019,15506,-51,-3,-54,188,187
28023,023,28,2020,15299,-182,0,-182,189,212
28025,025,28,2010,20569,-60,1,-59,48,80
28025,025,28,2011,20504,-128,5,-123,258,200
28025,025,28,2012,20406,-97,0,-97,233,231
28025,025,28,2013,20365,-41,0,-41,228,228
28025,025,28,2014,20156,-158,4,-154,203,255
28025,025,28,2015,20019,-135,8,-127,229,238
28025,025,28,2016,19853,-146,3,-143,221,245
28025,025,28,2017,19633,-196,5,-191,222,253
28025,025,28,2018,19387,-248,7,-241,231,235
28025,025,28,2019,19349,-79,2,-77,239,200
28025,025,28,2020,19352,2,4,6,237,241
28027,027,28,2010,26111,-67,3,-64,116,95
28027,027,28,2011,25861,-410,11,-399,455,308
28027,027,28,2012,25628,-386,1,-385,429,284
28027,027,28,2013,25196,-566,3,-563,437,318
28027,027,28,2014,24860,-472,3,-469,431,305
28027,027,28,2015,24525,-457,-1,-458,417,298
28027,027,28,2016,23876,-769,-6,-775,421,298
28027,027,28,2017,23236,-741,-7,-748,369,265
28027,027,28,2018,22652,-644,-7,-651,380,316
28027,027,28,2019,22095,-568,-7,-575,331,311
28027,027,28,2020,21564,-541,-6,-547,329,310
28029,029,28,2010,29436,-61,2,-59,87,43
28029,029,28,2011,29280,-263,2,-261,421,318
28029,029,28,2012,29047,-307,7,-300,377,315
28029,029,28,2013,28941,-149,21,-128,371,345
28029,029,28,2014,28976,-48,39,-9,364,314
28029,029,28,2015,28868,-148,32,-116,341,333
28029,029,28,2016,28666,-259,13,-246,369,326
28029,029,28,2017,28536,-145,24,-121,355,363
28029,029,28,2018,28459,-144,25,-119,354,311
28029,029,28,2019,28099,-395,20,-375,344,328
28029,029,28,2020,27933,-188,13,-175,353,343
28031,031,28,2010,19578,19,0,19,73,85
28031,031,28,2011,19488,-103,-2,-105,258,242
28031,031,28,2012,19447,-70,7,-63,286,263
28031,031,28,2013,19214,-234,9,-225,275,286
28031,031,28,2014,19161,-59,3,-56,260,255
28031,031,28,2015,19253,87,5,92,265,262
28031,031,28,2016,19171,-54,0,-54,253,280
28031,031,28,2017,19016,-130,0,-130,253,279
28031,031,28,2018,18781,-228,0,-228,265,272
28031,031,28,2019,18562,-214,0,-214,234,240
28031,031,28,2020,18518,-29,0,-29,226,240
28033,033,28,2010,161797,234,23,257,491,219
28033,033,28,2011,164133,1280,131,1411,2023,1099
28033,033,28,2012,166521,1458,22,1480,2078,1175
28033,033,28,2013,168502,1095,46,1141,2106,1258
28033,033,28,2014,170923,1521,126,1647,2018,1247
28033,033,28,2015,173470,1556,150,1706,2126,1279
28033,033,28,2016,175950,1641,32,1673,2150,1340
28033,033,28,2017,179265,2357,220,2577,2157,1417
28033,033,28,2018,182406,2335,115,2450,2138,1444
28033,033,28,2019,185385,2321,1,2322,2146,1482
28033,033,28,2020,188275,2329,9,2338,2129,1568
28035,035,28,2010,74944,-74,29,-45,261,128
28035,035,28,2011,75796,247,140,387,1159,694
28035,035,28,2012,76433,177,139,316,1022,705
28035,035,28,2013,76614,-318,141,-177,1130,766
28035,035,28,2014,75861,-1272,162,-1110,1041,712
28035,035,28,2015,75642,-804,226,-578,1074,722
28035,035,28,2016,75593,-374,55,-319,1032,758
28035,035,28,2017,75190,-728,86,-642,1009,774
28035,035,28,2018,74983,-519,137,-382,1018,842
28035,035,28,2019,75035,-349,119,-230,1070,788
28035,035,28,2020,75009,-365,87,-278,1040,791
28037,037,28,2010,8105,6,0,6,21,36
28037,037,28,2011,7981,-128,0,-128,96,93
28037,037,28,2012,7898,-60,0,-60,84,107
28037,037,28,2013,7874,-21,0,-21,99,101
28037,037,28,2014,7775,-58,5,-53,71,118
28037,037,28,2015,7734,-15,6,-9,88,121
28037,037,28,2016,7723,-7,4,-3,85,92
28037,037,28,2017,7761,39,2,41,77,81
28037,037,28,2018,7746,-1,3,2,91,108
28037,037,28,2019,7694,-52,3,-49,87,91
28037,037,28,2020,7657,-36,2,-34,84,87
28039,039,28,2010,22653,61,2,63,92,89
28039,039,28,2011,22860,55,19,74,370,236
28039,039,28,2012,22918,-97,26,-71,361,229
28039,039,28,2013,23223,161,45,206,362,264
28039,039,28,2014,23332,-87,65,-22,375,242
28039,039,28,2015,23391,-40,31,-9,340,268
28039,039,28,2016,23651,132,21,153,375,267
28039,039,28,2017,23937,216,0,216,365,294
28039,039,28,2018,24040,27,5,32,360,288
28039,039,28,2019,24435,318,2,320,342,265
28039,039,28,2020,24425,-82,1,-81,351,282
28041,041,28,2010,14384,-24,0,-24,32,11
28041,041,28,2011,14319,-64,0,-64,133,133
28041,041,28,2012,14331,12,-1,11,125,124
28041,041,28,2013,14286,-61,0,-61,137,120
28041,041,28,2014,14337,56,0,56,118,121
28041,041,28,2015,13545,-805,6,-799,126,136
28041,041,28,2016,13547,32,4,36,109,145
28041,041,28,2017,13526,-18,7,-11,168,175
28041,041,28,2018,13975,431,8,439,132,127
28041,041,28,2019,13569,-432,5,-427,134,114
28041,041,28,2020,13477,-92,5,-87,125,130
28043,043,28,2010,21837,-26,0,-26,54,94
28043,043,28,2011,21609,-235,0,-235,262,256
28043,043,28,2012,21622,9,1,10,298,289
28043,043,28,2013,21542,-32,-2,-34,262,305
28043,043,28,2014,21611,90,-2,88,286,301
28043,043,28,2015,21461,-136,-1,-137,274,286
28043,043,28,2016,21225,-202,-5,-207,270,301
28043,043,28,2017,21051,-141,-5,-146,270,297
28043,043,28,2018,21016,18,-5,13,268,316
28043,043,28,2019,20732,-208,-5,-213,257,328
28043,043,28,2020,20610,-103,-2,-105,254,271
28045,045,28,2010,44102,58,23,81,121,135
28045,045,28,2011,44767,616,34,650,431,419
28045,045,28,2012,45296,391,45,436,479,391
28045,045,28,2013,45561,223,30,253,475,462
28045,045,28,2014,46029,393,42,435,515,484
28045,045,28,2015,46360,278,44,322,522,515
28045,045,28,2016,46708,382,0,382,477,512
28045,045,28,2017,47020,419,-19,400,446,533
28045,045,28,2018,47295,345,-33,312,473,510
28045,045,28,2019,47673,384,-19,365,475,462
28045,045,28,2020,48000,404,-14,390,473,536
28047,047,28,2010,187868,388,125,513,668,432
28047,047,28,2011,191130,1827,324,2151,2780,1675
28047,047,28,2012,193633,820,664,1484,2791,1747
28047,047,28,2013,196255,1382,408,1790,2742,1923
28047,047,28,2014,198502,910,446,1356,2830,1912
28047,047,28,2015,200880,1029,606,1635,2751,1995
28047,047,28,2016,202740,884,163,1047,2779,1963
28047,047,28,2017,205096,1443,116,1559,2788,1996
28047,047,28,2018,206351,765,34,799,2648,2189
28047,047,28,2019,207859,984,53,1037,2638,2170
28047,047,28,2020,208801,452,54,506,2624,2201
28049,049,28,2010,245717,-107,73,-34,821,403
28049,049,28,2011,248221,751,288,1039,3454,1996
28049,049,28,2012,248036,-1822,190,-1632,3443,2001
28049,049,28,2013,246313,-3268,250,-3018,3306,2092
28049,049,28,2014,245370,-2483,339,-2144,3381,2211
28049,049,28,2015,244321,-2628,365,-2263,3295,2100
28049,049,28,2016,242263,-3212,107,-3105,3206,2171
28049,049,28,2017,240007,-3294,104,-3190,3140,2216
28049,049,28,2018,235867,-5173,193,-4980,3073,2257
28049,049,28,2019,231919,-4910,148,-4762,3048,2225
28049,049,28,2020,227966,-4594,117,-4477,2889,2340
28051,051,28,2010,19406,-95,0,-95,82,69
28051,051,28,2011,19081,-412,-1,-413,304,218
28051,051,28,2012,18921,-252,0,-252,278,192
28051,051,28,2013,18801,-177,0,-177,257,199
28051,051,28,2014,18508,-345,0,-345,265,219
28051,051,28,2015,18362,-184,0,-184,274,238
28051,051,28,2016,18002,-383,0,-383,229,207
28051,051,28,2017,17846,-181,0,-181,255,230
28051,051,28,2018,17458,-401,0,-401,222,210
28051,051,28,2019,17036,-421,0,-421,221,222
28051,051,28,2020,16726,-269,0,-269,211,250
28053,053,28,2010,9333,-67,0,-67,36,14
28053,053,28,2011,9316,-66,2,-64,139,93
28053,053,28,2012,9213,-165,4,-161,136,79
28053,053,28,2013,8965,-289,5,-284,141,115
28053,053,28,2014,8794,-196,10,-186,110,100
28053,053,28,2015,8707,-113,7,-106,116,98
28053,053,28,2016,8569,-138,4,-134,81,86
28053,053,28,2017,8327,-262,1,-261,121,102
28053,053,28,2018,8212,-93,-1,-94,101,122
28053,053,28,2019,8056,-177,-2,-179,98,76
28053,053,28,2020,7827,-193,-2,-195,92,126
28055,055,28,2010,1386,-10,0,-10,6,10
28055,055,28,2011,1387,-3,0,-3,13,9
28055,055,28,2012,1395,4,0,4,12,10
28055,055,28,2013,1405,5,0,5,17,12
28055,055,28,2014,1386,-7,0,-7,8,18
28055,055,28,2015,1337,-51,0,-51,12,12
28055,055,28,2016,1321,-18,0,-18,9,7
28055,055,28,2017,1339,12,0,12,15,9
28055,055,28,2018,1302,-36,0,-36,14,15
28055,055,28,2019,1324,28,0,28,7,13
28055,055,28,2020,1220,-97,0,-97,10,16
28057,057,28,2010,23418,16,0,16,61,56
28057,057,28,2011,23271,-112,-2,-114,250,283
28057,057,28,2012,23301,-39,0,-39,311,237
28057,057,28,2013,23378,92,8,100,250,270
28057,057,28,2014,23401,18,10,28,264,268
28057,057,28,2015,23546,170,14,184,253,289
28057,057,28,2016,23426,-97,4,-93,268,297
28057,057,28,2017,23508,126,2,128,259,303
28057,057,28,2018,23434,-39,4,-35,260,299
28057,057,28,2019,23351,-73,4,-69,265,279
28057,057,28,2020,23261,-56,2,-54,261,299
28059,059,28,2010,139479,-311,72,-239,392,350
28059,059,28,2011,140058,-103,281,178,1664,1260
28059,059,28,2012,140000,-729,306,-423,1621,1262
28059,059,28,2013,140393,-44,240,196,1534,1315
28059,059,28,2014,141511,431,303,734,1630,1222
28059,059,28,2015,141443,-684,388,-296,1648,1415
28059,059,28,2016,141680,-355,225,-130,1701,1330
28059,059,28,2017,142355,105,316,421,1647,1385
28059,059,28,2018,143137,116,440,556,1610,1380
28059,059,28,2019,143387,122,30,152,1581,1484
28059,059,28,2020,143802,312,118,430,1562,1584
28061,061,28,2010,17013,-91,0,-91,56,22
28061,061,28,2011,16857,-187,-1,-188,216,186
28061,061,28,2012,16558,-324,-1,-325,232,216
28061,061,28,2013,16490,-111,0,-111,253,208
28061,061,28,2014,16531,36,-2,34,207,198
28061,061,28,2015,16549,9,-1,8,223,211
28061,061,28,2016,16587,14,-1,13,219,191
28061,061,28,2017,16570,-23,0,-23,206,198
28061,061,28,2018,16411,-148,0,-148,189,200
28061,061,28,2019,16368,-41,0,-41,184,186
28061,061,28,2020,16332,-20,0,-20,195,212
28063,063,28,2010,7723,-30,0,-30,21,5
28063,063,28,2011,7599,-143,0,-143,111,93
28063,063,28,2012,7683,35,0,35,116,67
28063,063,28,2013,7658,-73,0,-73,127,82
28063,063,28,2014,7584,-98,0,-98,103,80
28063,063,28,2015,7507,-93,0,-93,116,102
28063,063,28,2016,7302,-206,0,-206,89,89
28063,063,28,2017,7231,-81,1,-80,113,105
28063,063,28,2018,7092,-126,1,-125,76,89
28063,063,28,2019,7022,-85,0,-85,84,69
28063,063,28,2020,6997,-29,0,-29,81,78
28065,065,28,2010,12466,-31,0,-31,35,13
28065,065,28,2011,12163,-296,0,-296,146,156
28065,065,28,2012,12065,-79,0,-79,144,160
28065,065,28,2013,11945,-124,0,-124,164,159
28065,065,28,2014,11815,-112,0,-112,137,156
28065,065,28,2015,11633,-134,0,-134,111,160
28065,065,28,2016,11455,-167,0,-167,149,161
28065,065,28,2017,11285,-118,0,-118,111,163
28065,065,28,2018,11189,-60,0,-60,133,168
28065,065,28,2019,11089,-64,0,-64,120,154
28065,065,28,2020,10890,-148,0,-148,116,165
28067,067,28,2010,67819,27,0,27,216,195
28067,067,28,2011,67945,-204,5,-199,996,668
28067,067,28,2012,68442,228,-1,227,952,676
28067,067,28,2013,68982,241,4,245,1016,714
28067,067,28,2014,68428,-795,12,-783,951,729
28067,067,28,2015,68664,41,35,76,1018,851
28067,067,28,2016,68517,-405,15,-390,985,740
28067,067,28,2017,68422,-294,87,-207,876,760
28067,067,28,2018,68320,-252,23,-229,944,818
28067,067,28,2019,68282,-147,-20,-167,919,791
28067,067,28,2020,67993,-335,-11,-346,916,859
28069,069,28,2010,10454,3,0,3,20,9
28069,069,28,2011,10292,-150,-2,-152,94,105
28069,069,28,2012,10392,112,-1,111,88,103
28069,069,28,2013,10295,-88,0,-88,84,95
28069,069,28,2014,10222,-51,0,-51,86,105
28069,069,28,2015,10108,-95,0,-95,85,102
28069,069,28,2016,10041,-51,0,-51,89,104
28069,069,28,2017,10089,67,0,67,97,118
28069,069,28,2018,9714,-351,0,-351,84,110
28069,069,28,2019,9780,56,0,56,90,80
28069,069,28,2020,9521,-231,0,-231,85,111
28071,071,28,2010,47574,95,24,119,147,60
28071,071,28,2011,48428,556,122,678,508,336
28071,071,28,2012,50266,1539,29,1568,580,386
28071,071,28,2013,51624,1137,54,1191,543,419
28071,071,28,2014,52116,245,90,335,526,364
28071,071,28,2015,52841,445,91,536,572,387
28071,071,28,2016,53614,560,9,569,580,380
28071,071,28,2017,54318,497,35,532,554,385
28071,071,28,2018,53717,-784,45,-739,522,392
28071,071,28,2019,54239,344,26,370,523,371
28071,071,28,2020,54408,44,26,70,520,428
28073,073,28,2010,56109,299,5,304,171,117
28073,073,28,2011,57390,879,9,888,774,386
28073,073,28,2012,58167,353,8,361,813,401
28073,073,28,2013,59209,646,14,660,765,395
28073,073,28,2014,60211,598,27,625,763,394
28073,073,28,2015,61034,419,38,457,797,430
28073,073,28,2016,61461,64,7,71,817,457
28073,073,28,2017,61649,-210,36,-174,816,455
28073,073,28,2018,62744,684,67,751,788,444
28073,073,28,2019,63447,323,22,345,758,401
28073,073,28,2020,64165,398,27,425,750,457
28075,075,28,2010,80395,2,38,40,257,178
28075,075,28,2011,80663,21,73,94,1041,863
28075,075,28,2012,80280,-720,113,-607,1043,827
28075,075,28,2013,80276,-195,56,-139,1059,913
28075,075,28,2014,79330,-1168,41,-1127,1039,887
28075,075,28,2015,78422,-1140,69,-1071,1053,900
28075,075,28,2016,77497,-1134,13,-1121,1026,833
28075,075,28,2017,76416,-1131,3,-1128,901,856
28075,075,28,2018,75503,-1034,-10,-1044,1011,882
28075,075,28,2019,74619,-891,0,-891,882,875
28075,075,28,2020,73751,-846,7,-839,880,906
28077,077,28,2010,12928,-50,0,-50,43,19
28077,077,28,2011,12748,-215,0,-215,173,139
28077,077,28,2012,12690,-67,0,-67,162,152
28077,077,28,2013,12599,-62,0,-62,133,162
28077,077,28,2014,12625,-15,0,-15,176,135
28077,077,28,2015,12694,59,0,59,157,144
28077,077,28,2016,12813,104,0,104,162,148
28077,077,28,2017,12633,-178,1,-177,165,168
28077,077,28,2018,12441,-169,1,-168,158,183
28077,077,28,2019,12607,163,1,164,147,144
28077,077,28,2020,12480,-106,1,-105,139,159
28079,079,28,2010,23730,-39,-2,-41,62,88
28079,079,28,2011,23251,-556,-8,-564,330,249
28079,079,28,2012,23189,-116,-7,-123,295,231
28079,079,28,2013,23261,9,-4,5,297,233
28079,079,28,2014,23176,-123,-3,-126,309,263
28079,079,28,2015,22774,-500,0,-500,317,221
28079,079,28,2016,22780,-35,2,-33,289,249
28079,079,28,2017,22822,-10,-4,-14,298,241
28079,079,28,2018,22781,-95,-4,-99,324,265
28079,079,28,2019,22830,-42,-5,-47,308,212
28079,079,28,2020,22741,-118,-2,-120,320,290
28081,081,28,2010,82877,-46,6,-40,275,257
28081,081,28,2011,84032,803,23,826,1178,850
28081,081,28,2012,84802,405,14,419,1196,843
28081,081,28,2013,84981,-37,13,-24,1133,914
28081,081,28,2014,84781,-490,16,-474,1167,890
28081,081,28,2015,84762,-247,20,-227,1181,963
28081,081,28,2016,84859,-177,0,-177,1168,889
28081,081,28,2017,85124,-49,59,10,1193,935
28081,081,28,2018,85396,-25,114,89,1143,959
28081,081,28,2019,85674,-28,95,67,1089,880
28081,081,28,2020,85466,-315,77,-238,1076,1050
28083,083,28,2010,32420,-68,11,-57,141,47
28083,083,28,2011,32073,-617,63,-554,554,350
28083,083,28,2012,30806,-1429,15,-1414,469,391
28083,083,28,2013,30759,-146,10,-136,456,365
28083,083,28,2014,30721,-120,9,-111,441,365
28083,083,28,2015,30260,-621,-1,-622,538,383
28083,083,28,2016,29797,-566,-5,-571,480,373
28083,083,28,2017,29317,-562,-1,-563,455,373
28083,083,28,2018,28651,-730,2,-728,439,382
28083,083,28,2019,28202,-482,2,-480,408,377
28083,083,28,2020,27854,-373,2,-371,389,365
28085,085,28,2010,34896,-13,5,-8,104,66
28085,085,28,2011,34870,-73,16,-57,435,404
28085,085,28,2012,34848,-115,5,-110,488,395
28085,085,28,2013,34728,-181,7,-174,472,417
28085,085,28,2014,34737,-41,7,-34,469,419
28085,085,28,2015,34527,-203,7,-196,427,440
28085,085,28,2016,34385,-145,7,-138,417,419
28085,085,28,2017,34352,-66,27,-39,423,417
28085,085,28,2018,34202,-140,6,-134,416,430
28085,085,28,2019,34111,-70,-2,-72,402,422
28085,085,28,2020,33936,-126,-2,-128,393,440
28087,087,28,2010,59796,-50,32,-18,176,138
28087,087,28,2011,59626,-425,56,-369,789,591
28087,087,28,2012,59619,-400,149,-251,802,559
28087,087,28,2013,59826,-150,139,-11,795,567
28087,087,28,2014,59828,-339,129,-210,806,590
28087,087,28,2015,59725,-478,190,-288,792,607
28087,087,28,2016,59552,-392,49,-343,788,616
28087,087,28,2017,59173,-557,44,-513,807,675
28087,087,28,2018,58826,-565,57,-508,815,656
28087,087,28,2019,58621,-397,63,-334,775,646
28087,087,28,2020,58309,-473,45,-428,794,678
28089,089,28,2010,95546,200,58,258,276,210
28089,089,28,2011,96977,871,243,1114,1246,932
28089,089,28,2012,98092,649,142,791,1314,986
28089,089,28,2013,99531,1074,129,1203,1240,1021
28089,089,28,2014,100902,862,148,1010,1323,959
28089,089,28,2015,102516,1067,201,1268,1345,1006
28089,089,28,2016,103921,1005,46,1051,1312,958
28089,089,28,2017,104635,354,87,441,1276,998
28089,089,28,2018,105651,680,102,782,1315,1076
28089,089,28,2019,106334,290,66,356,1359,1033
28089,089,28,2020,106871,304,56,360,1343,1174
28091,091,28,2010,26987,-30,0,-30,70,127
28091,091,28,2011,26669,-337,-4,-341,367,344
28091,091,28,2012,26333,-338,-2,-340,337,338
28091,091,28,2013,26064,-212,-3,-215,317,372
28091,091,28,2014,25685,-398,0,-398,320,308
28091,091,28,2015,25430,-226,11,-215,303,343
28091,091,28,2016,25120,-249,5,-244,301,367
28091,091,28,2017,25123,1,9,10,311,317
28091,091,28,2018,24736,-389,3,-386,290,292
28091,091,28,2019,24504,-196,-2,-198,298,331
28091,091,28,2020,24441,18,0,18,292,373
28093,093,28,2010,37071,-53,2,-51,102,138
28093,093,28,2011,36771,-385,-6,-391,461,371
28093,093,28,2012,36567,-251,-2,-253,466,418
28093,093,28,2013,36478,-131,1,-130,449,405
28093,093,28,2014,36197,-313,2,-311,455,427
28093,093,28,2015,35918,-292,5,-287,438,430
28093,093,28,2016,35794,-130,-4,-134,392,380
28093,093,28,2017,35622,-151,10,-141,384,412
28093,093,28,2018,35491,-162,-2,-164,448,415
28093,093,28,2019,35302,-129,-7,-136,386,438
28093,093,28,2020,35301,82,-4,78,406,486
28095,095,28,2010,36913,-102,0,-102,104,62
28095,095,28,2011,36601,-300,-1,-301,406,418
28095,095,28,2012,36410,-216,1,-215,427,405
28095,095,28,2013,36154,-269,1,-268,443,430
28095,095,28,2014,36061,-108,-2,-110,445,423
28095,095,28,2015,35831,-214,-1,-215,412,427
28095,095,28,2016,35906,129,-1,128,408,457
28095,095,28,2017,35863,-1,-1,-2,405,446
28095,095,28,2018,35614,-228,-2,-230,422,441
28095,095,28,2019,35291,-246,-3,-249,380,454
28095,095,28,2020,35123,-89,-2,-91,385,463
28097,097,28,2010,10894,-4,0,-4,35,65
28097,097,28,2011,10771,-94,0,-94,115,144
28097,097,28,2012,10600,-136,0,-136,126,164
28097,097,28,2013,10575,-24,3,-21,147,149
28097,097,28,2014,10358,-204,6,-198,120,143
28097,097,28,2015,10190,-151,10,-141,124,152
28097,097,28,2016,10230,38,1,39,134,132
28097,097,28,2017,10138,-90,0,-90,130,133
28097,097,28,2018,9986,-155,1,-154,152,148
28097,097,28,2019,9766,-192,1,-191,107,136
28097,097,28,2020,9661,-77,0,-77,117,145
28099,099,28,2010,29696,-45,0,-45,111,63
28099,099,28,2011,29758,-51,0,-51,428,313
28099,099,28,2012,29747,-128,-1,-129,442,327
28099,099,28,2013,29539,-243,-3,-246,416,380
28099,099,28,2014,29470,-84,-2,-86,416,394
28099,099,28,2015,29491,-38,-2,-40,445,380
28099,099,28,2016,29474,-22,-3,-25,423,414
28099,099,28,2017,29446,-97,0,-97,464,395
28099,099,28,2018,29188,-295,2,-293,428,393
28099,099,28,2019,29147,-86,0,-86,439,395
28099,099,28,2020,28996,-180,1,-179,433,405
28101,101,28,2010,21661,-18,5,-13,59,98
28101,101,28,2011,21424,-336,19,-317,313,235
28101,101,28,2012,21499,0,15,15,295,230
28101,101,28,2013,21525,45,1,46,271,289
28101,101,28,2014,21714,178,3,181,301,296
28101,101,28,2015,21578,-129,3,-126,259,268
28101,101,28,2016,21504,-126,0,-126,321,268
28101,101,28,2017,21402,-86,-1,-87,271,286
28101,101,28,2018,21315,-121,0,-121,294,260
28101,101,28,2019,20987,-361,0,-361,271,237
28101,101,28,2020,20866,-89,-1,-90,259,290
28103,103,28,2010,11482,-45,0,-45,32,54
28103,103,28,2011,11295,-216,0,-216,142,113
28103,103,28,2012,11155,-197,6,-191,154,108
28103,103,28,2013,11059,-167,14,-153,170,116
28103,103,28,2014,11069,-59,16,-43,163,111
28103,103,28,2015,10948,-156,18,-138,148,131
28103,103,28,2016,10891,-88,0,-88,155,124
28103,103,28,2017,10717,-205,0,-205,168,137
28103,103,28,2018,10561,-226,4,-222,183,118
28103,103,28,2019,10425,-174,3,-171,150,114
28103,103,28,2020,10236,-203,1,-202,152,137
28105,105,28,2010,47725,-62,21,-41,145,33
28105,105,28,2011,47776,-345,127,-218,559,292
28105,105,28,2012,48853,668,94,762,565,286
28105,105,28,2013,49152,-79,106,27,565,285
28105,105,28,2014,49124,-440,121,-319,564,281
28105,105,28,2015,49589,54,170,224,554,311
28105,105,28,2016,49612,-237,49,-188,541,330
28105,105,28,2017,49774,-153,56,-97,598,337
28105,105,28,2018,49248,-909,136,-773,555,315
28105,105,28,2019,49543,4,99,103,525,333
28105,105,28,2020,49789,42,76,118,513,388
28107,107,28,2010,34643,-43,2,-41,118,132
28107,107,28,2011,34480,-288,-3,-291,508,382
28107,107,28,2012,34427,-177,-2,-179,517,389
28107,107,28,2013,34398,-175,0,-175,497,349
28107,107,28,2014,34453,-106,39,-67,540,412
28107,107,28,2015,34204,-365,49,-316,477,411
28107,107,28,2016,34238,-88,17,-71,493,386
28107,107,28,2017,34113,-248,19,-229,531,426
28107,107,28,2018,34092,-134,5,-129,488,379
28107,107,28,2019,34102,-65,-2,-67,484,406
28107,107,28,2020,33848,-280,-2,-282,485,456
28109,109,28,2010,55683,-46,2,-44,165,161
28109,109,28,2011,55441,-333,8,-325,662,578
28109,109,28,2012,55003,-563,2,-561,687,574
28109,109,28,2013,54848,-133,-2,-135,627,637
28109,109,28,2014,55149,275,-22,253,642,594
28109,109,28,2015,54978,-120,-20,-140,610,635
28109,109,28,2016,55110,177,-15,162,642,668
28109,109,28,2017,55329,257,-9,248,610,637
28109,109,28,2018,55492,283,-18,265,612,712
28109,109,28,2019,55752,376,-22,354,627,720
28109,109,28,2020,55876,233,-13,220,616,713
28111,111,28,2010,12235,4,0,4,35,55
28111,111,28,2011,12155,-95,0,-95,147,133
28111,111,28,2012,12003,-216,0,-216,166,107
28111,111,28,2013,12020,4,0,4,156,142
28111,111,28,2014,12064,50,0,50,146,151
28111,111,28,2015,12083,31,-1,30,127,136
28111,111,28,2016,12077,4,-1,3,137,147
28111,111,28,2017,12031,-51,-2,-53,131,123
28111,111,28,2018,11937,-91,-2,-93,134,134
28111,111,28,2019,11998,49,-2,47,136,123
28111,111,28,2020,11862,-139,0,-139,140,136
28113,113,28,2010,40442,-21,3,-18,144,83
28113,113,28,2011,40436,-99,5,-94,595,505
28113,113,28,2012,40091,-452,-1,-453,586,489
28113,113,28,2013,39944,-223,7,-216,532,461
28113,113,28,2014,39960,-70,27,-43,565,502
28113,113,28,2015,39907,-41,8,-33,503,519
28113,113,28,2016,39637,-280,3,-277,553,544
28113,113,28,2017,39535,-133,-2,-135,550,514
28113,113,28,2018,39371,-136,1,-135,536,565
28113,113,28,2019,39284,-116,-1,-117,537,506
28113,113,28,2020,38997,-255,-1,-256,521,553
28115,115,28,2010,30055,67,2,69,127,95
28115,115,28,2011,29782,-404,3,-401,401,276
28115,115,28,2012,30306,344,-6,338,431,251
28115,115,28,2013,30680,259,-12,247,421,295
28115,115,28,2014,30802,-8,2,-6,453,321
28115,115,28,2015,30884,-99,20,-79,447,285
28115,115,28,2016,31516,439,21,460,452,281
28115,115,28,2017,31776,26,115,141,452,330
28115,115,28,2018,31947,37,42,79,412,320
28115,115,28,2019,32280,148,4,152,461,281
28115,115,28,2020,32461,19,3,22,449,290
28117,117,28,2010,25232,-84,0,-84,84,52
28117,117,28,2011,25368,93,3,96,354,314
28117,117,28,2012,25366,-119,-4,-123,353,235
28117,117,28,2013,25480,121,0,121,316,322
28117,117,28,2014,25421,-70,2,-68,288,274
28117,117,28,2015,25457,42,3,45,308,315
28117,117,28,2016,25404,-56,5,-51,302,303
28117,117,28,2017,25224,-166,5,-161,300,318
28117,117,28,2018,25062,-153,9,-144,321,339
28117,117,28,2019,25074,28,0,28,282,298
28117,117,28,2020,25013,-63,3,-60,283,284
28119,119,28,2010,8152,-41,0,-41,18,43
28119,119,28,2011,8050,-90,6,-84,101,119
28119,119,28,2012,7796,-273,4,-269,116,109
28119,119,28,2013,7814,10,7,17,108,107
28119,119,28,2014,7689,-140,10,-130,88,87
28119,119,28,2015,7513,-203,3,-200,108,86
28119,119,28,2016,7361,-139,0,-139,87,100
28119,119,28,2017,7207,-158,0,-158,96,92
28119,119,28,2018,7053,-141,0,-141,82,95
28119,119,28,2019,6808,-235,0,-235,75,85
28119,119,28,2020,6760,-11,0,-11,70,107
28121,121,28,2010,142518,194,31,225,446,207
28121,121,28,2011,144209,649,103,752,1993,1053
28121,121,28,2012,145833,686,79,765,1946,1073
28121,121,28,2013,147361,619,56,675,1875,1022
28121,121,28,2014,148464,83,168,251,1905,1024
28121,121,28,2015,149507,135,209,344,1834,1114
28121,121,28,2016,152093,1881,24,1905,1831,1158
28121,121,28,2017,152902,120,63,183,1797,1164
28121,121,28,2018,154277,840,54,894,1731,1249
28121,121,28,2019,155342,552,20,572,1723,1232
28121,121,28,2020,155975,218,29,247,1715,1339
28123,123,28,2010,28342,-5,23,18,106,46
28123,123,28,2011,28386,-207,108,-99,454,312
28123,123,28,2012,28360,-299,57,-242,473,262
28123,123,28,2013,28336,-223,56,-167,423,280
28123,123,28,2014,28552,4,51,55,455,288
28123,123,28,2015,28445,-343,41,-302,462,269
28123,123,28,2016,28378,-279,25,-254,489,301
28123,123,28,2017,28452,-166,74,-92,466,300
28123,123,28,2018,28344,-326,62,-264,504,348
28123,123,28,2019,28203,-319,5,-314,454,280
28123,123,28,2020,28061,-280,16,-264,454,332
28125,125,28,2010,4886,-50,0,-50,19,3
28125,125,28,2011,4877,-14,1,-13,72,68
28125,125,28,2012,4788,-125,1,-124,89,58
28125,125,28,2013,4681,-99,1,-98,61,73
28125,125,28,2014,4615,-52,2,-50,64,81
28125,125,28,2015,4568,-52,1,-51,63,59
28125,125,28,2016,4513,-42,0,-42,48,60
28125,125,28,2017,4419,-102,1,-101,61,54
28125,125,28,2018,4342,-51,2,-49,59,87
28125,125,28,2019,4312,-65,2,-63,67,33
28125,125,28,2020,4160,-159,1,-158,57,50
28127,127,28,2010,27527,-19,2,-17,91,43
28127,127,28,2011,27407,-213,31,-182,362,301
28127,127,28,2012,27426,-46,12,-34,351,295
28127,127,28,2013,27534,91,8,99,314,303
28127,127,28,2014,27517,-81,13,-68,344,288
28127,127,28,2015,27177,-318,14,-304,291,328
28127,127,28,2016,27001,-169,0,-169,303,309
28127,127,28,2017,26917,-46,8,-38,277,321
28127,127,28,2018,26739,-196,13,-183,333,327
28127,127,28,2019,26803,5,12,17,333,286
28127,127,28,2020,26629,-183,10,-173,324,324
28129,129,28,2010,16494,-34,0,-34,58,15
28129,129,28,2011,16523,-42,-1,-43,217,144
28129,129,28,2012,16334,-204,0,-204,178,166
28129,129,28,2013,16226,-128,0,-128,191,172
28129,129,28,2014,16207,-29,0,-29,185,175
28129,129,28,2015,16073,-117,1,-116,182,198
28129,129,28,2016,15943,-138,1,-137,181,173
28129,129,28,2017,16067,100,1,101,189,166
28129,129,28,2018,15967,-133,1,-132,187,155
28129,129,28,2019,15840,-158,1,-157,202,173
28129,129,28,2020,15779,-51,0,-51,188,197
28131,131,28,2010,17907,83,0,83,54,25
28131,131,28,2011,17900,-47,6,-41,206,171
28131,131,28,2012,18051,136,9,145,208,207
28131,131,28,2013,17967,-128,12,-116,207,176
28131,131,28,2014,18100,87,4,91,210,172
28131,131,28,2015,18283,95,3,98,239,153
28131,131,28,2016,18189,-84,0,-84,211,219
28131,131,28,2017,18608,393,3,396,202,183
28131,131,28,2018,17966,-672,0,-672,223,199
28131,131,28,2019,18289,273,-1,272,215,165
28131,131,28,2020,18360,51,0,51,218,199
28133,133,28,2010,28983,-509,1,-508,91,38
28133,133,28,2011,28519,-509,2,-507,370,329
28133,133,28,2012,28415,-160,0,-160,355,294
28133,133,28,2013,27910,-537,5,-532,319,300
28133,133,28,2014,27408,-553,12,-541,332,306
28133,133,28,2015,26883,-591,7,-584,331,281
28133,133,28,2016,26519,-390,6,-384,321,301
28133,133,28,2017,26149,-326,6,-320,283,334
28133,133,28,2018,26254,108,10,118,295,309
28133,133,28,2019,25131,-1064,-1,-1065,274,333
28133,133,28,2020,24740,-341,2,-339,271,322
28135,135,28,2010,15337,-32,0,-32,44,61
28135,135,28,2011,15329,-42,-3,-45,176,138
28135,135,28,2012,15045,-282,-6,-288,155,160
28135,135,28,2013,14977,-37,-12,-49,142,159
28135,135,28,2014,14724,-270,-1,-271,163,152
28135,135,28,2015,14619,-110,0,-110,166,161
28135,135,28,2016,14383,-240,-5,-245,154,145
28135,135,28,2017,14155,-248,9,-239,167,159
28135,135,28,2018,14028,-139,5,-134,164,158
28135,135,28,2019,13931,-126,-4,-130,161,128
28135,135,28,2020,13707,-220,1,-219,155,157
28137,137,28,2010,28978,74,1,75,76,39
28137,137,28,2011,28734,-336,9,-327,369,288
28137,137,28,2012,28519,-319,0,-319,340,242
28137,137,28,2013,28341,-196,2,-194,311,294
28137,137,28,2014,28244,-169,14,-155,326,268
28137,137,28,2015,28465,188,13,201,327,308
28137,137,28,2016,28310,-201,-2,-203,344,296
28137,137,28,2017,28595,234,23,257,325,297
28137,137,28,2018,28345,-323,8,-315,369,306
28137,137,28,2019,28304,-85,-1,-86,344,298
28137,137,28,2020,28539,203,-2,201,352,318
28139,139,28,2010,22184,-28,5,-23,67,90
28139,139,28,2011,22038,-170,20,-150,265,262
28139,139,28,2012,21914,-131,7,-124,261,261
28139,139,28,2013,22000,79,-7,72,274,259
28139,139,28,2014,21976,-25,-6,-31,278,268
28139,139,28,2015,22025,29,7,36,280,265
28139,139,28,2016,22079,43,4,47,284,276
28139,139,28,2017,21963,-89,10,-79,255,291
28139,139,28,2018,22071,98,-2,96,293,280
28139,139,28,2019,22021,-32,-7,-39,239,249
28139,139,28,2020,21748,-256,-5,-261,250,261
28141,141,28,2010,19624,14,2,16,52,42
28141,141,28,2011,19634,81,3,84,190,261
28141,141,28,2012,19617,76,-3,73,210,300
28141,141,28,2013,19505,-20,3,-17,203,295
28141,141,28,2014,19429,19,14,33,188,293
28141,141,28,2015,19485,146,9,155,196,296
28141,141,28,2016,19455,53,5,58,213,298
28141,141,28,2017,19520,148,13,161,198,293
28141,141,28,2018,19360,-79,2,-77,213,295
28141,141,28,2019,19368,85,-3,82,199,275
28141,141,28,2020,19275,18,-2,16,190,300
28143,143,28,2010,10763,-71,14,-57,46,10
28143,143,28,2011,10589,-253,21,-232,189,131
28143,143,28,2012,10438,-270,4,-266,203,97
28143,143,28,2013,10454,-70,2,-68,201,115
28143,143,28,2014,10496,-72,4,-68,196,87
28143,143,28,2015,10264,-332,7,-325,190,100
28143,143,28,2016,10138,-199,3,-196,180,111
28143,143,28,2017,9989,-228,3,-225,176,99
28143,143,28,2018,9916,-151,6,-145,189,118
28143,143,28,2019,9602,-365,5,-360,159,113
28143,143,28,2020,9392,-266,4,-262,155,100
28145,145,28,2010,27141,2,2,4,81,73
28145,145,28,2011,27305,64,34,98,334,267
28145,145,28,2012,27339,-49,29,-20,347,288
28145,145,28,2013,27763,251,29,280,395,253
28145,145,28,2014,28152,226,56,282,390,285
28145,145,28,2015,28309,79,53,132,346,317
28145,145,28,2016,28298,-98,9,-89,385,306
28145,145,28,2017,28478,84,25,109,389,317
28145,145,28,2018,28536,-13,26,13,373,327
28145,145,28,2019,28711,92,19,111,342,276
28145,145,28,2020,28866,87,15,102,348,297
28147,147,28,2010,15395,-30,0,-30,50,66
28147,147,28,2011,15372,-53,5,-48,213,187
28147,147,28,2012,15069,-322,0,-322,173,163
28147,147,28,2013,14853,-216,-2,-218,170,172
28147,147,28,2014,14844,23,0,23,179,208
28147,147,28,2015,14604,-234,3,-231,179,189
28147,147,28,2016,14568,-12,-2,-14,174,194
28147,147,28,2017,14515,-53,0,-53,167,166
28147,147,28,2018,14420,-69,0,-69,184,210
28147,147,28,2019,14316,-100,0,-100,156,160
28147,147,28,2020,14294,7,1,8,160,190
28149,149,28,2010,48833,-21,6,-15,157,76
28149,149,28,2011,48325,-630,31,-599,623,535
28149,149,28,2012,48226,-276,32,-244,608,462
28149,149,28,2013,48301,-45,34,-11,620,524
28149,149,28,2014,47951,-486,25,-461,620,513
28149,149,28,2015,47496,-526,0,-526,639,572
28149,149,28,2016,47017,-565,9,-556,667,590
28149,149,28,2017,46717,-362,18,-344,579,536
28149,149,28,2018,46096,-700,43,-657,575,540
28149,149,28,2019,45477,-789,33,-756,598,460
28149,149,28,2020,44841,-681,26,-655,555,534
28151,151,28,2010,51098,-135,1,-134,188,95
28151,151,28,2011,50465,-876,2,-874,819,583
28151,151,28,2012,50035,-674,2,-672,836,604
28151,151,28,2013,49679,-576,19,-557,794,597
28151,151,28,2014,49032,-875,37,-838,785,612
28151,151,28,2015,47991,-1254,35,-1219,748,586
28151,151,28,2016,47214,-884,12,-872,677,584
28151,151,28,2017,46238,-1045,12,-1033,630,576
28151,151,28,2018,45097,-1194,18,-1176,644,614
28151,151,28,2019,43973,-1114,12,-1102,581,601
28151,151,28,2020,42837,-1044,13,-1031,573,671
28153,153,28,2010,20782,1,0,1,77,48
28153,153,28,2011,20629,-249,-3,-252,318,221
28153,153,28,2012,20628,-52,-3,-55,277,224
28153,153,28,2013,20476,-189,-4,-193,266,224
28153,153,28,2014,20473,-60,-4,-64,282,220
28153,153,28,2015,20515,-51,0,-51,312,216
28153,153,28,2016,20476,-90,0,-90,294,242
28153,153,28,2017,20450,-84,0,-84,271,213
28153,153,28,2018,20289,-179,0,-179,262,244
28153,153,28,2019,20186,-173,0,-173,276,207
28153,153,28,2020,20317,83,0,83,265,216
28155,155,28,2010,10267,17,0,17,35,49
28155,155,28,2011,10194,-75,0,-75,130,128
28155,155,28,2012,10090,-103,0,-103,124,126
28155,155,28,2013,9951,-95,0,-95,120,164
28155,155,28,2014,10000,51,0,51,136,138
28155,155,28,2015,9881,-72,-1,-73,92,137
28155,155,28,2016,9768,-92,-2,-94,121,140
28155,155,28,2017,9743,2,-2,0,120,144
28155,155,28,2018,9748,39,-2,37,123,155
28155,155,28,2019,9702,-56,-2,-58,123,110
28155,155,28,2020,9676,0,-1,-1,118,144
28157,157,28,2010,9863,-31,0,-31,28,13
28157,157,28,2011,9582,-291,0,-291,145,137
28157,157,28,2012,9460,-133,0,-133,102,96
28157,157,28,2013,9340,-128,0,-128,119,110
28157,157,28,2014,9185,-149,0,-149,107,115
28157,157,28,2015,9089,-80,0,-80,111,128
28157,157,28,2016,9032,-22,-1,-23,106,138
28157,157,28,2017,8855,-146,-1,-147,86,118
28157,157,28,2018,8768,-27,-1,-28,89,147
28157,157,28,2019,8628,-126,-1,-127,91,103
28157,157,28,2020,8351,-236,-1,-237,94,132
28159,159,28,2010,19202,-17,0,-17,45,27
28159,159,28,2011,19045,-144,-2,-146,218,229
28159,159,28,2012,18981,-40,0,-40,203,222
28159,159,28,2013,18764,-170,-2,-172,191,238
28159,159,28,2014,18610,-92,-1,-93,194,256
28159,159,28,2015,18452,-149,-1,-150,188,194
28159,159,28,2016,18357,-68,-1,-69,214,240
28159,159,28,2017,18232,-83,-3,-86,181,218
28159,159,28,2018,18154,-10,-2,-12,199,264
28159,159,28,2019,17993,-135,-2,-137,197,221
28159,159,28,2020,17845,-91,-1,-92,192,248
28161,161,28,2010,12626,-29,0,-29,31,55
28161,161,28,2011,12518,-106,0,-106,174,176
28161,161,28,2012,12391,-110,0,-110,140,157
28161,161,28,2013,12377,10,0,10,146,168
28161,161,28,2014,12304,-49,0,-49,145,166
28161,161,28,2015,12457,167,0,167,170,186
28161,161,28,2016,12469,10,-2,8,170,164
28161,161,28,2017,12449,20,-1,19,146,186
28161,161,28,2018,12376,-53,-1,-54,157,175
28161,161,28,2019,12104,-222,-1,-223,143,191
28161,161,28,2020,11982,-68,-1,-69,139,191
28163,163,28,2010,28135,14,2,16,86,35
28163,163,28,2011,28275,-31,19,-12,405,253
28163,163,28,2012,28336,-68,17,-51,381,266
28163,163,28,2013,28002,-403,12,-391,370,320
28163,163,28,2014,27810,-227,7,-220,344,319
28163,163,28,2015,27424,-455,32,-423,338,307
28163,163,28,2016,28003,498,60,558,323,308
28163,163,28,2017,28711,511,227,738,276,312
28163,163,28,2018,29163,305,105,410,347,310
28163,163,28,2019,29698,539,-16,523,317,307
28163,163,28,2020,26982,-2720,2,-2718,309,287
29001,001,29,2010,25638,-36,19,-17,68,29
29001,001,29,2011,25676,-102,101,-1,243,205
29001,001,29,2012,25696,-118,86,-32,275,220
29001,001,29,2013,25728,-45,72,27,242,234
29001,001,29,2014,25552,-270,60,-210,242,213
29001,001,29,2015,25396,-308,102,-206,276,229
29001,001,29,2016,25313,-250,120,-130,266,220
29001,001,29,2017,25522,21,139,160,265,215
29001,001,29,2018,25593,-85,114,29,282,241
29001,001,29,2019,25511,-276,122,-154,293,222
29001,001,29,2020,25399,-264,92,-172,288,229
29003,003,29,2010,17345,52,0,52,32,36
29003,003,29,2011,17199,-180,0,-180,174,140
29003,003,29,2012,17311,101,-1,100,185,171
29003,003,29,2013,17306,-2,-2,-4,172,171
29003,003,29,2014,17284,-52,-2,-54,200,167
29003,003,29,2015,17316,-1,-3,-4,204,167
29003,003,29,2016,17351,50,-4,46,190,200
29003,003,29,2017,17473,93,0,93,185,154
29003,003,29,2018,17661,162,-2,160,187,157
29003,003,29,2019,17699,-10,-1,-11,201,151
29003,003,29,2020,17586,-129,-1,-130,200,184
29005,005,29,2010,5656,-28,0,-28,11,13
29005,005,29,2011,5572,-53,0,-53,60,91
29005,005,29,2012,5512,-24,0,-24,46,83
29005,005,29,2013,5418,-89,4,-85,65,78
29005,005,29,2014,5354,-45,1,-44,46,66
29005,005,29,2015,5292,-31,1,-30,51,84
29005,005,29,2016,5292,1,1,2,65,67
29005,005,29,2017,5242,-20,2,-18,44,75
29005,005,29,2018,5161,-58,2,-56,46,72
29005,005,29,2019,5109,-24,2,-22,42,71
29005,005,29,2020,5096,25,2,27,44,84
29007,007,29,2010,25453,-68,1,-67,91,103
29007,007,29,2011,25535,-5,4,-1,362,278
29007,007,29,2012,25539,-45,6,-39,339,290
29007,007,29,2013,25565,-6,-1,-7,337,302
29007,007,29,2014,25841,211,1,212,345,277
29007,007,29,2015,25976,78,10,88,349,301
29007,007,29,2016,25863,-123,2,-121,326,317
29007,007,29,2017,25609,-308,3,-305,344,294
29007,007,29,2018,25411,-203,2,-201,336,336
29007,007,29,2019,24962,-462,0,-462,309,297
29007,007,29,2020,24835,-136,0,-136,306,297
29009,009,29,2010,35555,-18,6,-12,95,124
29009,009,29,2011,35348,-282,51,-231,422,398
29009,009,29,2012,35334,-94,40,-54,433,391
29009,009,29,2013,35335,-33,40,7,403,407
29009,009,29,2014,35327,-50,43,-7,403,395
29009,009,29,2015,35300,-37,35,-2,401,421
29009,009,29,2016,35204,-72,-15,-87,424,430
29009,009,29,2017,35576,348,-14,334,459,420
29009,009,29,2018,35687,189,-16,173,404,465
29009,009,29,2019,35789,139,-17,122,410,429
29009,009,29,2020,35818,53,-11,42,402,415
29011,011,29,2010,12384,-21,2,-19,25,19
29011,011,29,2011,12346,-62,8,-54,147,129
29011,011,29,2012,12299,-65,3,-62,150,138
29011,011,29,2013,12183,-119,7,-112,143,148
29011,011,29,2014,11990,-184,1,-183,147,160
29011,011,29,2015,11834,-141,0,-141,135,152
29011,011,29,2016,11834,14,-2,12,144,156
29011,011,29,2017,11798,-32,-2,-34,126,128
29011,011,29,2018,11756,-34,-2,-36,135,140
29011,011,29,2019,11681,-74,-2,-76,127,126
29011,011,29,2020,11592,-71,0,-71,127,146
29013,013,29,2010,17026,-4,1,-3,46,62
29013,013,29,2011,16965,-41,5,-36,196,222
29013,013,29,2012,16615,-352,3,-349,183,192
29013,013,29,2013,16425,-147,0,-147,183,228
29013,013,29,2014,16514,91,1,92,203,207
29013,013,29,2015,16361,-126,0,-126,186,212
29013,013,29,2016,16342,20,1,21,172,210
29013,013,29,2017,16294,-27,3,-24,200,224
29013,013,29,2018,16320,58,0,58,175,207
29013,013,29,2019,16213,-107,2,-105,184,185
29013,013,29,2020,16242,54,3,57,174,203
29015,015,29,2010,19109,43,1,44,46,53
29015,015,29,2011,19046,15,1,16,179,257
29015,015,29,2012,19006,108,2,110,129,280
29015,015,29,2013,18960,98,-1,97,141,282
29015,015,29,2014,18900,72,2,74,151,282
29015,015,29,2015,18815,52,1,53,171,309
29015,015,29,2016,18947,291,-1,290,152,310
29015,015,29,2017,19097,282,-1,281,177,309
29015,015,29,2018,19377,391,-1,390,189,299
29015,015,29,2019,19477,270,-1,269,160,328
29015,015,29,2020,19627,312,-1,311,170,330
29017,017,29,2010,12349,-24,0,-24,31,24
29017,017,29,2011,12382,26,0,26,144,136
29017,017,29,2012,12447,30,0,30,160,125
29017,017,29,2013,12487,44,0,44,120,124
29017,017,29,2014,12418,-60,0,-60,137,146
29017,017,29,2015,12320,-91,0,-91,134,141
29017,017,29,2016,12204,-114,0,-114,119,120
29017,017,29,2017,12281,118,1,119,110,151
29017,017,29,2018,12167,-99,1,-98,147,163
29017,017,29,2019,12142,-37,1,-36,137,126
29017,017,29,2020,12111,-31,1,-30,141,141
29019,019,29,2010,163208,197,155,352,494,295
29019,019,29,2011,166287,1097,850,1947,2066,942
29019,019,29,2012,168868,838,560,1398,2117,951
29019,019,29,2013,171060,551,545,1096,2176,1079
29019,019,29,2014,172920,-26,708,682,2190,988
29019,019,29,2015,174563,-28,760,732,2041,1114
29019,019,29,2016,176579,288,549,837,2129,950
29019,019,29,2017,178297,-27,765,738,2078,1095
29019,019,29,2018,179569,-201,584,383,2075,1189
29019,019,29,2019,181084,56,600,656,2045,1192
29019,019,29,2020,182991,589,489,1078,2059,1245
29021,021,29,2010,89071,-250,39,-211,313,233
29021,021,29,2011,89748,231,204,435,1215,972
29021,021,29,2012,89962,-232,205,-27,1239,981
29021,021,29,2013,89871,-411,193,-218,1138,1005
29021,021,29,2014,89649,-712,267,-445,1162,940
29021,021,29,2015,89137,-905,211,-694,1164,984
29021,021,29,2016,89072,-466,157,-309,1137,892
29021,021,29,2017,88658,-772,151,-621,1164,958
29021,021,29,2018,88047,-795,119,-676,1080,1015
29021,021,29,2019,87212,-1175,122,-1053,1098,879
29021,021,29,2020,86530,-872,99,-773,1045,951
29023,023,29,2010,42785,17,2,19,125,147
29023,023,29,2011,42996,235,0,235,543,566
29023,023,29,2012,43001,-51,3,-48,579,515
29023,023,29,2013,42979,-11,3,-8,582,588
29023,023,29,2014,42870,-118,-3,-121,580,560
29023,023,29,2015,42857,78,13,91,530,628
29023,023,29,2016,42804,-73,5,-68,555,539
29023,023,29,2017,42651,-145,5,-140,544,556
29023,023,29,2018,42641,82,-1,81,529,618
29023,023,29,2019,42574,-12,0,-12,504,560
29023,023,29,2020,42178,-322,2,-320,518,592
29025,025,29,2010,9428,0,0,0,23,12
29025,025,29,2011,9276,-147,1,-146,89,97
29025,025,29,2012,9085,-175,0,-175,90,112
29025,025,29,2013,9036,-33,2,-31,85,105
29025,025,29,2014,8992,-23,2,-21,88,111
29025,025,29,2015,8996,12,1,13,93,101
29025,025,29,2016,9043,36,2,38,112,102
29025,025,29,2017,9056,7,1,8,93,90
29025,025,29,2018,9073,40,1,41,99,122
29025,025,29,2019,9039,-38,1,-37,100,96
29025,025,29,2020,9051,15,1,16,100,104
29027,027,29,2010,44312,-20,8,-12,123,129
29027,027,29,2011,44311,-217,63,-154,498,346
29027,027,29,2012,44413,-56,40,-16,507,385
29027,027,29,2013,44546,-68,28,-40,526,350
29027,027,29,2014,44651,-94,8,-86,536,336
29027,027,29,2015,44722,-69,24,-45,516,396
29027,027,29,2016,45082,263,14,277,469,384
29027,027,29,2017,45002,-164,18,-146,473,406
29027,027,29,2018,44987,-70,13,-57,470,428
29027,027,29,2019,44762,-317,14,-303,509,431
29027,027,29,2020,44887,76,11,87,491,454
29029,029,29,2010,44096,44,5,49,98,80
29029,029,29,2011,43851,-274,26,-248,447,443
29029,029,29,2012,44232,411,32,443,398,469
29029,029,29,2013,44334,120,18,138,396,433
29029,029,29,2014,44601,326,14,340,411,494
29029,029,29,2015,44793,228,22,250,416,476
29029,029,29,2016,44979,273,7,280,410,504
29029,029,29,2017,45554,666,8,674,391,491
29029,029,29,2018,45956,514,9,523,385,506
29029,029,29,2019,46211,406,-8,398,370,510
29029,029,29,2020,46414,429,-1,428,360,582
29031,031,29,2010,75905,115,22,137,230,138
29031,031,29,2011,76627,458,151,609,901,787
29031,031,29,2012,77076,117,123,240,937,711
29031,031,29,2013,77495,150,103,253,924,745
29031,031,29,2014,77950,159,137,296,893,720
29031,031,29,2015,78297,38,196,234,909,790
29031,031,29,2016,78540,3,139,142,919,815
29031,031,29,2017,78338,-473,173,-300,915,819
29031,031,29,2018,78810,218,125,343,911,779
29031,031,29,2019,78971,-30,134,104,877,823
29031,031,29,2020,79512,354,115,469,879,811
29033,033,29,2010,9282,-8,3,-5,34,40
29033,033,29,2011,9252,-17,8,-9,103,123
29033,033,29,2012,9076,-183,3,-180,115,117
29033,033,29,2013,9054,3,1,4,117,142
29033,033,29,2014,8958,-103,3,-100,114,112
29033,033,29,2015,8882,-57,2,-55,94,113
29033,033,29,2016,8849,-16,2,-14,98,116
29033,033,29,2017,8789,-38,4,-34,82,108
29033,033,29,2018,8724,-38,3,-35,94,123
29033,033,29,2019,8698,-14,4,-10,86,103
29033,033,29,2020,8554,-115,2,-113,86,115
29035,035,29,2010,6292,27,0,27,20,23
29035,035,29,2011,6330,52,-1,51,73,85
29035,035,29,2012,6271,-42,-1,-43,66,82
29035,035,29,2013,6342,35,0,35,90,55
29035,035,29,2014,6286,-67,0,-67,79,69
29035,035,29,2015,6280,-14,0,-14,78,69
29035,035,29,2016,6210,-62,0,-62,80,87
29035,035,29,2017,6177,-24,0,-24,73,82
29035,035,29,2018,6068,-106,0,-106,76,79
29035,035,29,2019,5981,-74,0,-74,77,90
29035,035,29,2020,5991,32,0,32,72,92
29037,037,29,2010,99756,136,8,144,354,235
29037,037,29,2011,100017,-176,61,-115,1205,828
29037,037,29,2012,100458,86,35,121,1203,865
29037,037,29,2013,100712,-39,50,11,1202,944
29037,037,29,2014,100872,-128,25,-103,1173,904
29037,037,29,2015,101389,236,48,284,1156,910
29037,037,29,2016,102645,1025,0,1025,1153,919
29037,037,29,2017,103502,651,2,653,1172,961
29037,037,29,2018,104753,1067,-13,1054,1185,986
29037,037,29,2019,105731,869,-8,861,1146,1025
29037,037,29,2020,106806,1004,-4,1000,1155,1079
29039,039,29,2010,13969,20,0,20,36,68
29039,039,29,2011,13914,-11,0,-11,144,187
29039,039,29,2012,13910,6,0,6,177,185
29039,039,29,2013,13776,-110,1,-109,172,196
29039,039,29,2014,13788,42,0,42,174,203
29039,039,29,2015,13790,37,0,37,176,210
29039,039,29,2016,13884,123,0,123,188,216
29039,039,29,2017,14086,208,1,209,201,208
29039,039,29,2018,14126,82,1,83,173,215
29039,039,29,2019,14301,188,1,189,191,205
29039,039,29,2020,14322,50,1,51,194,224
29041,041,29,2010,7836,13,1,14,18,11
29041,041,29,2011,7744,-84,3,-81,81,93
29041,041,29,2012,7680,-50,2,-48,80,97
29041,041,29,2013,7640,-58,2,-56,90,75
29041,041,29,2014,7676,31,0,31,102,96
29041,041,29,2015,7582,-47,0,-47,74,121
29041,041,29,2016,7512,-78,0,-78,90,83
29041,041,29,2017,7462,-32,0,-32,90,107
29041,041,29,2018,7449,11,0,11,80,102
29041,041,29,2019,7463,-1,0,-1,95,81
29041,041,29,2020,7360,-89,0,-89,90,103
29043,043,29,2010,77841,258,4,262,257,110
29043,043,29,2011,78664,252,21,273,1069,517
29043,043,29,2012,79695,616,2,618,952,537
29043,043,29,2013,80675,561,6,567,990,579
29043,043,29,2014,81887,827,9,836,969,600
29043,043,29,2015,83154,835,26,861,1071,666
29043,043,29,2016,84271,660,21,681,1038,600
29043,043,29,2017,85533,834,75,909,1019,665
29043,043,29,2018,87248,1351,60,1411,1017,711
29043,043,29,2019,88913,1201,69,1270,1083,685
29043,043,29,2020,90655,1388,55,1443,1062,759
29045,045,29,2010,7139,2,0,2,16,12
29045,045,29,2011,7028,-104,1,-103,73,81
29045,045,29,2012,6968,-63,1,-62,85,86
29045,045,29,2013,6901,-51,0,-51,86,102
29045,045,29,2014,6889,-1,3,2,72,84
29045,045,29,2015,6811,-75,5,-70,86,96
29045,045,29,2016,6734,-65,1,-64,76,89
29045,045,29,2017,6719,-16,6,-10,69,73
29045,045,29,2018,6827,102,4,106,85,82
29045,045,29,2019,6804,-35,6,-29,68,63
29045,045,29,2020,6830,23,3,26,73,73
29047,047,29,2010,222649,253,88,341,782,381
29047,047,29,2011,225271,771,340,1111,3070,1556
29047,047,29,2012,227636,743,215,958,2993,1570
29047,047,29,2013,230401,1130,154,1284,3134,1640
29047,047,29,2014,233142,1142,205,1347,3040,1634
29047,047,29,2015,235344,670,252,922,3110,1811
29047,047,29,2016,238837,1993,138,2131,3057,1697
29047,047,29,2017,242780,2577,210,2787,2945,1802
29047,047,29,2018,246798,2559,117,2676,3176,1838
29047,047,29,2019,250522,2365,139,2504,3069,1850
29047,047,29,2020,253463,1687,130,1817,3118,2000
29049,049,29,2010,20740,-12,0,-12,43,31
29049,049,29,2011,20679,-42,-5,-47,243,257
29049,049,29,2012,20560,-81,-6,-87,223,258
29049,049,29,2013,20569,-3,-3,-6,234,218
29049,049,29,2014,20270,-228,-4,-232,210,280
29049,049,29,2015,20592,345,0,345,235,258
29049,049,29,2016,20535,-22,-2,-24,215,248
29049,049,29,2017,20558,37,-2,35,251,261
29049,049,29,2018,20435,-78,-2,-80,232,277
29049,049,29,2019,20434,-2,-2,-4,230,226
29049,049,29,2020,20553,135,-1,134,227,243
29051,051,29,2010,76145,48,18,66,234,117
29051,051,29,2011,76490,-44,66,22,939,615
29051,051,29,2012,76480,-397,86,-311,893,590
29051,051,29,2013,76732,-108,60,-48,969,656
29051,051,29,2014,76656,-439,84,-355,916,638
29051,051,29,2015,76838,-219,88,-131,957,638
29051,051,29,2016,76748,-430,84,-346,915,661
29051,051,29,2017,76702,-391,106,-285,863,624
29051,051,29,2018,76734,-214,81,-133,886,720
29051,051,29,2019,76774,-248,92,-156,885,691
29051,051,29,2020,76191,-756,73,-683,861,757
29053,053,29,2010,17601,-20,2,-18,45,29
29053,053,29,2011,17551,-67,5,-62,198,186
29053,053,29,2012,17538,-6,2,-4,198,202
29053,053,29,2013,17612,61,1,62,189,176
29053,053,29,2014,17564,-73,10,-63,209,190
29053,053,29,2015,17615,41,16,57,195,200
29053,053,29,2016,17697,100,12,112,178,207
29053,053,29,2017,17642,-47,4,-43,188,200
29053,053,29,2018,17604,-63,2,-61,214,192
29053,053,29,2019,17563,-67,2,-65,205,178
29053,053,29,2020,17102,-467,2,-465,204,198
29055,055,29,2010,24631,-55,0,-55,68,101
29055,055,29,2011,24817,164,0,164,287,266
29055,055,29,2012,24783,10,0,10,258,296
29055,055,29,2013,24530,-272,-4,-276,297,277
29055,055,29,2014,24633,78,-4,74,316,283
29055,055,29,2015,24510,-132,-3,-135,298,286
29055,055,29,2016,24269,-219,-3,-222,276,295
29055,055,29,2017,24109,-85,-2,-87,253,325
29055,055,29,2018,23948,-98,-4,-102,267,326
29055,055,29,2019,23856,-41,-2,-43,252,301
29055,055,29,2020,23739,-34,-4,-38,254,332
29057,057,29,2010,7839,-13,0,-13,15,42
29057,057,29,2011,7765,-40,0,-40,70,103
29057,057,29,2012,7556,-191,0,-191,70,95
29057,057,29,2013,7531,-3,1,-2,67,90
29057,057,29,2014,7597,98,3,101,57,95
29057,057,29,2015,7576,14,6,20,76,115
29057,057,29,2016,7598,65,3,68,64,111
29057,057,29,2017,7583,18,2,20,74,106
29057,057,29,2018,7560,9,2,11,66,100
29057,057,29,2019,7547,28,1,29,75,116
29057,057,29,2020,7568,65,2,67,70,115
29059,059,29,2010,16723,-32,0,-32,46,60
29059,059,29,2011,16689,-39,-1,-40,190,182
29059,059,29,2012,16703,-57,-2,-59,211,141
29059,059,29,2013,16468,-249,-4,-253,199,185
29059,059,29,2014,16349,-120,-2,-122,191,188
29059,059,29,2015,16362,10,3,13,200,199
29059,059,29,2016,16418,25,14,39,227,209
29059,059,29,2017,16755,302,25,327,220,210
29059,059,29,2018,16828,53,19,72,206,206
29059,059,29,2019,16984,102,20,122,232,196
29059,059,29,2020,17219,219,15,234,233,231
29061,061,29,2010,8444,8,0,8,23,10
29061,061,29,2011,8289,-182,1,-181,118,92
29061,061,29,2012,8294,-31,1,-30,115,78
29061,061,29,2013,8295,4,1,5,103,105
29061,061,29,2014,8317,-17,1,-16,124,86
29061,061,29,2015,8281,-69,5,-64,124,97
29061,061,29,2016,8227,-73,0,-73,117,99
29061,061,29,2017,8355,104,0,104,108,84
29061,061,29,2018,8330,-61,0,-61,123,88
29061,061,29,2019,8273,-109,0,-109,127,75
29061,061,29,2020,8283,-20,0,-20,124,93
29063,063,29,2010,12899,2,3,5,23,17
29063,063,29,2011,12817,-69,6,-63,116,134
29063,063,29,2012,12783,-27,1,-26,107,117
29063,063,29,2013,12638,-104,-3,-107,98,136
29063,063,29,2014,12556,-85,0,-85,116,114
29063,063,29,2015,12559,20,-5,15,106,117
29063,063,29,2016,12520,-39,-2,-41,123,121
29063,063,29,2017,12561,61,1,62,94,115
29063,063,29,2018,12534,14,1,15,107,147
29063,063,29,2019,10802,-1708,1,-1707,92,120
29063,063,29,2020,10944,145,1,146,92,95
29065,065,29,2010,15739,25,5,30,46,29
29065,065,29,2011,15620,-75,0,-75,160,205
29065,065,29,2012,15659,58,6,64,163,186
29065,065,29,2013,15745,89,6,95,182,189
29065,065,29,2014,15641,-120,10,-110,179,173
29065,065,29,2015,15662,40,9,49,196,221
29065,065,29,2016,15457,-206,9,-197,182,191
29065,065,29,2017,15510,68,11,79,178,204
29065,065,29,2018,15592,64,7,71,195,181
29065,065,29,2019,15548,5,9,14,142,200
29065,065,29,2020,15481,-6,6,0,161,229
29067,067,29,2010,13652,-47,0,-47,35,22
29067,067,29,2011,13636,-2,-1,-3,144,156
29067,067,29,2012,13582,-66,-3,-69,160,143
29067,067,29,2013,13449,-107,-3,-110,149,173
29067,067,29,2014,13533,122,0,122,135,173
29067,067,29,2015,13374,-165,-3,-168,164,157
29067,067,29,2016,13368,37,-4,33,147,185
29067,067,29,2017,13301,-46,-4,-50,155,171
29067,067,29,2018,13416,168,-4,164,153,201
29067,067,29,2019,13248,-130,-4,-134,148,182
29067,067,29,2020,13344,143,-2,141,134,179
29069,069,29,2010,31951,-39,3,-36,107,77
29069,069,29,2011,32018,4,-7,-3,503,432
29069,069,29,2012,31848,-148,-6,-154,437,454
29069,069,29,2013,31738,-140,10,-130,481,461
29069,069,29,2014,31320,-486,21,-465,443,407
29069,069,29,2015,30868,-470,54,-416,429,466
29069,069,29,2016,30622,-307,38,-269,443,420
29069,069,29,2017,30147,-437,46,-391,356,443
29069,069,29,2018,29464,-647,37,-610,413,487
29069,069,29,2019,29173,-289,39,-250,361,403
29069,069,29,2020,28878,-241,32,-209,365,452
29071,071,29,2010,101424,-64,3,-61,295,267
29071,071,29,2011,101618,-59,11,-48,1252,1008
29071,071,29,2012,101331,-630,5,-625,1265,930
29071,071,29,2013,101717,61,6,67,1268,936
29071,071,29,2014,101923,-19,9,-10,1213,976
29071,071,29,2015,102265,80,30,110,1228,982
29071,071,29,2016,102758,269,12,281,1282,1063
29071,071,29,2017,103340,357,28,385,1210,1006
29071,071,29,2018,103716,159,18,177,1222,1020
29071,071,29,2019,103860,53,20,73,1202,1132
29071,071,29,2020,104469,581,18,599,1180,1173
29073,073,29,2010,15207,13,0,13,38,52
29073,073,29,2011,15075,-110,4,-106,177,203
29073,073,29,2012,14914,-75,1,-74,130,218
29073,073,29,2013,14816,-43,1,-42,160,212
29073,073,29,2014,14814,18,2,20,163,181
29073,073,29,2015,14753,3,2,5,152,216
29073,073,29,2016,14751,26,0,26,154,181
29073,073,29,2017,14695,11,-1,10,156,221
29073,073,29,2018,14680,41,-1,40,156,211
29073,073,29,2019,14671,41,-1,40,158,206
29073,073,29,2020,14566,-29,0,-29,151,227
29075,075,29,2010,6749,-7,1,-6,27,10
29075,075,29,2011,6821,71,3,74,84,88
29075,075,29,2012,6767,-58,2,-56,88,86
29075,075,29,2013,6733,-26,3,-23,94,104
29075,075,29,2014,6753,15,2,17,84,80
29075,075,29,2015,6650,-127,0,-127,106,83
29075,075,29,2016,6623,-34,1,-33,103,97
29075,075,29,2017,6630,14,1,15,87,95
29075,075,29,2018,6579,-32,1,-31,81,100
29075,075,29,2019,6564,-27,1,-26,91,78
29075,075,29,2020,6484,-73,0,-73,86,93
29077,077,29,2010,275320,-88,60,-28,868,661
29077,077,29,2011,277510,833,336,1169,3568,2543
29077,077,29,2012,280550,1861,231,2092,3466,2541
29077,077,29,2013,283750,1933,243,2176,3633,2632
29077,077,29,2014,285427,499,317,816,3565,2661
29077,077,29,2015,287543,816,467,1283,3601,2751
29077,077,29,2016,288114,-416,282,-134,3577,2855
29077,077,29,2017,289830,833,373,1206,3500,2983
29077,077,29,2018,291430,973,269,1242,3272,2913
29077,077,29,2019,293499,1365,293,1658,3381,2980
29077,077,29,2020,294997,946,242,1188,3347,3048
29079,079,29,2010,10254,10,1,11,42,57
29079,079,29,2011,10254,-12,13,1,120,121
29079,079,29,2012,10333,52,7,59,140,118
29079,079,29,2013,10346,-18,5,-13,157,130
29079,079,29,2014,10183,-201,7,-194,175,147
29079,079,29,2015,10033,-173,24,-149,153,153
29079,079,29,2016,10107,72,7,79,139,145
29079,079,29,2017,9990,-149,9,-140,150,126
29079,079,29,2018,9949,-92,6,-86,162,117
29079,079,29,2019,9780,-185,7,-178,130,120
29079,079,29,2020,9595,-191,7,-184,129,129
29081,081,29,2010,8968,-7,0,-7,28,13
29081,081,29,2011,8887,-90,1,-89,103,95
29081,081,29,2012,8731,-143,1,-142,113,128
29081,081,29,2013,8717,-5,-2,-7,113,120
29081,081,29,2014,8638,-70,-1,-71,117,125
29081,081,29,2015,8631,-4,-1,-5,115,115
29081,081,29,2016,8587,-28,-1,-29,106,121
29081,081,29,2017,8519,-49,-1,-50,101,119
29081,081,29,2018,8362,-119,-1,-120,90,127
29081,081,29,2019,8346,-20,-1,-21,96,89
29081,081,29,2020,8321,5,0,5,90,121
29083,083,29,2010,22265,6,1,7,64,96
29083,083,29,2011,22254,28,2,30,278,318
29083,083,29,2012,22228,31,0,31,261,313
29083,083,29,2013,22118,-43,-2,-45,264,325
29083,083,29,2014,22050,-33,-4,-37,263,287
29083,083,29,2015,21728,-237,-4,-241,244,327
29083,083,29,2016,21634,-42,-2,-44,258,307
29083,083,29,2017,21704,140,-2,138,233,301
29083,083,29,2018,21885,222,-3,219,258,297
29083,083,29,2019,21971,108,-3,105,271,290
29083,083,29,2020,22076,155,-2,153,275,321
29085,085,29,2010,9646,25,0,25,21,29
29085,085,29,2011,9614,39,0,39,82,152
29085,085,29,2012,9444,-89,1,-88,78,158
29085,085,29,2013,9349,-21,0,-21,63,136
29085,085,29,2014,9292,15,0,15,64,137
29085,085,29,2015,9269,57,1,58,75,156
29085,085,29,2016,9367,179,-1,178,80,161
29085,085,29,2017,9396,105,-1,104,74,150
29085,085,29,2018,9416,104,-1,103,81,163
29085,085,29,2019,9496,139,-1,138,70,129
29085,085,29,2020,9586,165,-1,164,82,155
29087,087,29,2010,4915,-3,0,-3,15,8
29087,087,29,2011,4838,-70,0,-70,62,69
29087,087,29,2012,4679,-149,0,-149,41,55
29087,087,29,2013,4589,-67,0,-67,55,80
29087,087,29,2014,4529,-45,0,-45,52,66
29087,087,29,2015,4483,-26,0,-26,45,65
29087,087,29,2016,4464,-3,0,-3,58,73
29087,087,29,2017,4406,-59,0,-59,38,37
29087,087,29,2018,4382,5,0,5,40,67
29087,087,29,2019,4387,-4,0,-4,52,44
29087,087,29,2020,4232,-133,0,-133,47,69
29089,089,29,2010,10141,-31,4,-27,41,17
29089,089,29,2011,10219,67,18,85,119,125
29089,089,29,2012,10198,-70,7,-63,123,82
29089,089,29,2013,10240,36,2,38,101,95
29089,089,29,2014,10131,-139,3,-136,130,105
29089,089,29,2015,10136,-10,3,-7,118,106
29089,089,29,2016,10033,-119,1,-118,121,106
29089,089,29,2017,10067,36,2,38,110,115
29089,089,29,2018,10027,-37,2,-35,119,125
29089,089,29,2019,9982,-73,2,-71,108,82
29089,089,29,2020,10001,3,1,4,106,90
29091,091,29,2010,40544,117,7,124,123,87
29091,091,29,2011,40578,-43,15,-28,560,494
29091,091,29,2012,40533,-90,11,-79,507,467
29091,091,29,2013,40234,-269,11,-258,483,523
29091,091,29,2014,40122,-150,13,-137,549,518
29091,091,29,2015,40071,5,20,25,481,550
29091,091,29,2016,40131,41,7,48,496,480
29091,091,29,2017,40069,-45,4,-41,510,529
29091,091,29,2018,40103,7,2,9,535,508
29091,091,29,2019,40084,21,3,24,487,530
29091,091,29,2020,40262,245,4,249,485,555
29093,093,29,2010,10591,-40,1,-39,31,18
29093,093,29,2011,10618,50,9,59,101,133
29093,093,29,2012,10544,-58,5,-53,120,142
29093,093,29,2013,10459,-79,3,-76,107,116
29093,093,29,2014,10359,-39,0,-39,91,152
29093,093,29,2015,10200,-94,4,-90,98,167
29093,093,29,2016,10127,-33,0,-33,113,152
29093,093,29,2017,10178,119,2,121,95,164
29093,093,29,2018,10193,63,1,64,106,154
29093,093,29,2019,10152,-8,2,-6,106,141
29093,093,29,2020,10098,15,1,16,104,174
29095,095,29,2010,674854,-420,185,-235,2442,1445
29095,095,29,2011,675644,-3677,1007,-2670,9581,6117
29095,095,29,2012,677570,-2304,707,-1597,9674,6038
29095,095,29,2013,680063,-1311,586,-725,9473,6146
29095,095,29,2014,683334,-762,614,-148,9658,6090
29095,095,29,2015,687182,-332,1087,755,9401,6219
29095,095,29,2016,692812,1920,626,2546,9315,6219
29095,095,29,2017,698768,1853,1165,3018,9348,6407
29095,095,29,2018,701809,-683,844,161,9316,6414
29095,095,29,2019,704350,-858,914,56,8930,6455
29095,095,29,2020,705925,-979,729,-250,8913,7121
29097,097,29,2010,117662,130,25,155,415,299
29097,097,29,2011,115313,-3090,186,-2904,1754,1219
29097,097,29,2012,115813,-204,128,-76,1686,1083
29097,097,29,2013,116814,343,101,444,1745,1181
29097,097,29,2014,117801,325,107,432,1726,1149
29097,097,29,2015,118623,222,151,373,1615,1154
29097,097,29,2016,119304,59,95,154,1687,1154
29097,097,29,2017,120113,283,141,424,1606,1214
29097,097,29,2018,120349,-180,107,-73,1610,1297
29097,097,29,2019,121228,438,116,554,1556,1234
29097,097,29,2020,121648,68,85,153,1548,1290
29099,099,29,2010,219130,100,21,121,713,403
29099,099,29,2011,219605,-468,103,-365,2728,1885
29099,099,29,2012,219885,-577,52,-525,2599,1778
29099,099,29,2013,220923,225,49,274,2720,1915
29099,099,29,2014,222066,369,61,430,2611,1848
29099,099,29,2015,223185,496,97,593,2523,1970
29099,099,29,2016,223439,-360,42,-318,2601,2023
29099,099,29,2017,223843,-125,79,-46,2605,2144
29099,099,29,2018,224656,322,55,377,2600,2156
29099,099,29,2019,225402,340,64,404,2469,2133
29099,099,29,2020,226543,937,47,984,2496,2347
29101,101,29,2010,52689,-44,50,6,189,66
29101,101,29,2011,53417,354,72,426,718,419
29101,101,29,2012,54335,276,278,554,731,371
29101,101,29,2013,54331,-459,145,-314,687,378
29101,101,29,2014,54221,-638,142,-496,771,390
29101,101,29,2015,53717,-1019,224,-795,721,441
29101,101,29,2016,53722,-361,106,-255,702,443
29101,101,29,2017,53893,-141,41,-100,699,424
29101,101,29,2018,53718,-491,-19,-510,729,396
29101,101,29,2019,54187,150,39,189,678,401
29101,101,29,2020,54219,-267,32,-235,691,426
29103,103,29,2010,4125,3,0,3,10,18
29103,103,29,2011,4126,13,0,13,43,55
29103,103,29,2012,4091,-34,0,-34,50,52
29103,103,29,2013,4060,-35,0,-35,58,53
29103,103,29,2014,3994,-70,0,-70,58,58
29103,103,29,2015,3907,-89,0,-89,50,48
29103,103,29,2016,3929,27,0,27,41,47
29103,103,29,2017,3971,34,0,34,53,44
29103,103,29,2018,3943,-39,0,-39,49,38
29103,103,29,2019,3957,-8,0,-8,66,43
29103,103,29,2020,3940,-35,0,-35,62,43
29105,105,29,2010,35697,47,1,48,112,58
29105,105,29,2011,35668,-118,4,-114,444,358
29105,105,29,2012,35490,-285,0,-285,487,386
29105,105,29,2013,35672,163,2,165,423,401
29105,105,29,2014,35558,-218,4,-214,490,390
29105,105,29,2015,35506,-114,4,-110,475,414
29105,105,29,2016,35486,-118,3,-115,486,391
29105,105,29,2017,35467,-80,5,-75,519,461
29105,105,29,2018,35684,175,3,178,483,445
29105,105,29,2019,35869,147,4,151,483,449
29105,105,29,2020,35895,-24,0,-24,481,432
29107,107,29,2010,33380,18,1,19,107,113
29107,107,29,2011,33213,-246,2,-244,376,299
29107,107,29,2012,33061,-181,-1,-182,370,342
29107,107,29,2013,32828,-199,-1,-200,360,392
29107,107,29,2014,32627,-223,-2,-225,384,364
29107,107,29,2015,32633,-2,10,8,398,397
29107,107,29,2016,32532,-29,-1,-30,339,408
29107,107,29,2017,32604,105,6,111,358,393
29107,107,29,2018,32567,6,1,7,374,417
29107,107,29,2019,32774,195,3,198,399,390
29107,107,29,2020,33006,217,1,218,398,383
29109,109,29,2010,38590,-68,1,-67,122,113
29109,109,29,2011,38502,-145,2,-143,481,424
29109,109,29,2012,38384,-176,-3,-179,492,428
29109,109,29,2013,38109,-347,-10,-357,509,432
29109,109,29,2014,37917,-189,-6,-195,462,459
29109,109,29,2015,37999,74,-6,68,483,463
29109,109,29,2016,38201,150,-19,131,525,452
29109,109,29,2017,38271,62,-14,48,488,463
29109,109,29,2018,38271,-7,-20,-27,552,523
29109,109,29,2019,38288,42,-16,26,497,505
29109,109,29,2020,38175,-132,-5,-137,509,486
29111,111,29,2010,10206,-12,0,-12,28,15
29111,111,29,2011,10217,-2,3,1,111,101
29111,111,29,2012,10116,-99,3,-96,112,119
29111,111,29,2013,10110,-16,1,-15,113,104
29111,111,29,2014,10098,-32,3,-29,114,96
29111,111,29,2015,10141,71,-1,70,107,133
29111,111,29,2016,10091,-65,0,-65,131,117
29111,111,29,2017,9957,-122,-2,-124,119,129
29111,111,29,2018,9844,-104,-3,-107,127,132
29111,111,29,2019,9787,-69,-2,-71,115,102
29111,111,29,2020,9810,11,1,12,116,104
29113,113,29,2010,52673,41,2,43,176,80
29113,113,29,2011,53051,45,14,59,740,419
29113,113,29,2012,53267,-74,11,-63,701,411
29113,113,29,2013,53784,238,14,252,699,429
29113,113,29,2014,54167,94,5,99,733,435
29113,113,29,2015,54569,104,8,112,746,452
29113,113,29,2016,55146,332,1,333,747,502
29113,113,29,2017,56040,676,2,678,732,519
29113,113,29,2018,57604,1280,2,1282,772,495
29113,113,29,2019,59040,1102,0,1102,827,490
29113,113,29,2020,60119,777,3,780,823,525
29115,115,29,2010,12774,-7,-1,-8,28,19
29115,115,29,2011,12602,-137,2,-135,130,168
29115,115,29,2012,12489,-71,0,-71,138,179
29115,115,29,2013,12330,-127,3,-124,126,164
29115,115,29,2014,12318,14,4,18,165,192
29115,115,29,2015,12290,-11,8,-3,156,180
29115,115,29,2016,12123,-110,3,-107,121,181
29115,115,29,2017,12159,73,4,77,143,182
29115,115,29,2018,12002,-114,4,-110,137,183
29115,115,29,2019,11906,-83,4,-79,133,150
29115,115,29,2020,11830,-55,3,-52,135,158
29117,117,29,2010,15128,-57,0,-57,49,63
29117,117,29,2011,15121,18,7,25,155,187
29117,117,29,2012,14997,-98,6,-92,164,198
29117,117,29,2013,14878,-127,5,-122,174,172
29117,117,29,2014,15009,163,5,168,152,192
29117,117,29,2015,14943,-38,7,-31,171,206
29117,117,29,2016,15119,240,4,244,147,216
29117,117,29,2017,15161,59,7,66,158,181
29117,117,29,2018,15169,15,4,19,151,161
29117,117,29,2019,14982,-182,4,-178,170,178
29117,117,29,2020,14413,-530,4,-526,152,193
29119,119,29,2010,23071,-53,7,-46,76,45
29119,119,29,2011,22897,-312,43,-269,288,194
29119,119,29,2012,22976,-53,28,-25,317,209
29119,119,29,2013,22651,-449,16,-433,317,218
29119,119,29,2014,22851,90,54,144,299,242
29119,119,29,2015,22721,-274,56,-218,317,231
29119,119,29,2016,22773,-135,36,-99,373,222
29119,119,29,2017,22796,-143,53,-90,362,248
29119,119,29,2018,23031,116,42,158,338,260
29119,119,29,2019,22912,-289,49,-240,351,230
29119,119,29,2020,22900,-140,40,-100,329,240
29121,121,29,2010,15580,16,0,16,37,24
29121,121,29,2011,15473,-89,3,-86,188,208
29121,121,29,2012,15550,109,3,112,166,199
29121,121,29,2013,15463,-54,3,-51,168,205
29121,121,29,2014,15436,-19,3,-16,185,194
29121,121,29,2015,15271,-173,6,-167,189,187
29121,121,29,2016,15145,-98,8,-90,165,201
29121,121,29,2017,15253,111,13,124,181,198
29121,121,29,2018,15167,-70,11,-59,180,205
29121,121,29,2019,15111,-37,12,-25,171,202
29121,121,29,2020,15095,2,6,8,171,196
29123,123,29,2010,12197,-30,4,-26,28,23
29123,123,29,2011,12257,35,26,61,143,143
29123,123,29,2012,12376,136,16,152,148,183
29123,123,29,2013,12272,-81,6,-75,133,163
29123,123,29,2014,12195,-39,0,-39,136,172
29123,123,29,2015,12182,23,2,25,140,176
29123,123,29,2016,12209,62,-2,60,137,169
29123,123,29,2017,12236,39,-2,37,151,161
29123,123,29,2018,12205,3,-3,0,159,190
29123,123,29,2019,12118,-63,-3,-66,122,143
29123,123,29,2020,12113,44,-3,41,127,174
29125,125,29,2010,9159,10,2,12,30,33
29125,125,29,2011,9170,22,9,31,89,109
29125,125,29,2012,9020,-151,5,-146,89,95
29125,125,29,2013,9031,40,2,42,68,99
29125,125,29,2014,8998,-9,0,-9,77,99
29125,125,29,2015,8934,-44,4,-40,84,108
29125,125,29,2016,8823,-103,5,-98,90,103
29125,125,29,2017,8791,-2,5,3,68,103
29125,125,29,2018,8795,21,5,26,81,103
29125,125,29,2019,8751,-50,4,-46,94,91
29125,125,29,2020,8795,68,3,71,88,114
29127,127,29,2010,28785,-29,3,-26,97,61
29127,127,29,2011,28786,-70,16,-54,392,335
29127,127,29,2012,28753,-62,9,-53,339,313
29127,127,29,2013,28781,-31,16,-15,357,309
29127,127,29,2014,28784,-73,17,-56,386,324
29127,127,29,2015,28719,-115,18,-97,378,342
29127,127,29,2016,28721,-64,13,-51,380,326
29127,127,29,2017,28607,-109,17,-92,351,371
29127,127,29,2018,28564,-65,14,-51,354,347
29127,127,29,2019,28543,-65,16,-49,362,334
29127,127,29,2020,28423,-154,12,-142,350,327
29129,129,29,2010,3770,-8,0,-8,10,17
29129,129,29,2011,3774,9,3,12,42,49
29129,129,29,2012,3708,-57,0,-57,39,48
29129,129,29,2013,3664,-40,1,-39,40,45
29129,129,29,2014,3682,11,1,12,41,36
29129,129,29,2015,3660,-20,1,-19,51,52
29129,129,29,2016,3654,-15,3,-12,40,35
29129,129,29,2017,3659,9,4,13,52,60
29129,129,29,2018,3625,-53,2,-51,55,38
29129,129,29,2019,3619,-16,3,-13,43,36
29129,129,29,2020,3558,-71,2,-69,43,34
29131,131,29,2010,24701,-24,4,-20,72,83
29131,131,29,2011,24705,-36,0,-36,287,245
29131,131,29,2012,24573,-98,-2,-100,274,302
29131,131,29,2013,24805,196,-3,193,309,269
29131,131,29,2014,24824,-17,-3,-20,312,267
29131,131,29,2015,24865,43,0,43,305,304
29131,131,29,2016,24981,99,-1,98,300,279
29131,131,29,2017,25199,184,-3,181,312,275
29131,131,29,2018,25269,83,-3,80,313,321
29131,131,29,2019,25607,288,-4,284,309,254
29131,131,29,2020,25791,158,0,158,323,296
29133,133,29,2010,14333,-16,0,-16,44,74
29133,133,29,2011,14241,-55,-5,-60,171,202
29133,133,29,2012,14288,40,-4,36,198,186
29133,133,29,2013,14189,-68,-3,-71,169,197
29133,133,29,2014,14197,11,-1,10,152,153
29133,133,29,2015,13984,-212,0,-212,137,139
29133,133,29,2016,13755,-203,0,-203,145,170
29133,133,29,2017,13615,-114,0,-114,159,185
29133,133,29,2018,13369,-198,-1,-199,145,192
29133,133,29,2019,13208,-163,0,-163,162,159
29133,133,29,2020,12691,-466,0,-466,150,198
29135,135,29,2010,15630,-3,0,-3,45,21
29135,135,29,2011,15711,11,9,20,201,139
29135,135,29,2012,15674,-121,10,-111,215,142
29135,135,29,2013,15748,1,3,4,225,153
29135,135,29,2014,15815,13,5,18,195,141
29135,135,29,2015,15878,-14,22,8,206,151
29135,135,29,2016,15990,41,6,47,212,145
29135,135,29,2017,16028,-7,7,0,198,159
29135,135,29,2018,16118,50,7,57,202,169
29135,135,29,2019,15816,-371,3,-368,196,131
29135,135,29,2020,15585,-256,4,-252,189,167
29137,137,29,2010,8787,-49,0,-49,23,34
29137,137,29,2011,8685,-119,0,-119,100,83
29137,137,29,2012,8691,18,0,18,83,94
29137,137,29,2013,8768,74,0,74,81,79
29137,137,29,2014,8735,-36,0,-36,98,94
29137,137,29,2015,8635,-97,0,-97,94,98
29137,137,29,2016,8629,-5,0,-5,105,106
29137,137,29,2017,8594,-35,0,-35,102,102
29137,137,29,2018,8630,58,0,58,89,110
29137,137,29,2019,8627,-1,0,-1,89,89
29137,137,29,2020,8672,70,0,70,88,113
29139,139,29,2010,12209,3,1,4,32,51
29139,139,29,2011,12206,-8,5,-3,168,169
29139,139,29,2012,11971,-235,6,-229,142,155
29139,139,29,2013,11852,-124,5,-119,145,145
29139,139,29,2014,11725,-89,3,-86,127,168
29139,139,29,2015,11579,-131,3,-128,130,148
29139,139,29,2016,11459,-75,4,-71,126,176
29139,139,29,2017,11388,-13,3,-10,116,176
29139,139,29,2018,11458,109,4,113,127,170
29139,139,29,2019,11472,33,2,35,145,166
29139,139,29,2020,11294,-143,0,-143,135,168
29141,141,29,2010,20542,2,1,3,61,85
29141,141,29,2011,20375,-96,1,-95,232,302
29141,141,29,2012,20079,-265,0,-265,269,303
29141,141,29,2013,20123,96,-1,95,243,294
29141,141,29,2014,20081,-4,-1,-5,247,283
29141,141,29,2015,20072,13,-2,11,263,281
29141,141,29,2016,20106,65,0,65,277,308
29141,141,29,2017,20181,89,-1,88,280,294
29141,141,29,2018,20466,323,-1,322,265,301
29141,141,29,2019,20720,294,-1,293,255,294
29141,141,29,2020,20716,46,0,46,254,303
29143,143,29,2010,18928,-32,1,-31,63,36
29143,143,29,2011,18758,-135,-5,-140,230,259
29143,143,29,2012,18468,-253,1,-252,209,252
29143,143,29,2013,18315,-138,1,-137,231,251
29143,143,29,2014,18230,-112,3,-109,258,231
29143,143,29,2015,18070,-132,3,-129,229,261
29143,143,29,2016,17851,-229,1,-228,236,225
29143,143,29,2017,17541,-296,0,-296,230,245
29143,143,29,2018,17234,-269,0,-269,223,263
29143,143,29,2019,17052,-167,0,-167,210,225
29143,143,29,2020,16693,-321,0,-321,215,251
29145,145,29,2010,58172,-14,12,-2,182,117
29145,145,29,2011,58564,194,32,226,743,574
29145,145,29,2012,58651,-133,20,-113,793,589
29145,145,29,2013,58396,-311,31,-280,686,659
29145,145,29,2014,58148,-362,30,-332,717,634
29145,145,29,2015,58165,-73,17,-56,728,648
29145,145,29,2016,58221,-24,4,-20,708,628
29145,145,29,2017,58206,-36,7,-29,680,664
29145,145,29,2018,58233,-13,-3,-16,712,666
29145,145,29,2019,58329,35,1,36,731,672
29145,145,29,2020,58451,40,10,50,723,652
29147,147,29,2010,23402,-20,4,-16,72,26
29147,147,29,2011,23439,-22,34,12,220,197
29147,147,29,2012,23336,-137,24,-113,222,211
29147,147,29,2013,23165,-240,20,-220,226,181
29147,147,29,2014,23002,-222,9,-213,240,196
29147,147,29,2015,22649,-400,21,-379,222,200
29147,147,29,2016,22486,-207,10,-197,231,197
29147,147,29,2017,22431,-106,13,-93,226,189
29147,147,29,2018,22244,-174,7,-167,192,213
29147,147,29,2019,22089,-195,8,-187,214,183
29147,147,29,2020,21743,-374,7,-367,206,183
29149,149,29,2010,10934,51,0,51,32,33
29149,149,29,2011,11049,131,-2,129,130,143
29149,149,29,2012,10973,-89,-4,-93,142,127
29149,149,29,2013,10937,-22,-1,-23,124,134
29149,149,29,2014,10835,-95,-1,-96,133,141
29149,149,29,2015,10864,36,1,37,142,147
29149,149,29,2016,10753,-75,1,-74,112,149
29149,149,29,2017,10568,-150,2,-148,114,150
29149,149,29,2018,10557,28,1,29,118,158
29149,149,29,2019,10517,-24,2,-22,113,130
29149,149,29,2020,10411,-74,1,-73,118,151
29151,151,29,2010,13907,-22,1,-21,38,21
29151,151,29,2011,13909,-10,2,-8,147,137
29151,151,29,2012,13848,-98,2,-96,156,123
29151,151,29,2013,13679,-180,2,-178,142,135
29151,151,29,2014,13640,-57,1,-56,137,122
29151,151,29,2015,13540,-120,0,-120,158,136
29151,151,29,2016,13612,27,0,27,164,118
29151,151,29,2017,13659,24,0,24,165,141
29151,151,29,2018,13640,-6,0,-6,143,156
29151,151,29,2019,13621,-42,0,-42,150,126
29151,151,29,2020,13535,-88,0,-88,139,138
29153,153,29,2010,9746,15,0,15,17,15
29153,153,29,2011,9649,-55,-3,-58,82,120
29153,153,29,2012,9600,-14,-2,-16,100,132
29153,153,29,2013,9512,-50,-3,-53,89,122
29153,153,29,2014,9448,-13,-3,-16,90,137
29153,153,29,2015,9373,-26,0,-26,85,133
29153,153,29,2016,9204,-119,0,-119,73,123
29153,153,29,2017,9236,72,0,72,95,133
29153,153,29,2018,9011,-163,0,-163,84,145
29153,153,29,2019,9155,174,0,174,75,104
29153,153,29,2020,9083,-12,0,-12,70,130
29155,155,29,2010,18260,-59,1,-58,64,32
29155,155,29,2011,18187,-161,1,-160,297,211
29155,155,29,2012,18081,-145,-3,-148,276,232
29155,155,29,2013,17782,-352,-2,-354,310,262
29155,155,29,2014,17574,-213,-4,-217,270,263
29155,155,29,2015,17427,-181,-2,-183,271,235
29155,155,29,2016,17092,-367,-2,-369,273,241
29155,155,29,2017,16809,-285,-3,-288,249,244
29155,155,29,2018,16281,-538,-4,-542,244,232
29155,155,29,2019,15864,-432,-3,-435,227,208
29155,155,29,2020,15600,-245,-1,-246,221,238
29157,157,29,2010,18931,-31,3,-28,63,68
29157,157,29,2011,19000,22,15,37,232,199
29157,157,29,2012,18991,-33,2,-31,215,189
29157,157,29,2013,19047,27,3,30,216,187
29157,157,29,2014,19116,36,-2,34,221,182
29157,157,29,2015,19066,-53,-3,-56,213,205
29157,157,29,2016,19224,106,12,118,232,190
29157,157,29,2017,19267,21,21,42,222,220
29157,157,29,2018,19284,-27,17,-10,218,190
29157,157,29,2019,19164,-142,16,-126,215,209
29157,157,29,2020,19194,29,10,39,216,226
29159,159,29,2010,42263,6,9,15,167,117
29159,159,29,2011,42147,-302,45,-257,598,458
29159,159,29,2012,42299,-51,29,-22,579,395
29159,159,29,2013,42197,-288,45,-243,574,432
29159,159,29,2014,42201,-184,41,-143,558,406
29159,159,29,2015,42303,-141,52,-89,597,405
29159,159,29,2016,42274,-202,36,-166,574,434
29159,159,29,2017,42477,65,51,116,579,489
29159,159,29,2018,42449,-135,38,-97,556,487
29159,159,29,2019,42417,-255,41,-214,631,449
29159,159,29,2020,42490,-115,37,-78,587,438
29161,161,29,2010,45298,58,46,104,144,74
29161,161,29,2011,45260,-371,224,-147,548,441
29161,161,29,2012,45248,-324,149,-175,559,401
29161,161,29,2013,45030,-489,179,-310,521,436
29161,161,29,2014,44957,-358,194,-164,516,432
29161,161,29,2015,44801,-434,243,-191,510,478
29161,161,29,2016,44772,-266,179,-87,526,469
29161,161,29,2017,44606,-365,239,-126,480,521
29161,161,29,2018,44549,-291,176,-115,480,425
29161,161,29,2019,44593,-148,194,46,447,449
29161,161,29,2020,44414,-284,148,-136,440,484
29163,163,29,2010,18474,-23,0,-23,48,62
29163,163,29,2011,18665,139,-1,138,223,171
29163,163,29,2012,18554,-158,-1,-159,230,184
29163,163,29,2013,18607,56,-1,55,199,199
29163,163,29,2014,18493,-135,0,-135,232,211
29163,163,29,2015,18404,-97,7,-90,215,215
29163,163,29,2016,18508,78,3,81,227,203
29163,163,29,2017,18556,25,4,29,220,200
29163,163,29,2018,18495,-38,2,-36,212,237
29163,163,29,2019,17678,-852,3,-849,211,180
29163,163,29,2020,17552,-129,2,-127,199,197
29165,165,29,2010,89714,216,43,259,279,159
29165,165,29,2011,90912,487,139,626,1149,576
29165,165,29,2012,92203,577,164,741,1140,586
29165,165,29,2013,93435,519,160,679,1174,612
29165,165,29,2014,94947,841,195,1036,1102,630
29165,165,29,2015,96552,780,296,1076,1165,633
29165,165,29,2016,98771,1480,202,1682,1235,699
29165,165,29,2017,101256,1723,287,2010,1202,731
29165,165,29,2018,102953,1008,239,1247,1211,759
29165,165,29,2019,104726,1030,225,1255,1216,699
29165,165,29,2020,106532,1175,187,1362,1214,767
29167,167,29,2010,31158,6,6,12,78,60
29167,167,29,2011,31203,-17,17,0,393,347
29167,167,29,2012,31088,-149,8,-141,389,363
29167,167,29,2013,31126,23,5,28,356,342
29167,167,29,2014,31130,-72,-1,-73,413,332
29167,167,29,2015,31272,135,-9,126,359,339
29167,167,29,2016,31415,76,-3,73,383,311
29167,167,29,2017,31776,377,-4,373,382,393
29167,167,29,2018,32244,450,-7,443,405,381
29167,167,29,2019,32228,-59,-5,-64,431,383
29167,167,29,2020,32490,270,-4,266,425,429
29169,169,29,2010,52865,241,147,388,216,41
29169,169,29,2011,53322,-372,192,-180,904,267
29169,169,29,2012,53521,-1108,807,-301,794,324
29169,169,29,2013,54151,-349,398,49,861,280
29169,169,29,2014,53648,-1322,291,-1031,817,318
29169,169,29,2015,53324,-1303,483,-820,807,328
29169,169,29,2016,52554,-1450,204,-1246,766,299
29169,169,29,2017,51918,-1160,96,-1064,768,345
29169,169,29,2018,51982,-269,-47,-316,717,336
29169,169,29,2019,52634,212,31,243,711,306
29169,169,29,2020,52709,-337,25,-312,725,340
29171,171,29,2010,4974,-9,0,-9,16,12
29171,171,29,2011,4977,7,0,7,51,54
29171,171,29,2012,4948,-13,0,-13,55,70
29171,171,29,2013,4887,-41,0,-41,49,70
29171,171,29,2014,4845,-36,-2,-38,57,60
29171,171,29,2015,4864,12,0,12,66,59
29171,171,29,2016,4825,-26,0,-26,59,72
29171,171,29,2017,4782,-21,0,-21,64,84
29171,171,29,2018,4748,-31,0,-31,56,59
29171,171,29,2019,4688,-45,0,-45,53,68
29171,171,29,2020,4688,19,0,19,53,72
29173,173,29,2010,10196,16,0,16,35,31
29173,173,29,2011,10278,64,0,64,101,84
29173,173,29,2012,10230,-64,0,-64,90,74
29173,173,29,2013,10168,-36,0,-36,98,123
29173,173,29,2014,10280,101,0,101,97,87
29173,173,29,2015,10171,-92,0,-92,90,106
29173,173,29,2016,10240,70,0,70,100,101
29173,173,29,2017,10228,-7,0,-7,100,104
29173,173,29,2018,10233,-26,0,-26,117,86
29173,173,29,2019,10292,61,0,61,84,87
29173,173,29,2020,10299,12,0,12,91,95
29175,175,29,2010,25454,1,0,1,83,43
29175,175,29,2011,25283,-218,6,-212,282,243
29175,175,29,2012,25337,52,6,58,269,271
29175,175,29,2013,24953,-377,6,-371,282,304
29175,175,29,2014,25063,91,4,95,292,276
29175,175,29,2015,25063,26,11,37,267,301
29175,175,29,2016,24992,-87,0,-87,290,272
29175,175,29,2017,24909,-60,4,-56,291,317
29175,175,29,2018,24697,-246,3,-243,300,271
29175,175,29,2019,24839,127,3,130,296,284
29175,175,29,2020,24409,-449,3,-446,287,269
29177,177,29,2010,23517,-23,1,-22,56,32
29177,177,29,2011,23345,-191,-1,-192,257,238
29177,177,29,2012,23081,-266,1,-265,236,244
29177,177,29,2013,23065,-17,2,-15,247,246
29177,177,29,2014,22939,-99,2,-97,234,261
29177,177,29,2015,22799,-169,-1,-170,271,242
29177,177,29,2016,22740,-41,1,-40,249,267
29177,177,29,2017,22895,157,3,160,266,269
29177,177,29,2018,22924,68,2,70,255,296
29177,177,29,2019,23024,77,1,78,269,246
29177,177,29,2020,22915,-81,2,-79,256,287
29179,179,29,2010,6676,7,0,7,13,32
29179,179,29,2011,6565,-86,0,-86,68,92
29179,179,29,2012,6549,-6,0,-6,59,69
29179,179,29,2013,6456,-81,0,-81,69,82
29179,179,29,2014,6402,-12,0,-12,58,100
29179,179,29,2015,6294,-57,0,-57,52,101
29179,179,29,2016,6359,82,0,82,65,82
29179,179,29,2017,6260,-69,0,-69,46,76
29179,179,29,2018,6267,34,0,34,63,90
29179,179,29,2019,6288,29,0,29,70,78
29179,179,29,2020,6198,-57,0,-57,67,99
29181,181,29,2010,14102,18,0,18,48,70
29181,181,29,2011,14143,34,-1,33,190,181
29181,181,29,2012,14032,-100,-2,-102,172,180
29181,181,29,2013,13996,-13,1,-12,175,196
29181,181,29,2014,13941,-56,-1,-57,183,179
29181,181,29,2015,13797,-159,-1,-160,186,171
29181,181,29,2016,13773,20,-1,19,161,201
29181,181,29,2017,13576,-187,-2,-189,158,167
29181,181,29,2018,13428,-89,-2,-91,153,209
29181,181,29,2019,13343,-68,-2,-70,160,175
29181,181,29,2020,13300,27,-2,25,154,221
29183,183,29,2010,361808,536,109,645,1209,532
29183,183,29,2011,365614,912,546,1458,4611,2250
29183,183,29,2012,369175,1171,436,1607,4395,2360
29183,183,29,2013,374378,2668,401,3069,4550,2410
29183,183,29,2014,379956,3039,525,3564,4572,2576
29183,183,29,2015,385108,2858,591,3449,4475,2759
29183,183,29,2016,390724,3313,418,3731,4597,2711
29183,183,29,2017,395153,2405,546,2951,4481,2986
29183,183,29,2018,398656,1721,450,2171,4379,3037
29183,183,29,2019,401625,1411,365,1776,4303,3112
29183,183,29,2020,406204,3271,326,3597,4254,3274
29185,185,29,2010,9823,40,0,40,25,48
29185,185,29,2011,9694,-100,-1,-101,95,124
29185,185,29,2012,9533,-105,0,-105,87,145
29185,185,29,2013,9499,27,-1,26,88,147
29185,185,29,2014,9446,-11,-1,-12,98,137
29185,185,29,2015,9427,44,-1,43,94,155
29185,185,29,2016,9310,-58,2,-56,100,160
29185,185,29,2017,9395,130,2,132,96,143
29185,185,29,2018,9431,58,1,59,110,131
29185,185,29,2019,9450,56,1,57,90,127
29185,185,29,2020,9689,301,1,302,92,152
29186,186,29,2010,18126,-9,0,-9,45,55
29186,186,29,2011,18196,28,32,60,194,185
29186,186,29,2012,17867,-319,36,-283,149,203
29186,186,29,2013,17951,75,40,115,160,190
29186,186,29,2014,17936,-51,22,-29,190,173
29186,186,29,2015,17805,-108,2,-106,193,217
29186,186,29,2016,17867,55,1,56,166,159
29186,186,29,2017,17797,-47,1,-46,193,215
29186,186,29,2018,17890,119,1,120,198,223
29186,186,29,2019,17957,26,1,27,226,185
29186,186,29,2020,17924,-41,1,-40,209,202
29187,187,29,2010,65534,148,3,151,196,188
29187,187,29,2011,65596,58,13,71,735,741
29187,187,29,2012,65811,193,9,202,753,732
29187,187,29,2013,66118,351,-2,349,751,794
29187,187,29,2014,65801,-301,-3,-304,738,746
29187,187,29,2015,66253,514,10,524,717,791
29187,187,29,2016,66395,190,-4,186,723,764
29187,187,29,2017,66702,381,1,382,702,775
29187,187,29,2018,66740,127,-3,124,720,804
29187,187,29,2019,66942,303,-1,302,680,780
29187,187,29,2020,66485,-296,-3,-299,678,836
29189,189,29,2010,998846,-1191,465,-726,2842,2224
29189,189,29,2011,1000147,-3685,2453,-1232,11830,9284
29189,189,29,2012,1000975,-3159,1572,-1587,11762,9262
29189,189,29,2013,1000746,-3519,1534,-1985,11338,9536
29189,189,29,2014,1000903,-4073,1900,-2173,11715,9316
29189,189,29,2015,1001585,-3728,2695,-1033,11843,10078
29189,189,29,2016,998393,-6764,1850,-4914,11570,9857
29189,189,29,2017,997116,-5368,2659,-2709,11539,10113
29189,189,29,2018,995900,-3759,2030,-1729,11358,10838
29189,189,29,2019,995467,-3497,2038,-1459,11434,10425
29189,189,29,2020,994020,-3489,1580,-1909,11261,10827
29195,195,29,2010,23422,6,11,17,73,37
29195,195,29,2011,23409,-130,52,-78,309,244
29195,195,29,2012,23547,48,31,79,326,262
29195,195,29,2013,23362,-261,20,-241,304,253
29195,195,29,2014,23408,6,24,30,304,284
29195,195,29,2015,23241,-269,72,-197,271,244
29195,195,29,2016,23126,-168,44,-124,263,255
29195,195,29,2017,22940,-217,69,-148,231,269
29195,195,29,2018,22907,-60,55,-5,236,262
29195,195,29,2019,22827,-173,63,-110,268,237
29195,195,29,2020,22858,-15,48,33,256,259
29197,197,29,2010,4441,3,0,3,18,11
29197,197,29,2011,4390,-60,0,-60,57,49
29197,197,29,2012,4391,-13,-1,-14,63,47
29197,197,29,2013,4375,-24,0,-24,60,52
29197,197,29,2014,4397,21,3,24,69,71
29197,197,29,2015,4506,89,5,94,64,49
29197,197,29,2016,4496,-22,-1,-23,63,49
29197,197,29,2017,4513,-11,2,-9,81,55
29197,197,29,2018,4577,48,1,49,69,55
29197,197,29,2019,4632,34,2,36,65,45
29197,197,29,2020,4534,-115,0,-115,65,48
29199,199,29,2010,4841,-5,0,-5,22,31
29199,199,29,2011,4839,-13,-1,-14,69,56
29199,199,29,2012,4872,2,-1,1,85,53
29199,199,29,2013,4902,17,0,17,73,58
29199,199,29,2014,4851,-87,0,-87,83,50
29199,199,29,2015,4833,-12,0,-12,62,66
29199,199,29,2016,4915,55,0,55,97,72
29199,199,29,2017,4958,5,0,5,96,59
29199,199,29,2018,4937,-40,0,-40,69,50
29199,199,29,2019,4936,-54,0,-54,81,28
29199,199,29,2020,4871,-90,0,-90,72,45
29201,201,29,2010,39268,19,6,25,120,76
29201,201,29,2011,39159,-255,8,-247,556,416
29201,201,29,2012,39177,-87,19,-68,501,410
29201,201,29,2013,39228,-21,2,-19,534,457
29201,201,29,2014,38897,-414,5,-409,509,434
29201,201,29,2015,39040,73,7,80,505,438
29201,201,29,2016,38781,-290,3,-287,465,436
29201,201,29,2017,38611,-200,6,-194,469,444
29201,201,29,2018,38596,-82,10,-72,527,470
29201,201,29,2019,38416,-237,-4,-241,485,424
29201,201,29,2020,38288,-121,-1,-122,488,495
29203,203,29,2010,8445,-11,1,-10,29,10
29203,203,29,2011,8414,-37,1,-36,98,93
29203,203,29,2012,8333,-86,0,-86,95,90
29203,203,29,2013,8289,-35,0,-35,92,101
29203,203,29,2014,8295,18,0,18,80,91
29203,203,29,2015,8275,-18,0,-18,89,90
29203,203,29,2016,8225,-36,0,-36,85,100
29203,203,29,2017,8238,5,0,5,92,83
29203,203,29,2018,8192,-42,0,-42,99,102
29203,203,29,2019,8177,-6,0,-6,88,97
29203,203,29,2020,8203,43,0,43,88,106
29205,205,29,2010,6364,-4,0,-4,23,27
29205,205,29,2011,6232,-101,0,-101,62,94
29205,205,29,2012,6213,-20,0,-20,88,86
29205,205,29,2013,6150,-54,1,-53,59,68
29205,205,29,2014,6089,-52,1,-51,72,82
29205,205,29,2015,6099,26,2,28,76,92
29205,205,29,2016,6035,-46,2,-44,69,90
29205,205,29,2017,5992,-45,1,-44,90,89
29205,205,29,2018,6004,24,2,26,71,84
29205,205,29,2019,5923,-91,1,-90,74,66
29205,205,29,2020,5919,-18,0,-18,73,59
29207,207,29,2010,30025,56,1,57,80,78
29207,207,29,2011,29850,-160,1,-159,366,382
29207,207,29,2012,29816,15,1,16,355,398
29207,207,29,2013,29802,-24,-2,-26,381,365
29207,207,29,2014,29794,-24,0,-24,388,365
29207,207,29,2015,29751,11,2,13,367,419
29207,207,29,2016,29504,-164,0,-164,314,396
29207,207,29,2017,29384,-43,2,-41,315,392
29207,207,29,2018,29288,-42,2,-40,350,404
29207,207,29,2019,29096,-141,2,-139,336,390
29207,207,29,2020,29001,-21,1,-20,334,409
29209,209,29,2010,32241,10,2,12,86,64
29209,209,29,2011,32130,-22,5,-17,241,334
29209,209,29,2012,31908,-150,6,-144,269,342
29209,209,29,2013,31672,-76,1,-75,233,386
29209,209,29,2014,31462,-42,9,-33,265,436
29209,209,29,2015,31334,34,10,44,231,403
29209,209,29,2016,31503,316,4,320,242,390
29209,209,29,2017,31676,291,-1,290,263,381
29209,209,29,2018,31729,255,-4,251,262,459
29209,209,29,2019,32002,427,-3,424,258,405
29209,209,29,2020,32465,643,-1,642,260,432
29211,211,29,2010,6737,5,0,5,27,9
29211,211,29,2011,6665,-90,13,-77,81,77
29211,211,29,2012,6557,-141,22,-119,91,82
29211,211,29,2013,6499,-90,19,-71,86,77
29211,211,29,2014,6476,-28,22,-6,82,97
29211,211,29,2015,6369,-139,20,-119,85,74
29211,211,29,2016,6328,-83,18,-65,82,58
29211,211,29,2017,6203,-158,16,-142,84,68
29211,211,29,2018,6189,-32,16,-16,82,79
29211,211,29,2019,6061,-163,11,-152,97,73
29211,211,29,2020,6033,-62,11,-51,93,71
29213,213,29,2010,51905,162,31,193,147,116
29213,213,29,2011,52666,545,88,633,611,484
29213,213,29,2012,52928,104,40,144,617,489
29213,213,29,2013,53298,270,36,306,624,558
29213,213,29,2014,53861,460,-3,457,628,531
29213,213,29,2015,54282,298,44,342,660,572
29213,213,29,2016,54663,329,21,350,634,600
29213,213,29,2017,55176,435,27,462,641,591
29213,213,29,2018,55817,669,22,691,616,666
29213,213,29,2019,56057,140,10,150,664,573
29213,213,29,2020,56104,11,11,22,627,602
29215,215,29,2010,26043,43,1,44,70,90
29215,215,29,2011,25935,-134,10,-124,296,280
29215,215,29,2012,25799,-147,5,-142,283,277
29215,215,29,2013,25699,-104,0,-104,301,293
29215,215,29,2014,25680,-7,-3,-10,298,301
29215,215,29,2015,25692,44,-2,42,290,316
29215,215,29,2016,25844,162,-4,158,304,309
29215,215,29,2017,25689,-139,-2,-141,283,295
29215,215,29,2018,25560,-101,-2,-103,302,327
29215,215,29,2019,25383,-124,-2,-126,255,307
29215,215,29,2020,25112,-212,0,-212,263,321
29217,217,29,2010,21160,-21,12,-9,46,40
29217,217,29,2011,21090,-119,65,-54,232,248
29217,217,29,2012,20937,-178,31,-147,252,261
29217,217,29,2013,20988,34,8,42,264,251
29217,217,29,2014,20996,11,6,17,263,268
29217,217,29,2015,20775,-229,9,-220,262,263
29217,217,29,2016,20689,-107,5,-102,280,264
29217,217,29,2017,20527,-163,6,-157,231,237
29217,217,29,2018,20544,17,5,22,250,253
29217,217,29,2019,20654,92,5,97,242,229
29217,217,29,2020,20388,-265,3,-262,248,251
29219,219,29,2010,32612,10,-2,8,104,42
29219,219,29,2011,32615,-150,-4,-154,414,257
29219,219,29,2012,32746,24,-12,12,391,266
29219,219,29,2013,32987,69,-4,65,421,240
29219,219,29,2014,33185,118,6,124,386,307
29219,219,29,2015,33539,210,19,229,420,295
29219,219,29,2016,33875,209,8,217,421,302
29219,219,29,2017,34462,436,15,451,435,300
29219,219,29,2018,34801,248,12,260,403,324
29219,219,29,2019,35716,793,13,806,435,325
29219,219,29,2020,36594,764,11,775,441,332
29221,221,29,2010,25198,-15,0,-15,74,59
29221,221,29,2011,25106,-165,2,-163,306,237
29221,221,29,2012,25088,-70,0,-70,306,248
29221,221,29,2013,25145,10,0,10,303,252
29221,221,29,2014,25078,-58,0,-58,291,295
29221,221,29,2015,24795,-290,0,-290,296,291
29221,221,29,2016,24847,60,0,60,292,299
29221,221,29,2017,25000,177,0,177,294,318
29221,221,29,2018,24900,-65,0,-65,277,310
29221,221,29,2019,24743,-175,0,-175,277,259
29221,221,29,2020,24604,-97,0,-97,269,313
29223,223,29,2010,13519,9,0,9,34,58
29223,223,29,2011,13424,-42,0,-42,145,198
29223,223,29,2012,13409,48,-1,47,129,191
29223,223,29,2013,13476,80,0,80,177,191
29223,223,29,2014,13482,77,4,81,129,202
29223,223,29,2015,13435,8,-1,7,146,199
29223,223,29,2016,13229,-156,-1,-157,133,182
29223,223,29,2017,13309,144,-1,143,144,206
29223,223,29,2018,13079,-147,-1,-148,135,216
29223,223,29,2019,12904,-139,-1,-140,127,161
29223,223,29,2020,12769,-68,-1,-69,123,190
29225,225,29,2010,36320,30,1,31,130,101
29225,225,29,2011,36451,-56,-3,-59,470,278
29225,225,29,2012,36451,-238,-3,-241,522,288
29225,225,29,2013,36630,21,-2,19,498,333
29225,225,29,2014,37044,156,1,157,552,284
29225,225,29,2015,37611,341,3,344,568,346
29225,225,29,2016,38158,303,4,307,572,330
29225,225,29,2017,38767,372,14,386,577,353
29225,225,29,2018,39205,216,10,226,591,378
29225,225,29,2019,39644,185,13,198,606,367
29225,225,29,2020,39859,-2,11,9,616,410
29227,227,29,2010,2152,-14,0,-14,5,10
29227,227,29,2011,2118,-13,0,-13,21,42
29227,227,29,2012,2080,-41,0,-41,28,25
29227,227,29,2013,2079,4,0,4,25,30
29227,227,29,2014,2054,-16,0,-16,20,28
29227,227,29,2015,2042,-6,0,-6,27,33
29227,227,29,2016,2009,-10,0,-10,16,39
29227,227,29,2017,2041,33,0,33,25,26
29227,227,29,2018,2011,-21,0,-21,23,32
29227,227,29,2019,1989,-25,0,-25,24,21
29227,227,29,2020,1953,-34,0,-34,21,23
29229,229,29,2010,18777,32,3,35,54,53
29229,229,29,2011,18569,-199,-2,-201,226,233
29229,229,29,2012,18557,-42,-1,-43,249,215
29229,229,29,2013,18335,-239,-1,-240,238,223
29229,229,29,2014,18200,-142,-3,-145,235,225
29229,229,29,2015,18147,-67,-5,-72,253,233
29229,229,29,2016,18181,21,-3,18,240,223
29229,229,29,2017,18216,47,-4,43,267,273
29229,229,29,2018,18230,38,-4,34,251,271
29229,229,29,2019,18329,121,-4,117,240,257
29229,229,29,2020,18325,-1,-2,-3,243,243
29510,510,29,2010,319367,-797,308,-489,1241,682
29510,510,29,2011,319417,-2957,1260,-1697,4821,3081
29510,510,29,2012,319534,-2661,814,-1847,4886,2901
29510,510,29,2013,318624,-3220,708,-2512,4634,3008
29510,510,29,2014,317599,-3555,679,-2876,4796,2941
29510,510,29,2015,316268,-3975,1085,-2890,4575,3009
29510,510,29,2016,312926,-5571,694,-4877,4501,2972
29510,510,29,2017,308424,-6509,956,-5553,4170,3117
29510,510,29,2018,303661,-6653,741,-5912,4183,3026
29510,510,29,2019,300887,-4528,763,-3765,4049,3033
29510,510,29,2020,297645,-4439,593,-3846,3970,3348
30001,001,30,2010,9257,-1,2,1,20,9
30001,001,30,2011,9214,-70,10,-60,95,78
30001,001,30,2012,9361,121,1,122,91,70
30001,001,30,2013,9307,-69,2,-67,87,75
30001,001,30,2014,9340,21,6,27,99,91
30001,001,30,2015,9303,-40,14,-26,87,98
30001,001,30,2016,9462,142,17,159,82,82
30001,001,30,2017,9436,-21,26,5,80,110
30001,001,30,2018,9413,-32,6,-26,84,81
30001,001,30,2019,9474,54,10,64,85,89
30001,001,30,2020,9483,25,10,35,80,105
30003,003,30,2010,12912,4,1,5,71,26
30003,003,30,2011,13058,-4,1,-3,251,102
30003,003,30,2012,12996,-212,0,-212,268,121
30003,003,30,2013,13114,2,-2,0,254,134
30003,003,30,2014,13341,9,16,25,315,112
30003,003,30,2015,13310,-216,22,-194,292,130
30003,003,30,2016,13438,6,10,16,255,142
30003,003,30,2017,13454,-130,7,-123,269,131
30003,003,30,2018,13305,-232,4,-228,218,138
30003,003,30,2019,13248,-157,10,-147,222,132
30003,003,30,2020,13063,-259,7,-252,211,143
30005,005,30,2010,6503,-3,0,-3,21,6
30005,005,30,2011,6576,30,1,31,112,70
30005,005,30,2012,6683,41,27,68,117,79
30005,005,30,2013,6638,-108,19,-89,100,58
30005,005,30,2014,6710,7,22,29,110,66
30005,005,30,2015,6683,-81,11,-70,122,80
30005,005,30,2016,6716,-23,6,-17,118,67
30005,005,30,2017,6740,-10,1,-9,107,74
30005,005,30,2018,6764,-2,1,-1,95,70
30005,005,30,2019,6704,-112,2,-110,101,51
30005,005,30,2020,6568,-171,1,-170,104,69
30007,007,30,2010,5632,16,0,16,12,6
30007,007,30,2011,5725,99,-4,95,51,54
30007,007,30,2012,5759,41,-3,38,51,55
30007,007,30,2013,5678,-74,1,-73,56,65
30007,007,30,2014,5657,-21,1,-20,49,50
30007,007,30,2015,5717,64,1,65,42,47
30007,007,30,2016,5787,79,0,79,51,59
30007,007,30,2017,5922,153,0,153,53,71
30007,007,30,2018,6043,131,0,131,54,64
30007,007,30,2019,6203,137,0,137,66,44
30007,007,30,2020,6444,243,0,243,61,61
30009,009,30,2010,10063,4,1,5,23,42
30009,009,30,2011,10089,27,-4,23,96,93
30009,009,30,2012,10142,58,12,70,82,100
30009,009,30,2013,10338,204,8,212,66,86
30009,009,30,2014,10438,99,5,104,81,88
30009,009,30,2015,10404,2,2,4,59,96
30009,009,30,2016,10480,134,2,136,64,123
30009,009,30,2017,10687,212,6,218,81,91
30009,009,30,2018,10654,-1,4,3,83,119
30009,009,30,2019,10703,41,8,49,87,87
30009,009,30,2020,10921,223,7,230,84,93
30011,011,30,2010,1159,-4,0,-4,3,0
30011,011,30,2011,1136,-19,0,-19,10,15
30011,011,30,2012,1157,31,0,31,10,20
30011,011,30,2013,1152,-8,0,-8,11,8
30011,011,30,2014,1150,-2,0,-2,16,16
30011,011,30,2015,1147,-13,0,-13,19,10
30011,011,30,2016,1175,26,0,26,13,11
30011,011,30,2017,1222,45,0,45,21,20
30011,011,30,2018,1223,7,0,7,17,21
30011,011,30,2019,1245,14,0,14,20,12
30011,011,30,2020,1235,-16,0,-16,20,15
30013,013,30,2010,81513,40,66,106,312,230
30013,013,30,2011,81734,-197,48,-149,1193,818
30013,013,30,2012,81657,-705,238,-467,1177,790
30013,013,30,2013,82241,36,171,207,1180,794
30013,013,30,2014,82118,-558,89,-469,1150,800
30013,013,30,2015,81959,-649,118,-531,1200,827
30013,013,30,2016,81655,-629,106,-523,1123,903
30013,013,30,2017,81729,-120,44,-76,1089,933
30013,013,30,2018,81756,-129,-28,-157,1070,882
30013,013,30,2019,81393,-607,50,-557,1033,839
30013,013,30,2020,81346,-266,38,-228,1028,848
30015,015,30,2010,5810,2,2,4,17,24
30015,015,30,2011,5812,-11,8,-3,45,40
30015,015,30,2012,5933,134,4,138,35,55
30015,015,30,2013,5854,-74,8,-66,50,64
30015,015,30,2014,5902,71,6,77,42,69
30015,015,30,2015,5777,-115,2,-113,55,67
30015,015,30,2016,5780,1,1,2,58,57
30015,015,30,2017,5738,-35,15,-20,52,75
30015,015,30,2018,5759,9,0,9,66,52
30015,015,30,2019,5681,-74,1,-73,46,52
30015,015,30,2020,5699,36,0,36,51,69
30017,017,30,2010,11691,0,2,2,33,42
30017,017,30,2011,11759,54,4,58,152,141
30017,017,30,2012,11804,44,1,45,137,136
30017,017,30,2013,11883,55,8,63,178,161
30017,017,30,2014,12023,108,1,109,153,122
30017,017,30,2015,12098,44,3,47,165,136
30017,017,30,2016,11844,-259,3,-256,146,145
30017,017,30,2017,11741,-112,2,-110,148,141
30017,017,30,2018,11576,-143,0,-143,119,143
30017,017,30,2019,11361,-202,4,-198,117,133
30017,017,30,2020,11292,-26,5,-21,109,157
30019,019,30,2010,1749,4,0,4,6,12
30019,019,30,2011,1760,24,1,25,17,31
30019,019,30,2012,1775,9,1,10,17,13
30019,019,30,2013,1778,-1,4,3,20,19
30019,019,30,2014,1798,23,5,28,24,32
30019,019,30,2015,1751,-41,3,-38,21,29
30019,019,30,2016,1730,-16,0,-16,15,21
30019,019,30,2017,1720,-1,0,-1,11,20
30019,019,30,2018,1706,-8,0,-8,20,27
30019,019,30,2019,1646,-59,0,-59,15,15
30019,019,30,2020,1638,-5,0,-5,15,19
30021,021,30,2010,8952,-27,0,-27,33,19
30021,021,30,2011,9030,64,-1,63,128,114
30021,021,30,2012,9238,212,-3,209,96,104
30021,021,30,2013,9392,147,4,151,108,111
30021,021,30,2014,9518,93,-4,89,127,92
30021,021,30,2015,9591,35,-1,34,132,94
30021,021,30,2016,9279,-338,1,-337,121,97
30021,021,30,2017,8966,-317,0,-317,103,101
30021,021,30,2018,8683,-262,0,-262,70,92
30021,021,30,2019,8638,-64,2,-62,95,77
30021,021,30,2020,8555,-84,2,-82,91,92
30023,023,30,2010,9291,13,0,13,25,40
30023,023,30,2011,9282,49,-1,48,70,127
30023,023,30,2012,9220,7,-2,5,69,134
30023,023,30,2013,9264,99,1,100,62,119
30023,023,30,2014,9125,-87,-2,-89,67,117
30023,023,30,2015,9115,41,-1,40,83,132
30023,023,30,2016,9071,5,4,9,76,129
30023,023,30,2017,9122,87,11,98,85,131
30023,023,30,2018,9159,99,-2,97,63,124
30023,023,30,2019,9207,81,0,81,73,106
30023,023,30,2020,9204,55,0,55,73,129
30025,025,30,2010,2889,-6,0,-6,6,2
30025,025,30,2011,2930,18,0,18,58,36
30025,025,30,2012,3025,70,0,70,50,27
30025,025,30,2013,3047,21,-1,20,41,39
30025,025,30,2014,3111,34,0,34,58,27
30025,025,30,2015,3172,38,0,38,52,29
30025,025,30,2016,3097,-96,5,-91,52,35
30025,025,30,2017,3012,-96,2,-94,38,31
30025,025,30,2018,2925,-88,1,-87,33,33
30025,025,30,2019,2878,-58,3,-55,32,24
30025,025,30,2020,2826,-53,2,-51,29,29
30027,027,30,2010,11585,7,2,9,40,52
30027,027,30,2011,11463,-82,5,-77,113,156
30027,027,30,2012,11394,-2,1,-1,105,172
30027,027,30,2013,11470,87,9,96,128,149
30027,027,30,2014,11336,-74,5,-69,106,170
30027,027,30,2015,11315,-24,4,-20,149,150
30027,027,30,2016,11333,49,12,61,110,153
30027,027,30,2017,11280,-1,9,8,121,180
30027,027,30,2018,11088,-177,7,-170,122,144
30027,027,30,2019,11032,-49,16,-33,109,131
30027,027,30,2020,11104,97,11,108,109,143
30029,029,30,2010,90863,-170,30,-140,265,189
30029,029,30,2011,91282,9,60,69,1100,746
30029,029,30,2012,91630,90,-2,88,1066,787
30029,029,30,2013,92988,995,74,1069,1100,820
30029,029,30,2014,94642,1314,-5,1309,1131,812
30029,029,30,2015,95940,1119,1,1120,1108,938
30029,029,30,2016,97901,1682,17,1699,1172,915
30029,029,30,2017,100272,1998,118,2116,1139,893
30029,029,30,2018,102100,1649,-7,1642,1109,929
30029,029,30,2019,103880,1554,44,1598,1119,934
30029,029,30,2020,105851,1842,29,1871,1114,1004
30031,031,30,2010,89662,-67,77,10,289,148
30031,031,30,2011,91413,1108,112,1220,1040,517
30031,031,30,2012,92627,539,60,599,1101,496
30031,031,30,2013,94885,1252,393,1645,1120,537
30031,031,30,2014,97629,1764,201,1965,1205,493
30031,031,30,2015,101043,2611,164,2775,1121,530
30031,031,30,2016,104999,2929,229,3158,1305,532
30031,031,30,2017,108850,2983,265,3248,1170,597
30031,031,30,2018,111878,2199,118,2317,1242,548
30031,031,30,2019,114472,1819,291,2110,1082,605
30031,031,30,2020,116806,1664,223,1887,1130,681
30033,033,30,2010,1192,-15,0,-15,3,5
30033,033,30,2011,1254,56,0,56,15,10
30033,033,30,2012,1244,-16,0,-16,14,8
30033,033,30,2013,1254,14,0,14,11,16
30033,033,30,2014,1274,21,0,21,7,9
30033,033,30,2015,1283,12,0,12,18,21
30033,033,30,2016,1295,10,0,10,16,14
30033,033,30,2017,1279,-22,0,-22,17,11
30033,033,30,2018,1262,-16,0,-16,15,15
30033,033,30,2019,1272,1,0,1,18,9
30033,033,30,2020,1268,-7,0,-7,15,12
30035,035,30,2010,13421,17,9,26,44,49
30035,035,30,2011,13579,-8,19,11,274,127
30035,035,30,2012,13671,1,5,6,236,148
30035,035,30,2013,13793,-24,25,1,254,131
30035,035,30,2014,13711,-204,9,-195,256,146
30035,035,30,2015,13647,-197,7,-190,249,126
30035,035,30,2016,13707,-34,8,-26,227,141
30035,035,30,2017,13729,-108,55,-53,234,158
30035,035,30,2018,13797,0,2,2,230,163
30035,035,30,2019,13701,-187,9,-178,224,142
30035,035,30,2020,13594,-167,5,-162,206,152
30037,037,30,2010,879,0,0,0,0,5
30037,037,30,2011,830,-46,0,-46,6,10
30037,037,30,2012,827,0,0,0,7,9
30037,037,30,2013,846,23,0,23,9,13
30037,037,30,2014,841,-2,0,-2,6,8
30037,037,30,2015,818,-23,0,-23,8,9
30037,037,30,2016,811,-7,0,-7,9,10
30037,037,30,2017,817,6,0,6,9,9
30037,037,30,2018,825,8,0,8,8,8
30037,037,30,2019,827,1,0,1,5,3
30037,037,30,2020,827,-3,0,-3,5,2
30039,039,30,2010,3073,8,0,8,3,9
30039,039,30,2011,3077,11,2,13,25,35
30039,039,30,2012,3040,-24,1,-23,19,33
30039,039,30,2013,3067,38,7,45,15,34
30039,039,30,2014,3144,90,2,92,17,33
30039,039,30,2015,3160,25,1,26,25,33
30039,039,30,2016,3276,129,1,130,16,32
30039,039,30,2017,3343,77,0,77,21,32
30039,039,30,2018,3355,29,0,29,18,35
30039,039,30,2019,3335,-4,0,-4,15,32
30039,039,30,2020,3317,0,1,1,16,35
30041,041,30,2010,16151,11,9,20,73,35
30041,041,30,2011,16391,105,13,118,267,145
30041,041,30,2012,16395,-169,13,-156,302,142
30041,041,30,2013,16534,-7,13,6,303,167
30041,041,30,2014,16500,-219,6,-213,301,126
30041,041,30,2015,16435,-223,5,-218,315,164
30041,041,30,2016,16440,-141,16,-125,296,164
30041,041,30,2017,16468,-142,11,-131,311,152
30041,041,30,2018,16351,-287,10,-277,298,138
30041,041,30,2019,16494,19,20,39,282,178
30041,041,30,2020,16358,-262,16,-246,288,176
30043,043,30,2010,11406,12,3,15,21,32
30043,043,30,2011,11373,-35,6,-29,85,89
30043,043,30,2012,11319,-35,5,-30,74,98
30043,043,30,2013,11457,120,26,146,103,110
30043,043,30,2014,11505,63,8,71,83,103
30043,043,30,2015,11576,100,3,103,83,115
30043,043,30,2016,11774,196,3,199,86,86
30043,043,30,2017,11918,140,-1,139,100,96
30043,043,30,2018,12084,191,-1,190,86,109
30043,043,30,2019,12211,152,0,152,89,112
30043,043,30,2020,12360,221,0,221,82,152
30045,045,30,2010,2075,-2,0,-2,7,2
30045,045,30,2011,2011,-52,0,-52,16,27
30045,045,30,2012,2006,4,0,4,15,24
30045,045,30,2013,2002,-2,0,-2,15,18
30045,045,30,2014,1985,-7,1,-6,16,27
30045,045,30,2015,1932,-52,1,-51,11,14
30045,045,30,2016,1944,8,1,9,19,16
30045,045,30,2017,1944,4,0,4,12,15
30045,045,30,2018,1950,5,0,5,18,16
30045,045,30,2019,2010,58,0,58,19,17
30045,045,30,2020,1994,-15,0,-15,19,19
30047,047,30,2010,28792,9,4,13,82,49
30047,047,30,2011,28983,101,13,114,353,273
30047,047,30,2012,29021,-135,29,-106,385,240
30047,047,30,2013,29138,-80,110,30,389,299
30047,047,30,2014,29236,-4,42,38,349,285
30047,047,30,2015,29482,171,-1,170,379,300
30047,047,30,2016,29722,210,10,220,334,313
30047,047,30,2017,30277,474,29,503,367,318
30047,047,30,2018,30346,48,11,59,320,308
30047,047,30,2019,30586,242,26,268,291,316
30047,047,30,2020,30986,455,19,474,299,370
30049,049,30,2010,63578,134,18,152,201,174
30049,049,30,2011,64284,432,48,480,757,534
30049,049,30,2012,64760,260,29,289,729,544
30049,049,30,2013,65277,185,112,297,754,526
30049,049,30,2014,65764,286,13,299,770,574
30049,049,30,2015,66308,357,3,360,778,593
30049,049,30,2016,67001,462,17,479,794,577
30049,049,30,2017,67988,814,23,837,777,631
30049,049,30,2018,68775,638,13,651,754,619
30049,049,30,2019,69578,697,45,742,731,668
30049,049,30,2020,70229,596,42,638,727,711
30051,051,30,2010,2349,8,3,11,6,7
30051,051,30,2011,2381,25,4,29,26,24
30051,051,30,2012,2396,22,2,24,19,28
30051,051,30,2013,2364,-36,0,-36,25,21
30051,051,30,2014,2351,-11,0,-11,22,25
30051,051,30,2015,2395,45,0,45,22,24
30051,051,30,2016,2413,19,0,19,27,27
30051,051,30,2017,2415,-13,0,-13,25,11
30051,051,30,2018,2440,20,0,20,23,17
30051,051,30,2019,2386,-68,0,-68,29,15
30051,051,30,2020,2369,-19,0,-19,26,24
30053,053,30,2010,19693,-3,5,2,46,32
30053,053,30,2011,19629,-17,6,-11,171,224
30053,053,30,2012,19494,-83,1,-82,194,244
30053,053,30,2013,19437,-17,11,-6,186,235
30053,053,30,2014,19208,-178,9,-169,174,236
30053,053,30,2015,19085,-40,16,-24,166,262
30053,053,30,2016,19332,301,24,325,171,250
30053,053,30,2017,19589,303,21,324,169,235
30053,053,30,2018,19862,326,12,338,173,238
30053,053,30,2019,20099,316,37,353,166,281
30053,053,30,2020,20343,352,29,381,176,311
30055,055,30,2010,1745,6,0,6,5,1
30055,055,30,2011,1709,-25,0,-25,13,22
30055,055,30,2012,1700,4,0,4,8,21
30055,055,30,2013,1714,10,0,10,15,12
30055,055,30,2014,1713,11,0,11,16,26
30055,055,30,2015,1698,-21,0,-21,21,15
30055,055,30,2016,1729,31,0,31,19,19
30055,055,30,2017,1695,-26,0,-26,20,26
30055,055,30,2018,1655,-35,0,-35,16,22
30055,055,30,2019,1649,-10,0,-10,14,10
30055,055,30,2020,1648,3,0,3,14,18
30057,057,30,2010,7696,1,0,1,12,8
30057,057,30,2011,7644,-36,2,-34,67,83
30057,057,30,2012,7664,35,-1,34,57,71
30057,057,30,2013,7679,17,12,29,64,78
30057,057,30,2014,7832,122,51,173,50,72
30057,057,30,2015,8033,134,63,197,59,56
30057,057,30,2016,8074,59,14,73,59,90
30057,057,30,2017,8280,213,22,235,68,99
30057,057,30,2018,8586,298,12,310,69,73
30057,057,30,2019,8749,129,27,156,71,65
30057,057,30,2020,8959,194,21,215,78,82
30059,059,30,2010,1878,-3,-1,-4,3,11
30059,059,30,2011,1878,4,2,6,25,31
30059,059,30,2012,1887,9,1,10,22,24
30059,059,30,2013,1905,24,2,26,20,28
30059,059,30,2014,1857,-35,1,-34,16,30
30059,059,30,2015,1822,-21,0,-21,17,31
30059,059,30,2016,1851,18,3,21,26,18
30059,059,30,2017,1856,9,3,12,14,21
30059,059,30,2018,1847,0,1,1,15,24
30059,059,30,2019,1841,-9,4,-5,20,19
30059,059,30,2020,1831,-10,3,-7,19,23
30061,061,30,2010,4230,0,0,0,16,16
30061,061,30,2011,4221,-5,0,-5,45,49
30061,061,30,2012,4130,-97,-1,-98,49,45
30061,061,30,2013,4230,105,0,105,44,49
30061,061,30,2014,4196,-13,-1,-14,39,57
30061,061,30,2015,4194,9,-2,7,44,54
30061,061,30,2016,4129,-51,-2,-53,46,58
30061,061,30,2017,4240,140,-1,139,35,62
30061,061,30,2018,4314,77,-1,76,43,46
30061,061,30,2019,4422,114,-1,113,41,45
30061,061,30,2020,4544,140,-1,139,43,58
30063,063,30,2010,109471,23,51,74,321,214
30063,063,30,2011,110270,292,110,402,1201,803
30063,063,30,2012,111104,331,52,383,1215,759
30063,063,30,2013,111988,122,384,506,1222,826
30063,063,30,2014,112924,406,126,532,1258,841
30063,063,30,2015,114281,851,122,973,1243,864
30063,063,30,2016,116587,1653,258,1911,1256,869
30063,063,30,2017,118068,1084,176,1260,1191,980
30063,063,30,2018,118959,567,124,691,1070,872
30063,063,30,2019,120066,649,304,953,1058,908
30063,063,30,2020,121630,1242,237,1479,1057,973
30065,065,30,2010,4555,12,0,12,10,4
30065,065,30,2011,4747,200,5,205,48,63
30065,065,30,2012,4693,-36,0,-36,42,60
30065,065,30,2013,4684,-22,26,4,37,50
30065,065,30,2014,4647,-25,7,-18,36,53
30065,065,30,2015,4631,-22,6,-16,46,47
30065,065,30,2016,4640,24,1,25,38,53
30065,065,30,2017,4623,7,0,7,39,62
30065,065,30,2018,4623,24,0,24,46,70
30065,065,30,2019,4626,30,0,30,46,73
30065,065,30,2020,4669,71,0,71,45,73
30067,067,30,2010,15595,-42,5,-37,34,39
30067,067,30,2011,15512,-103,2,-101,160,140
30067,067,30,2012,15597,102,0,102,130,150
30067,067,30,2013,15705,89,10,99,144,133
30067,067,30,2014,15926,211,13,224,150,156
30067,067,30,2015,16013,90,25,115,140,167
30067,067,30,2016,16138,118,5,123,151,149
30067,067,30,2017,16392,263,5,268,141,157
30067,067,30,2018,16662,253,0,253,162,147
30067,067,30,2019,16612,-57,4,-53,156,154
30067,067,30,2020,16760,169,4,173,157,181
30069,069,30,2010,489,3,0,3,1,3
30069,069,30,2011,491,0,0,0,3,1
30069,069,30,2012,505,16,0,16,4,6
30069,069,30,2013,505,1,0,1,4,5
30069,069,30,2014,489,-16,0,-16,3,3
30069,069,30,2015,475,-14,0,-14,3,3
30069,069,30,2016,491,20,0,20,0,3
30069,069,30,2017,512,24,0,24,2,5
30069,069,30,2018,517,4,0,4,2,2
30069,069,30,2019,497,-18,0,-18,2,3
30069,069,30,2020,500,7,0,7,2,6
30071,071,30,2010,4252,6,0,6,6,11
30071,071,30,2011,4186,-45,-1,-46,46,65
30071,071,30,2012,4123,-67,12,-55,44,54
30071,071,30,2013,4163,54,0,54,46,61
30071,071,30,2014,4174,12,-1,11,63,63
30071,071,30,2015,4150,-40,0,-40,63,48
30071,071,30,2016,4121,-48,0,-48,60,42
30071,071,30,2017,4117,-12,0,-12,49,41
30071,071,30,2018,4047,-53,0,-53,44,60
30071,071,30,2019,3955,-94,0,-94,48,46
30071,071,30,2020,3919,-34,0,-34,44,45
30073,073,30,2010,6161,1,6,7,15,15
30073,073,30,2011,6195,12,9,21,78,66
30073,073,30,2012,6152,-52,5,-47,72,69
30073,073,30,2013,6218,48,21,69,70,73
30073,073,30,2014,6140,-74,4,-70,67,75
30073,073,30,2015,6100,-72,7,-65,85,61
30073,073,30,2016,6024,-77,7,-70,73,78
30073,073,30,2017,5954,-87,5,-82,87,75
30073,073,30,2018,5936,-24,3,-21,71,68
30073,073,30,2019,5858,-75,10,-65,63,76
30073,073,30,2020,5782,-77,8,-69,55,61
30075,075,30,2010,1739,-3,0,-3,4,6
30075,075,30,2011,1739,20,0,20,6,26
30075,075,30,2012,1754,28,0,28,12,24
30075,075,30,2013,1754,12,0,12,9,21
30075,075,30,2014,1777,28,0,28,10,16
30075,075,30,2015,1768,-6,0,-6,17,20
30075,075,30,2016,1747,-18,0,-18,19,22
30075,075,30,2017,1748,-4,4,0,21,20
30075,075,30,2018,1729,-24,0,-24,18,13
30075,075,30,2019,1688,-41,0,-41,18,19
30075,075,30,2020,1681,-9,0,-9,18,16
30077,077,30,2010,7019,-1,0,-1,14,27
30077,077,30,2011,7084,82,0,82,56,74
30077,077,30,2012,7078,3,0,3,62,69
30077,077,30,2013,6953,-88,0,-88,42,81
30077,077,30,2014,6876,-50,0,-50,44,71
30077,077,30,2015,6793,-62,0,-62,55,76
30077,077,30,2016,6837,69,2,71,58,86
30077,077,30,2017,6785,-23,7,-16,49,84
30077,077,30,2018,6920,148,1,149,62,78
30077,077,30,2019,6854,-52,2,-50,53,67
30077,077,30,2020,6817,2,1,3,52,91
30079,079,30,2010,1183,10,0,10,2,9
30079,079,30,2011,1141,-37,2,-35,10,18
30079,079,30,2012,1141,-2,2,0,16,16
30079,079,30,2013,1163,30,2,32,11,22
30079,079,30,2014,1125,-35,2,-33,12,18
30079,079,30,2015,1140,15,0,15,16,16
30079,079,30,2016,1159,30,0,30,12,23
30079,079,30,2017,1097,-57,0,-57,11,17
30079,079,30,2018,1056,-32,0,-32,16,24
30079,079,30,2019,1064,2,0,2,17,10
30079,079,30,2020,1067,-7,0,-7,19,9
30081,081,30,2010,40323,100,19,119,116,123
30081,081,30,2011,40387,59,35,94,376,403
30081,081,30,2012,40596,206,12,218,378,384
30081,081,30,2013,40698,143,11,154,377,426
30081,081,30,2014,40786,164,-9,155,385,446
30081,081,30,2015,41199,438,-14,424,396,410
30081,081,30,2016,41975,825,-2,823,385,432
30081,081,30,2017,42617,762,13,775,382,516
30081,081,30,2018,43377,771,9,780,392,412
30081,081,30,2019,44149,850,35,885,389,498
30081,081,30,2020,45002,967,28,995,393,529
30083,083,30,2010,9760,0,1,1,31,17
30083,083,30,2011,10151,342,-2,340,131,83
30083,083,30,2012,10791,590,-5,585,143,114
30083,083,30,2013,11173,319,-7,312,154,94
30083,083,30,2014,11555,299,-12,287,186,100
30083,083,30,2015,11931,281,0,281,174,83
30083,083,30,2016,11442,-565,-6,-571,165,87
30083,083,30,2017,11101,-431,30,-401,150,91
30083,083,30,2018,10955,-184,-3,-187,133,94
30083,083,30,2019,10943,-75,-3,-78,160,93
30083,083,30,2020,11043,36,-2,34,152,85
30085,085,30,2010,10444,-2,1,-1,59,39
30085,085,30,2011,10496,-29,0,-29,196,114
30085,085,30,2012,10854,240,0,240,223,111
30085,085,30,2013,11087,122,0,122,232,127
30085,085,30,2014,11283,107,2,109,241,155
30085,085,30,2015,11416,46,4,50,257,173
30085,085,30,2016,11223,-318,7,-311,245,128
30085,085,30,2017,11156,-187,6,-181,249,137
30085,085,30,2018,11084,-177,6,-171,208,109
30085,085,30,2019,11027,-129,11,-118,194,132
30085,085,30,2020,10964,-97,8,-89,205,179
30087,087,30,2010,9245,-4,2,-2,41,32
30087,087,30,2011,9328,27,1,28,138,82
30087,087,30,2012,9349,-85,-1,-86,167,63
30087,087,30,2013,9303,-148,17,-131,181,100
30087,087,30,2014,9327,-76,7,-69,174,81
30087,087,30,2015,9355,-39,9,-30,149,90
30087,087,30,2016,9263,-183,10,-173,173,93
30087,087,30,2017,9225,-85,10,-75,134,98
30087,087,30,2018,9047,-251,9,-242,143,79
30087,087,30,2019,8955,-148,16,-132,122,84
30087,087,30,2020,8836,-140,11,-129,118,107
30089,089,30,2010,11395,-26,3,-23,25,19
30089,089,30,2011,11402,45,10,55,84,132
30089,089,30,2012,11379,10,6,16,88,124
30089,089,30,2013,11314,-37,1,-36,109,138
30089,089,30,2014,11316,45,-5,40,114,151
30089,089,30,2015,11298,6,-3,3,128,147
30089,089,30,2016,11472,208,1,209,113,149
30089,089,30,2017,11702,258,1,259,126,155
30089,089,30,2018,11744,102,1,103,99,158
30089,089,30,2019,11946,233,2,235,96,128
30089,089,30,2020,12157,262,1,263,98,148
30091,091,30,2010,3368,1,0,1,4,21
30091,091,30,2011,3418,83,0,83,32,66
30091,091,30,2012,3549,134,0,134,38,46
30091,091,30,2013,3626,90,1,91,41,58
30091,091,30,2014,3661,50,10,60,38,65
30091,091,30,2015,3673,1,13,14,51,53
30091,091,30,2016,3609,-54,0,-54,45,54
30091,091,30,2017,3461,-133,0,-133,37,55
30091,091,30,2018,3379,-83,0,-83,40,37
30091,091,30,2019,3318,-63,1,-62,37,37
30091,091,30,2020,3261,-44,0,-44,37,50
30093,093,30,2010,34235,25,30,55,94,122
30093,093,30,2011,34420,140,47,187,397,401
30093,093,30,2012,34496,37,16,53,426,394
30093,093,30,2013,34610,-40,173,133,390,402
30093,093,30,2014,34801,120,109,229,380,416
30093,093,30,2015,34746,-160,97,-63,405,396
30093,093,30,2016,34768,-56,96,40,406,423
30093,093,30,2017,34859,88,46,134,388,428
30093,093,30,2018,34768,-82,36,-46,382,429
30093,093,30,2019,34901,129,79,208,340,414
30093,093,30,2020,35180,301,59,360,369,448
30095,095,30,2010,9112,-2,0,-2,31,11
30095,095,30,2011,9153,45,0,45,79,84
30095,095,30,2012,9161,10,0,10,79,81
30095,095,30,2013,9250,75,22,97,83,91
30095,095,30,2014,9230,-35,14,-21,92,91
30095,095,30,2015,9419,184,14,198,87,96
30095,095,30,2016,9349,-53,12,-41,71,101
30095,095,30,2017,9408,50,6,56,87,83
30095,095,30,2018,9496,83,5,88,89,88
30095,095,30,2019,9671,164,10,174,77,75
30095,095,30,2020,9888,207,8,215,92,89
30097,097,30,2010,3617,-35,0,-35,13,14
30097,097,30,2011,3584,-9,0,-9,27,50
30097,097,30,2012,3579,5,0,5,25,34
30097,097,30,2013,3657,78,6,84,39,47
30097,097,30,2014,3637,2,3,5,25,49
30097,097,30,2015,3618,-11,2,-9,31,40
30097,097,30,2016,3610,3,1,4,33,44
30097,097,30,2017,3668,59,0,59,35,36
30097,097,30,2018,3701,30,0,30,28,25
30097,097,30,2019,3717,22,0,22,30,35
30097,097,30,2020,3684,-20,0,-20,27,40
30099,099,30,2010,6074,8,4,12,16,24
30099,099,30,2011,6060,-26,5,-21,72,65
30099,099,30,2012,6058,-18,0,-18,75,61
30099,099,30,2013,6053,-29,18,-11,79,73
30099,099,30,2014,6035,-44,5,-39,80,59
30099,099,30,2015,6064,18,2,20,77,67
30099,099,30,2016,6017,-71,12,-59,81,70
30099,099,30,2017,6100,56,9,65,86,67
30099,099,30,2018,6121,-12,9,-3,76,52
30099,099,30,2019,6150,7,17,24,76,69
30099,099,30,2020,6249,82,13,95,73,70
30101,101,30,2010,5343,8,0,8,16,5
30101,101,30,2011,5157,-194,-2,-196,66,57
30101,101,30,2012,5218,50,-1,49,55,45
30101,101,30,2013,5125,-99,3,-96,40,41
30101,101,30,2014,5121,-8,-1,-9,60,54
30101,101,30,2015,5083,-45,-2,-47,58,48
30101,101,30,2016,4962,-128,1,-127,61,55
30101,101,30,2017,4872,-96,0,-96,50,46
30101,101,30,2018,4830,-54,0,-54,69,57
30101,101,30,2019,4709,-126,1,-125,57,52
30101,101,30,2020,4686,-28,0,-28,55,50
30103,103,30,2010,714,1,0,1,2,3
30103,103,30,2011,709,-5,0,-5,7,6
30103,103,30,2012,717,10,0,10,6,9
30103,103,30,2013,688,-31,0,-31,7,5
30103,103,30,2014,684,1,0,1,8,14
30103,103,30,2015,680,-4,0,-4,8,8
30103,103,30,2016,678,-2,0,-2,14,14
30103,103,30,2017,668,-10,0,-10,12,11
30103,103,30,2018,667,-5,0,-5,12,8
30103,103,30,2019,697,20,0,20,15,5
30103,103,30,2020,695,-16,0,-16,18,3
30105,105,30,2010,7378,3,1,4,18,11
30105,105,30,2011,7463,88,4,92,82,89
30105,105,30,2012,7506,48,0,48,69,73
30105,105,30,2013,7636,112,16,128,101,101
30105,105,30,2014,7636,7,6,13,83,95
30105,105,30,2015,7630,-16,4,-12,83,77
30105,105,30,2016,7548,-101,4,-97,96,81
30105,105,30,2017,7413,-133,3,-130,85,92
30105,105,30,2018,7409,-13,3,-10,98,91
30105,105,30,2019,7390,-34,5,-29,77,66
30105,105,30,2020,7359,-60,3,-57,88,62
30107,107,30,2010,2156,-7,0,-7,4,9
30107,107,30,2011,2131,-30,0,-30,23,19
30107,107,30,2012,2089,-40,0,-40,25,29
30107,107,30,2013,2121,29,0,29,21,18
30107,107,30,2014,2089,-43,9,-34,25,25
30107,107,30,2015,2110,0,20,20,24,21
30107,107,30,2016,2123,18,0,18,20,25
30107,107,30,2017,2143,20,0,20,30,29
30107,107,30,2018,2163,26,0,26,30,36
30107,107,30,2019,2102,-66,0,-66,26,21
30107,107,30,2020,2157,57,0,57,22,23
30109,109,30,2010,1008,-8,0,-8,0,1
30109,109,30,2011,982,-16,0,-16,8,19
30109,109,30,2012,1034,60,0,60,7,16
30109,109,30,2013,1101,63,0,63,14,11
30109,109,30,2014,1084,-19,0,-19,14,13
30109,109,30,2015,1071,-9,0,-9,17,22
30109,109,30,2016,1043,-21,0,-21,13,21
30109,109,30,2017,1019,-23,0,-23,11,11
30109,109,30,2018,1029,13,0,13,12,15
30109,109,30,2019,954,-68,-1,-69,6,12
30109,109,30,2020,939,-13,0,-13,6,7
30111,111,30,2010,148405,233,29,262,493,350
30111,111,30,2011,149805,747,37,784,1983,1364
30111,111,30,2012,151690,1181,18,1199,2013,1334
30111,111,30,2013,153857,1493,141,1634,1977,1463
30111,111,30,2014,155379,864,41,905,1975,1348
30111,111,30,2015,156658,607,53,660,2066,1436
30111,111,30,2016,158066,834,109,943,2005,1534
30111,111,30,2017,159425,818,117,935,1918,1487
30111,111,30,2018,160118,395,69,464,1810,1578
30111,111,30,2019,161349,831,176,1007,1825,1603
30111,111,30,2020,162990,1319,141,1460,1790,1609
31001,001,31,2010,31328,-38,1,-37,102,104
31001,001,31,2011,31207,-225,-2,-227,398,292
31001,001,31,2012,31351,39,0,39,401,289
31001,001,31,2013,31536,52,2,54,411,275
31001,001,31,2014,31400,-291,43,-248,412,304
31001,001,31,2015,31576,63,43,106,406,332
31001,001,31,2016,31723,-39,90,51,429,331
31001,001,31,2017,31837,-73,107,34,388,307
31001,001,31,2018,31513,-478,75,-403,413,336
31001,001,31,2019,31309,-349,65,-284,387,308
31001,001,31,2020,31321,-102,54,-48,391,330
31003,003,31,2010,6679,-29,0,-29,30,9
31003,003,31,2011,6621,-52,1,-51,74,80
31003,003,31,2012,6551,-79,2,-77,74,69
31003,003,31,2013,6473,-85,4,-81,85,84
31003,003,31,2014,6421,-81,1,-80,93,66
31003,003,31,2015,6416,-10,4,-6,78,75
31003,003,31,2016,6347,-71,4,-67,84,86
31003,003,31,2017,6343,-9,8,-1,88,89
31003,003,31,2018,6305,-50,2,-48,79,71
31003,003,31,2019,6317,-27,6,-21,84,50
31003,003,31,2020,6264,-83,3,-80,82,54
31005,005,31,2010,465,3,0,3,2,0
31005,005,31,2011,468,1,0,1,6,4
31005,005,31,2012,479,9,0,9,5,2
31005,005,31,2013,454,-23,0,-23,4,6
31005,005,31,2014,451,0,0,0,3,5
31005,005,31,2015,451,2,0,2,3,6
31005,005,31,2016,467,15,1,16,4,6
31005,005,31,2017,456,-11,0,-11,5,3
31005,005,31,2018,463,8,0,8,2,4
31005,005,31,2019,468,5,0,5,5,3
31005,005,31,2020,466,-8,0,-8,6,1
31007,007,31,2010,695,-1,1,0,1,1
31007,007,31,2011,659,-35,2,-33,4,6
31007,007,31,2012,688,21,2,23,8,2
31007,007,31,2013,682,-13,2,-11,4,0
31007,007,31,2014,673,-9,4,-5,6,10
31007,007,31,2015,715,44,0,44,4,6
31007,007,31,2016,722,-2,0,-2,11,3
31007,007,31,2017,732,8,1,9,6,6
31007,007,31,2018,728,-12,1,-11,9,2
31007,007,31,2019,757,22,1,23,7,1
31007,007,31,2020,786,20,1,21,9,1
31009,009,31,2010,478,0,0,0,0,0
31009,009,31,2011,475,-8,0,-8,8,3
31009,009,31,2012,498,24,0,24,5,8
31009,009,31,2013,469,-26,0,-26,4,7
31009,009,31,2014,489,19,0,19,3,2
31009,009,31,2015,476,-15,0,-15,6,5
31009,009,31,2016,468,-14,0,-14,9,2
31009,009,31,2017,479,10,0,10,5,3
31009,009,31,2018,475,-10,0,-10,7,2
31009,009,31,2019,455,-19,0,-19,6,6
31009,009,31,2020,457,4,0,4,6,9
31011,011,31,2010,5511,-6,0,-6,18,7
31011,011,31,2011,5406,-93,1,-92,57,70
31011,011,31,2012,5428,35,0,35,49,61
31011,011,31,2013,5396,-49,2,-47,77,62
31011,011,31,2014,5355,-25,1,-24,54,71
31011,011,31,2015,5308,-43,0,-43,68,73
31011,011,31,2016,5341,26,1,27,75,69
31011,011,31,2017,5317,-10,2,-8,56,71
31011,011,31,2018,5211,-103,1,-102,56,60
31011,011,31,2019,5176,-50,2,-48,70,56
31011,011,31,2020,5096,-86,2,-84,70,64
31013,013,31,2010,11277,-44,1,-43,26,18
31013,013,31,2011,11298,1,-2,-1,140,119
31013,013,31,2012,11270,-38,3,-35,135,126
31013,013,31,2013,11302,-32,7,-25,179,123
31013,013,31,2014,11303,-39,6,-33,149,114
31013,013,31,2015,11327,-53,6,-47,181,109
31013,013,31,2016,11168,-189,10,-179,149,129
31013,013,31,2017,10842,-368,9,-359,142,111
31013,013,31,2018,10735,-120,8,-112,138,133
31013,013,31,2019,10786,25,4,29,125,103
31013,013,31,2020,10696,-112,4,-108,129,109
31015,015,31,2010,2106,9,0,9,5,6
31015,015,31,2011,2080,-27,0,-27,21,21
31015,015,31,2012,2061,-8,1,-7,24,34
31015,015,31,2013,2017,-26,1,-25,15,35
31015,015,31,2014,2020,22,0,22,13,31
31015,015,31,2015,2004,1,2,3,16,36
31015,015,31,2016,1980,-12,2,-10,21,34
31015,015,31,2017,1956,1,2,3,13,41
31015,015,31,2018,1946,-5,0,-5,22,27
31015,015,31,2019,1894,-30,-1,-31,9,28
31015,015,31,2020,1860,-19,1,-18,12,28
31017,017,31,2010,3155,12,0,12,11,10
31017,017,31,2011,3099,-39,0,-39,29,47
31017,017,31,2012,3054,-39,0,-39,28,35
31017,017,31,2013,2960,-73,0,-73,27,50
31017,017,31,2014,2976,26,0,26,28,38
31017,017,31,2015,2985,30,0,30,25,46
31017,017,31,2016,2981,-3,1,-2,28,30
31017,017,31,2017,3006,34,3,37,30,40
31017,017,31,2018,2963,-30,2,-28,28,45
31017,017,31,2019,2966,-6,3,-3,31,23
31017,017,31,2020,2981,12,3,15,33,33
31019,019,31,2010,46176,-36,19,-17,162,66
31019,019,31,2011,46826,247,96,343,665,359
31019,019,31,2012,47642,312,121,433,680,299
31019,019,31,2013,48013,-88,118,30,690,344
31019,019,31,2014,48220,-324,150,-174,739,358
31019,019,31,2015,48605,-28,63,35,722,368
31019,019,31,2016,49171,91,79,170,739,340
31019,019,31,2017,49400,-167,75,-92,682,357
31019,019,31,2018,49461,-260,51,-209,646,378
31019,019,31,2019,49823,79,34,113,611,363
31019,019,31,2020,50114,66,26,92,609,413
31021,021,31,2010,6841,-9,0,-9,23,31
31021,021,31,2011,6782,-14,1,-13,59,105
31021,021,31,2012,6683,-101,1,-100,88,90
31021,021,31,2013,6572,-73,1,-72,59,100
31021,021,31,2014,6548,7,1,8,68,100
31021,021,31,2015,6540,8,1,9,76,92
31021,021,31,2016,6526,31,0,31,58,103
31021,021,31,2017,6529,9,0,9,79,84
31021,021,31,2018,6482,3,0,3,56,104
31021,021,31,2019,6494,16,0,16,73,78
31021,021,31,2020,6477,21,0,21,63,100
31023,023,31,2010,8374,-1,0,-1,19,39
31023,023,31,2011,8255,-114,1,-113,91,96
31023,023,31,2012,8250,-5,1,-4,98,98
31023,023,31,2013,8228,-8,2,-6,84,101
31023,023,31,2014,8175,-67,3,-64,104,94
31023,023,31,2015,8053,-102,1,-101,84,106
31023,023,31,2016,7985,-37,2,-35,77,110
31023,023,31,2017,8028,54,1,55,87,98
31023,023,31,2018,8022,21,1,22,88,115
31023,023,31,2019,7990,-36,1,-35,106,102
31023,023,31,2020,7960,-31,1,-30,100,99
31025,025,31,2010,25239,21,2,23,71,94
31025,025,31,2011,25237,-99,8,-91,313,224
31025,025,31,2012,25125,-162,4,-158,259,217
31025,025,31,2013,25292,107,0,107,283,220
31025,025,31,2014,25401,63,5,68,294,248
31025,025,31,2015,25419,-25,4,-21,300,259
31025,025,31,2016,25629,172,8,180,261,230
31025,025,31,2017,25927,256,11,267,267,234
31025,025,31,2018,26137,185,5,190,262,240
31025,025,31,2019,26186,-4,9,5,263,219
31025,025,31,2020,26232,31,7,38,251,243
31027,027,31,2010,8819,-22,0,-22,25,36
31027,027,31,2011,8751,-69,0,-69,98,98
31027,027,31,2012,8699,-55,0,-55,109,106
31027,027,31,2013,8628,-72,0,-72,92,92
31027,027,31,2014,8546,-99,0,-99,103,87
31027,027,31,2015,8523,-38,2,-36,131,120
31027,027,31,2016,8600,74,4,78,96,97
31027,027,31,2017,8523,-82,2,-80,111,107
31027,027,31,2018,8459,-74,2,-72,105,97
31027,027,31,2019,8420,-52,1,-51,112,102
31027,027,31,2020,8414,-16,1,-15,112,101
31029,029,31,2010,3966,8,0,8,13,20
31029,029,31,2011,3986,24,-3,21,54,55
31029,029,31,2012,4019,33,-1,32,43,42
31029,029,31,2013,3984,-54,18,-36,46,45
31029,029,31,2014,3984,18,1,19,37,54
31029,029,31,2015,3966,-15,8,-7,49,61
31029,029,31,2016,3910,-64,10,-54,47,48
31029,029,31,2017,3922,-7,15,8,57,53
31029,029,31,2018,3904,-11,3,-8,46,55
31029,029,31,2019,3901,-18,10,-8,50,44
31029,029,31,2020,3840,-63,8,-55,49,56
31031,031,31,2010,5694,-2,0,-2,7,24
31031,031,31,2011,5732,23,0,23,72,56
31031,031,31,2012,5735,-1,-2,-3,66,62
31031,031,31,2013,5759,13,-1,12,71,57
31031,031,31,2014,5749,-26,1,-25,68,53
31031,031,31,2015,5831,64,0,64,91,73
31031,031,31,2016,5847,-10,10,0,75,60
31031,031,31,2017,5818,-31,8,-23,72,77
31031,031,31,2018,5801,-40,7,-33,81,65
31031,031,31,2019,5757,-74,6,-68,78,52
31031,031,31,2020,5781,0,5,5,76,57
31033,033,31,2010,9969,-28,2,-26,33,37
31033,033,31,2011,9993,-26,3,-23,133,87
31033,033,31,2012,10076,56,-1,55,120,91
31033,033,31,2013,10075,-37,-1,-38,127,90
31033,033,31,2014,10124,24,-3,21,134,107
31033,033,31,2015,10150,1,-2,-1,117,90
31033,033,31,2016,10069,-119,8,-111,129,99
31033,033,31,2017,9654,-436,5,-431,118,105
31033,033,31,2018,9295,-369,3,-366,110,105
31033,033,31,2019,9011,-310,1,-309,109,83
31033,033,31,2020,9111,78,2,80,106,85
31035,035,31,2010,6537,3,0,3,21,25
31035,035,31,2011,6455,-77,0,-77,78,83
31035,035,31,2012,6385,-71,0,-71,67,69
31035,035,31,2013,6360,-32,0,-32,76,67
31035,035,31,2014,6316,-53,0,-53,73,66
31035,035,31,2015,6289,-36,0,-36,91,80
31035,035,31,2016,6134,-169,1,-168,83,71
31035,035,31,2017,6190,38,2,40,81,66
31035,035,31,2018,6208,5,2,7,80,68
31035,035,31,2019,6219,-4,1,-3,75,61
31035,035,31,2020,6216,-6,1,-5,76,73
31037,037,31,2010,10541,-10,1,-9,43,7
31037,037,31,2011,10563,-86,7,-79,181,80
31037,037,31,2012,10550,-128,29,-99,168,86
31037,037,31,2013,10451,-248,79,-169,164,100
31037,037,31,2014,10662,7,108,115,184,86
31037,037,31,2015,10713,-179,120,-59,189,82
31037,037,31,2016,10726,-300,186,-114,211,84
31037,037,31,2017,10700,-318,163,-155,196,69
31037,037,31,2018,10714,-219,103,-116,201,70
31037,037,31,2019,10677,-266,104,-162,191,67
31037,037,31,2020,10587,-288,84,-204,190,74
31039,039,31,2010,9161,-2,5,3,32,13
31039,039,31,2011,9117,-32,0,-32,101,111
31039,039,31,2012,9084,-68,14,-54,115,96
31039,039,31,2013,9011,-83,18,-65,106,116
31039,039,31,2014,9018,-13,6,-7,112,98
31039,039,31,2015,9074,26,-3,23,129,96
31039,039,31,2016,8939,-145,-1,-146,96,85
31039,039,31,2017,8940,-5,-5,-10,111,98
31039,039,31,2018,8913,-42,-6,-48,111,90
31039,039,31,2019,8818,-103,-10,-113,119,100
31039,039,31,2020,8798,-25,-2,-27,116,110
31041,041,31,2010,10905,-24,0,-24,29,39
31041,041,31,2011,10905,53,-1,52,107,157
31041,041,31,2012,10846,-47,-2,-49,122,132
31041,041,31,2013,10830,6,-2,4,118,136
31041,041,31,2014,10772,-66,-4,-70,137,126
31041,041,31,2015,10831,48,-2,46,137,124
31041,041,31,2016,10828,-13,-1,-14,138,126
31041,041,31,2017,10873,42,-1,41,142,138
31041,041,31,2018,10818,-33,-2,-35,124,143
31041,041,31,2019,10796,-53,-1,-54,123,91
31041,041,31,2020,10626,-180,1,-179,125,114
31043,043,31,2010,21033,-41,23,-18,105,63
31043,043,31,2011,20810,-433,27,-406,352,172
31043,043,31,2012,20711,-365,14,-351,381,136
31043,043,31,2013,20761,-192,13,-179,371,144
31043,043,31,2014,20545,-423,12,-411,359,176
31043,043,31,2015,20548,-241,14,-227,377,149
31043,043,31,2016,20295,-492,63,-429,345,170
31043,043,31,2017,20075,-460,68,-392,370,199
31043,043,31,2018,20081,-230,34,-196,365,164
31043,043,31,2019,20100,-219,14,-205,354,130
31043,043,31,2020,20070,-254,18,-236,342,136
31045,045,31,2010,9170,-15,3,-12,22,22
31045,045,31,2011,9208,8,13,21,101,83
31045,045,31,2012,9144,-108,13,-95,110,81
31045,045,31,2013,9072,-90,13,-77,98,97
31045,045,31,2014,9030,-79,11,-68,102,77
31045,045,31,2015,8974,-84,14,-70,88,72
31045,045,31,2016,8922,-66,16,-50,94,98
31045,045,31,2017,8897,-34,11,-23,93,96
31045,045,31,2018,8688,-201,13,-188,67,89
31045,045,31,2019,8557,-139,1,-138,81,74
31045,045,31,2020,8361,-190,2,-188,78,86
31047,047,31,2010,24302,-47,15,-32,90,72
31047,047,31,2011,24204,-275,26,-249,342,192
31047,047,31,2012,23967,-476,44,-432,396,214
31047,047,31,2013,24003,-164,58,-106,388,247
31047,047,31,2014,23964,-337,100,-237,391,201
31047,047,31,2015,23870,-419,106,-313,423,208
31047,047,31,2016,23742,-507,183,-324,391,196
31047,047,31,2017,23640,-470,167,-303,410,210
31047,047,31,2018,23726,-250,134,-116,416,214
31047,047,31,2019,23571,-467,101,-366,404,194
31047,047,31,2020,23510,-324,84,-240,396,217
31049,049,31,2010,1925,0,0,0,3,10
31049,049,31,2011,1957,44,0,44,14,25
31049,049,31,2012,1958,8,0,8,15,23
31049,049,31,2013,1919,-35,1,-34,16,21
31049,049,31,2014,1924,6,0,6,17,20
31049,049,31,2015,1908,-10,1,-9,17,22
31049,049,31,2016,1862,-42,1,-41,21,26
31049,049,31,2017,1858,9,1,10,10,24
31049,049,31,2018,1826,-24,0,-24,14,23
31049,049,31,2019,1816,-9,0,-9,16,16
31049,049,31,2020,1793,-28,1,-27,18,15
31051,051,31,2010,5988,-30,0,-30,21,6
31051,051,31,2011,5996,11,0,11,77,81
31051,051,31,2012,5888,-109,1,-108,67,69
31051,051,31,2013,5813,-81,8,-73,67,70
31051,051,31,2014,5758,-84,3,-81,76,52
31051,051,31,2015,5769,-12,6,-6,84,67
31051,051,31,2016,5742,-48,6,-42,76,62
31051,051,31,2017,5744,-15,10,-5,81,74
31051,051,31,2018,5692,-79,4,-75,84,60
31051,051,31,2019,5636,-82,9,-73,60,43
31051,051,31,2020,5596,-63,9,-54,68,53
31053,053,31,2010,36671,-34,3,-31,97,75
31053,053,31,2011,36928,196,5,201,478,422
31053,053,31,2012,36587,-335,8,-327,454,474
31053,053,31,2013,36491,-142,2,-140,493,446
31053,053,31,2014,36607,-7,60,53,495,426
31053,053,31,2015,36566,-155,77,-78,511,472
31053,053,31,2016,36702,-69,111,42,537,440
31053,053,31,2017,36778,-11,69,58,454,434
31053,053,31,2018,36679,-154,61,-93,466,472
31053,053,31,2019,36444,-309,32,-277,468,424
31053,053,31,2020,36222,-286,30,-256,461,428
31055,055,31,2010,518599,86,262,348,2086,917
31055,055,31,2011,524264,373,908,1281,8129,3730
31055,055,31,2012,530899,899,1188,2087,8340,3727
31055,055,31,2013,536923,350,1237,1587,8482,3997
31055,055,31,2014,543236,-186,1977,1791,8536,3892
31055,055,31,2015,549313,-69,1614,1545,8755,4153
31055,055,31,2016,555880,-647,2517,1870,8720,3992
31055,055,31,2017,561099,-1129,1961,832,8585,4171
31055,055,31,2018,566523,-124,1433,1309,8282,4155
31055,055,31,2019,570860,-694,836,142,8250,4067
31055,055,31,2020,574332,-1100,671,-429,8194,4329
31057,057,31,2010,2008,2,0,2,6,8
31057,057,31,2011,1976,-26,-1,-27,15,21
31057,057,31,2012,1979,39,-2,37,8,41
31057,057,31,2013,1955,-7,-3,-10,19,32
31057,057,31,2014,1864,-67,-2,-69,13,36
31057,057,31,2015,1771,-86,-2,-88,14,21
31057,057,31,2016,1807,32,-2,30,21,15
31057,057,31,2017,1786,-7,-1,-8,19,32
31057,057,31,2018,1742,-20,-1,-21,15,38
31057,057,31,2019,1686,-65,-1,-66,26,15
31057,057,31,2020,1671,-10,0,-10,20,25
31059,059,31,2010,5869,-2,0,-2,10,28
31059,059,31,2011,5825,-22,1,-21,53,76
31059,059,31,2012,5710,-79,1,-78,54,92
31059,059,31,2013,5635,-31,0,-31,46,90
31059,059,31,2014,5601,-13,0,-13,60,80
31059,059,31,2015,5552,-10,0,-10,62,101
31059,059,31,2016,5619,85,0,85,65,83
31059,059,31,2017,5559,-46,0,-46,71,85
31059,059,31,2018,5531,1,0,1,59,88
31059,059,31,2019,5484,-48,0,-48,62,60
31059,059,31,2020,5519,56,0,56,59,80
31061,061,31,2010,3244,16,0,16,7,4
31061,061,31,2011,3204,-21,0,-21,26,44
31061,061,31,2012,3183,-2,0,-2,29,48
31061,061,31,2013,3065,-104,0,-104,25,39
31061,061,31,2014,3048,-7,0,-7,28,38
31061,061,31,2015,2976,-55,0,-55,23,40
31061,061,31,2016,2996,28,0,28,30,39
31061,061,31,2017,2976,-20,0,-20,42,43
31061,061,31,2018,2991,18,0,18,34,36
31061,061,31,2019,2945,-48,0,-48,32,29
31061,061,31,2020,2940,-4,0,-4,36,36
31063,063,31,2010,2760,-1,0,-1,6,0
31063,063,31,2011,2714,-61,2,-59,26,13
31063,063,31,2012,2719,9,1,10,23,27
31063,063,31,2013,2715,-8,1,-7,21,18
31063,063,31,2014,2721,-1,2,1,30,24
31063,063,31,2015,2629,-98,1,-97,22,18
31063,063,31,2016,2651,5,1,6,33,18
31063,063,31,2017,2623,-30,1,-29,23,21
31063,063,31,2018,2598,-34,0,-34,25,17
31063,063,31,2019,2631,29,0,29,24,21
31063,063,31,2020,2587,-53,0,-53,27,16
31065,065,31,2010,4945,3,0,3,11,27
31065,065,31,2011,4914,6,0,6,39,76
31065,065,31,2012,4884,-16,0,-16,44,57
31065,065,31,2013,4831,-27,0,-27,46,71
31065,065,31,2014,4852,47,0,47,52,79
31065,065,31,2015,4828,-7,0,-7,56,73
31065,065,31,2016,4751,-62,1,-61,44,61
31065,065,31,2017,4765,9,2,11,71,67
31065,065,31,2018,4694,-50,0,-50,54,73
31065,065,31,2019,4690,-27,1,-26,70,49
31065,065,31,2020,4653,-50,0,-50,62,48
31067,067,31,2010,22269,-8,0,-8,62,94
31067,067,31,2011,21911,-301,-4,-305,231,286
31067,067,31,2012,21656,-219,0,-219,231,269
31067,067,31,2013,21767,140,-1,139,261,287
31067,067,31,2014,21561,-194,0,-194,253,266
31067,067,31,2015,21718,204,3,207,226,274
31067,067,31,2016,21622,-49,11,-38,222,279
31067,067,31,2017,21644,35,15,50,246,272
31067,067,31,2018,21499,-120,11,-109,243,280
31067,067,31,2019,21542,67,9,76,217,248
31067,067,31,2020,21431,-48,5,-43,209,278
31069,069,31,2010,2075,15,0,15,5,3
31069,069,31,2011,2063,3,0,3,23,37
31069,069,31,2012,1984,-67,0,-67,15,30
31069,069,31,2013,1924,-43,0,-43,20,38
31069,069,31,2014,1909,-1,0,-1,16,30
31069,069,31,2015,1917,13,0,13,26,30
31069,069,31,2016,1904,-3,0,-3,14,26
31069,069,31,2017,1892,-4,0,-4,20,27
31069,069,31,2018,1891,2,0,2,22,24
31069,069,31,2019,1822,-57,0,-57,13,25
31069,069,31,2020,1847,42,0,42,12,29
31071,071,31,2010,2033,1,0,1,1,16
31071,071,31,2011,2008,-9,0,-9,15,30
31071,071,31,2012,1994,6,0,6,10,30
31071,071,31,2013,2021,59,0,59,11,43
31071,071,31,2014,1999,-13,0,-13,19,28
31071,071,31,2015,2013,18,0,18,24,27
31071,071,31,2016,1991,-3,0,-3,13,33
31071,071,31,2017,1985,26,0,26,14,46
31071,071,31,2018,1969,-1,0,-1,26,41
31071,071,31,2019,1970,10,0,10,20,30
31071,071,31,2020,1956,-9,0,-9,23,27
31073,073,31,2010,2040,6,0,6,2,12
31073,073,31,2011,1990,-46,0,-46,22,26
31073,073,31,2012,2078,78,0,78,26,17
31073,073,31,2013,2017,-53,0,-53,23,32
31073,073,31,2014,2004,-12,0,-12,22,23
31073,073,31,2015,2025,19,0,19,21,18
31073,073,31,2016,2026,0,0,0,23,22
31073,073,31,2017,2027,6,0,6,25,30
31073,073,31,2018,1987,-37,0,-37,17,20
31073,073,31,2019,1978,-9,0,-9,20,20
31073,073,31,2020,1986,10,0,10,23,23
31075,075,31,2010,614,0,0,0,3,3
31075,075,31,2011,635,11,0,11,13,4
31075,075,31,2012,626,-8,0,-8,5,6
31075,075,31,2013,635,5,0,5,11,7
31075,075,31,2014,628,-10,0,-10,7,6
31075,075,31,2015,648,16,0,16,10,6
31075,075,31,2016,666,10,0,10,9,1
31075,075,31,2017,651,-21,0,-21,12,6
31075,075,31,2018,670,16,0,16,12,8
31075,075,31,2019,631,-37,0,-37,6,7
31075,075,31,2020,630,1,0,1,6,8
31077,077,31,2010,2546,5,0,5,8,4
31077,077,31,2011,2534,-8,1,-7,30,36
31077,077,31,2012,2463,-72,0,-72,29,31
31077,077,31,2013,2482,15,0,15,25,22
31077,077,31,2014,2482,-1,1,0,28,28
31077,077,31,2015,2435,-52,1,-51,32,29
31077,077,31,2016,2400,-34,0,-34,29,29
31077,077,31,2017,2362,-28,0,-28,25,35
31077,077,31,2018,2357,-7,0,-7,28,27
31077,077,31,2019,2368,5,0,5,29,22
31077,077,31,2020,2319,-42,0,-42,26,32
31079,079,31,2010,58813,22,62,84,220,105
31079,079,31,2011,59508,116,213,329,933,566
31079,079,31,2012,60105,5,219,224,901,514
31079,079,31,2013,60498,-228,247,19,906,528
31079,079,31,2014,61103,-244,331,87,1018,490
31079,079,31,2015,61135,-692,264,-428,1009,555
31079,079,31,2016,61404,-551,358,-193,995,533
31079,079,31,2017,61294,-820,374,-446,930,597
31079,079,31,2018,61510,-512,317,-195,985,575
31079,079,31,2019,61454,-624,214,-410,912,558
31079,079,31,2020,61028,-979,169,-810,938,550
31081,081,31,2010,9127,6,1,7,22,16
31081,081,31,2011,9079,-57,1,-56,89,81
31081,081,31,2012,9042,-63,1,-62,99,75
31081,081,31,2013,9123,51,1,52,110,79
31081,081,31,2014,9101,-17,-1,-18,95,100
31081,081,31,2015,9138,38,-1,37,92,91
31081,081,31,2016,9167,-16,0,-16,116,71
31081,081,31,2017,9193,-4,1,-3,115,86
31081,081,31,2018,9213,-3,0,-3,116,92
31081,081,31,2019,9285,37,0,37,100,65
31081,081,31,2020,9237,-67,0,-67,106,86
31083,083,31,2010,3422,2,0,2,5,2
31083,083,31,2011,3436,14,1,15,48,49
31083,083,31,2012,3411,-2,1,-1,29,51
31083,083,31,2013,3487,89,0,89,41,56
31083,083,31,2014,3468,-31,0,-31,41,30
31083,083,31,2015,3440,-34,0,-34,42,36
31083,083,31,2016,3441,15,0,15,29,42
31083,083,31,2017,3415,-18,0,-18,42,49
31083,083,31,2018,3363,-46,0,-46,36,43
31083,083,31,2019,3372,11,0,11,31,32
31083,083,31,2020,3311,-60,0,-60,34,35
31085,085,31,2010,956,-7,0,-7,2,0
31085,085,31,2011,952,-10,0,-10,15,8
31085,085,31,2012,919,-37,0,-37,8,7
31085,085,31,2013,947,14,3,17,13,2
31085,085,31,2014,910,-43,0,-43,10,5
31085,085,31,2015,916,-3,0,-3,13,5
31085,085,31,2016,896,-36,1,-35,20,4
31085,085,31,2017,895,-9,1,-8,13,6
31085,085,31,2018,912,2,1,3,20,5
31085,085,31,2019,911,-12,1,-11,16,6
31085,085,31,2020,916,1,1,2,10,7
31087,087,31,2010,2897,-2,1,-1,9,18
31087,087,31,2011,2857,-43,0,-43,37,36
31087,087,31,2012,2871,19,1,20,29,34
31087,087,31,2013,2852,-17,5,-12,33,41
31087,087,31,2014,2878,40,0,40,23,38
31087,087,31,2015,2878,-9,0,-9,47,36
31087,087,31,2016,2820,-44,0,-44,24,39
31087,087,31,2017,2804,-7,0,-7,31,41
31087,087,31,2018,2786,-5,0,-5,21,33
31087,087,31,2019,2759,-15,0,-15,23,35
31087,087,31,2020,2773,31,0,31,25,42
31089,089,31,2010,10434,-2,1,-1,24,23
31089,089,31,2011,10443,-20,9,-11,151,131
31089,089,31,2012,10378,-86,4,-82,134,118
31089,089,31,2013,10382,-13,1,-12,137,119
31089,089,31,2014,10361,-54,4,-50,144,116
31089,089,31,2015,10266,-93,1,-92,145,148
31089,089,31,2016,10229,-74,9,-65,141,114
31089,089,31,2017,10195,-66,14,-52,143,125
31089,089,31,2018,10152,-28,6,-22,136,156
31089,089,31,2019,10084,-101,11,-90,127,105
31089,089,31,2020,9956,-150,6,-144,128,110
31091,091,31,2010,737,0,0,0,2,1
31091,091,31,2011,743,5,0,5,5,5
31091,091,31,2012,718,-16,0,-16,7,16
31091,091,31,2013,731,16,0,16,6,9
31091,091,31,2014,722,-7,0,-7,10,13
31091,091,31,2015,714,2,0,2,6,16
31091,091,31,2016,684,-15,0,-15,8,24
31091,091,31,2017,666,-13,0,-13,6,11
31091,091,31,2018,670,9,0,9,8,13
31091,091,31,2019,668,5,0,5,5,11
31091,091,31,2020,647,-17,0,-17,5,9
31093,093,31,2010,6279,-12,0,-12,20,3
31093,093,31,2011,6295,12,1,13,63,60
31093,093,31,2012,6296,-4,1,-3,71,65
31093,093,31,2013,6335,33,1,34,81,77
31093,093,31,2014,6350,10,1,11,77,71
31093,093,31,2015,6378,-3,0,-3,80,49
31093,093,31,2016,6394,16,2,18,74,75
31093,093,31,2017,6391,-7,1,-6,87,84
31093,093,31,2018,6446,43,1,44,69,57
31093,093,31,2019,6423,-29,1,-28,77,71
31093,093,31,2020,6488,65,1,66,78,79
31095,095,31,2010,7521,-17,0,-17,10,18
31095,095,31,2011,7553,48,4,52,82,102
31095,095,31,2012,7536,29,2,31,74,121
31095,095,31,2013,7511,11,5,16,77,116
31095,095,31,2014,7299,-182,3,-179,89,127
31095,095,31,2015,7224,-50,13,-37,62,101
31095,095,31,2016,7167,-30,6,-24,77,109
31095,095,31,2017,7161,-3,6,3,91,99
31095,095,31,2018,7062,-63,4,-59,70,109
31095,095,31,2019,7020,-39,3,-36,95,102
31095,095,31,2020,7099,89,2,91,84,95
31097,097,31,2010,5233,11,0,11,13,9
31097,097,31,2011,5218,-3,1,-2,48,61
31097,097,31,2012,5187,-38,0,-38,51,47
31097,097,31,2013,5166,12,1,13,38,72
31097,097,31,2014,5222,73,1,74,40,61
31097,097,31,2015,5239,29,3,32,46,60
31097,097,31,2016,5206,-8,0,-8,44,68
31097,097,31,2017,5170,-19,8,-11,41,67
31097,097,31,2018,5105,-38,11,-27,43,80
31097,097,31,2019,5050,-40,0,-40,37,53
31097,097,31,2020,5057,28,2,30,35,58
31099,099,31,2010,6476,-1,0,-1,18,30
31099,099,31,2011,6548,77,-1,76,78,81
31099,099,31,2012,6509,-66,-2,-68,97,68
31099,099,31,2013,6487,-15,-1,-16,60,66
31099,099,31,2014,6590,74,-3,71,93,62
31099,099,31,2015,6560,-32,1,-31,81,80
31099,099,31,2016,6568,4,11,15,81,87
31099,099,31,2017,6528,-56,23,-33,70,77
31099,099,31,2018,6587,49,18,67,78,85
31099,099,31,2019,6607,-36,15,-21,90,49
31099,099,31,2020,6652,19,9,28,79,62
31101,101,31,2010,8356,8,0,8,19,41
31101,101,31,2011,8245,-94,-4,-98,76,90
31101,101,31,2012,8234,-14,2,-12,81,79
31101,101,31,2013,8173,-28,-1,-29,74,106
31101,101,31,2014,8195,35,1,36,70,83
31101,101,31,2015,8159,-13,-2,-15,77,97
31101,101,31,2016,8121,-13,0,-13,84,110
31101,101,31,2017,8097,-30,-3,-33,104,95
31101,101,31,2018,8020,-70,-3,-73,78,80
31101,101,31,2019,8021,10,-3,7,89,94
31101,101,31,2020,7983,-25,-3,-28,82,92
31103,103,31,2010,824,2,0,2,0,2
31103,103,31,2011,819,-5,0,-5,6,6
31103,103,31,2012,797,-16,1,-15,5,13
31103,103,31,2013,790,-10,0,-10,12,9
31103,103,31,2014,795,8,0,8,4,7
31103,103,31,2015,797,-2,0,-2,10,6
31103,103,31,2016,790,-6,0,-6,5,6
31103,103,31,2017,790,-3,0,-3,9,5
31103,103,31,2018,794,2,0,2,6,5
31103,103,31,2019,784,-11,0,-11,7,5
31103,103,31,2020,759,-23,0,-23,5,8
31105,105,31,2010,3834,3,5,8,9,3
31105,105,31,2011,3807,-39,26,-13,43,57
31105,105,31,2012,3802,16,2,18,41,63
31105,105,31,2013,3694,-107,8,-99,37,47
31105,105,31,2014,3725,30,9,39,42,51
31105,105,31,2015,3715,-22,8,-14,44,39
31105,105,31,2016,3672,-43,2,-41,49,51
31105,105,31,2017,3567,-78,1,-77,35,64
31105,105,31,2018,3549,-4,2,-2,40,56
31105,105,31,2019,3597,60,1,61,29,42
31105,105,31,2020,3495,-83,1,-82,34,52
31107,107,31,2010,8677,-3,0,-3,23,43
31107,107,31,2011,8575,-73,1,-72,89,119
31107,107,31,2012,8578,0,4,4,107,107
31107,107,31,2013,8555,-8,2,-6,103,118
31107,107,31,2014,8478,-54,2,-52,107,133
31107,107,31,2015,8472,14,0,14,94,113
31107,107,31,2016,8502,23,4,27,106,102
31107,107,31,2017,8447,-32,4,-28,100,128
31107,107,31,2018,8410,-42,2,-40,115,110
31107,107,31,2019,8337,-81,2,-79,97,92
31107,107,31,2020,8304,-36,2,-34,101,99
31109,109,31,2010,286175,-12,167,155,1035,390
31109,109,31,2011,289963,1110,622,1732,4067,2010
31109,109,31,2012,293515,640,855,1495,4021,1919
31109,109,31,2013,297232,861,769,1630,4137,2026
31109,109,31,2014,302775,2038,1387,3425,4046,1960
31109,109,31,2015,306293,540,1082,1622,4082,2156
31109,109,31,2016,310561,860,1445,2305,4081,2114
31109,109,31,2017,313892,581,1012,1593,3978,2229
31109,109,31,2018,316372,189,744,933,3838,2284
31109,109,31,2019,318403,7,430,437,3854,2268
31109,109,31,2020,320650,380,358,738,3796,2313
31111,111,31,2010,36250,-51,3,-48,116,105
31111,111,31,2011,36035,-309,20,-289,415,342
31111,111,31,2012,35979,-186,20,-166,452,345
31111,111,31,2013,35946,-117,16,-101,427,356
31111,111,31,2014,35661,-385,36,-349,411,353
31111,111,31,2015,35519,-184,12,-172,419,390
31111,111,31,2016,35528,-114,37,-77,442,355
31111,111,31,2017,35299,-275,28,-247,423,403
31111,111,31,2018,35182,-207,25,-182,426,362
31111,111,31,2019,34856,-393,16,-377,414,361
31111,111,31,2020,34347,-512,9,-503,400,404
31113,113,31,2010,772,6,0,6,3,0
31113,113,31,2011,779,4,0,4,9,6
31113,113,31,2012,785,2,0,2,10,6
31113,113,31,2013,777,-16,1,-15,11,3
31113,113,31,2014,767,-18,2,-16,12,7
31113,113,31,2015,791,20,2,22,9,7
31113,113,31,2016,797,-3,4,1,13,9
31113,113,31,2017,768,-35,3,-32,9,7
31113,113,31,2018,751,-21,2,-19,7,6
31113,113,31,2019,750,-5,2,-3,7,4
31113,113,31,2020,747,-8,2,-6,7,4
31115,115,31,2010,628,2,0,2,0,3
31115,115,31,2011,617,-11,0,-11,5,4
31115,115,31,2012,605,-13,0,-13,8,5
31115,115,31,2013,587,-19,0,-19,4,3
31115,115,31,2014,596,5,0,5,5,2
31115,115,31,2015,606,10,0,10,8,8
31115,115,31,2016,616,9,0,9,7,6
31115,115,31,2017,604,-9,0,-9,5,9
31115,115,31,2018,620,20,0,20,6,10
31115,115,31,2019,659,43,0,43,7,11
31115,115,31,2020,650,-6,0,-6,7,10
31117,117,31,2010,539,1,0,1,0,1
31117,117,31,2011,551,15,0,15,2,5
31117,117,31,2012,509,-44,0,-44,4,3
31117,117,31,2013,528,19,0,19,2,2
31117,117,31,2014,510,-21,0,-21,3,1
31117,117,31,2015,489,-22,0,-22,3,4
31117,117,31,2016,503,17,0,17,5,7
31117,117,31,2017,493,-7,0,-7,4,8
31117,117,31,2018,494,1,0,1,2,1
31117,117,31,2019,493,0,0,0,2,3
31117,117,31,2020,474,-16,0,-16,2,4
31119,119,31,2010,34963,9,13,22,121,51
31119,119,31,2011,35012,-220,33,-187,561,325
31119,119,31,2012,35088,-150,43,-107,507,323
31119,119,31,2013,35155,-88,60,-28,505,406
31119,119,31,2014,35087,-323,111,-212,511,371
31119,119,31,2015,35001,-353,94,-259,544,373
31119,119,31,2016,34951,-308,101,-207,514,358
31119,119,31,2017,35128,-36,88,52,502,375
31119,119,31,2018,35166,-180,75,-105,534,391
31119,119,31,2019,35059,-286,40,-246,501,362
31119,119,31,2020,34813,-397,33,-364,495,375
31121,121,31,2010,7852,2,0,2,23,32
31121,121,31,2011,7762,-95,0,-95,88,83
31121,121,31,2012,7848,90,0,90,77,82
31121,121,31,2013,7834,-27,-1,-28,100,85
31121,121,31,2014,7791,-49,0,-49,92,84
31121,121,31,2015,7806,8,0,8,98,90
31121,121,31,2016,7852,14,9,23,96,73
31121,121,31,2017,7877,4,9,13,99,87
31121,121,31,2018,7774,-103,7,-96,87,94
31121,121,31,2019,7818,38,4,42,81,78
31121,121,31,2020,7809,-8,4,-4,86,92
31123,123,31,2010,5039,3,1,4,15,22
31123,123,31,2011,4985,-45,-3,-48,51,57
31123,123,31,2012,4936,-51,0,-51,56,56
31123,123,31,2013,4929,-2,4,2,52,61
31123,123,31,2014,4921,-5,0,-5,56,59
31123,123,31,2015,4928,15,2,17,59,69
31123,123,31,2016,4858,-50,3,-47,45,68
31123,123,31,2017,4794,-66,6,-60,51,54
31123,123,31,2018,4653,-129,2,-127,47,61
31123,123,31,2019,4624,-38,5,-33,51,47
31123,123,31,2020,4625,-9,3,-6,50,43
31125,125,31,2010,3740,-1,0,-1,12,5
31125,125,31,2011,3732,5,0,5,42,55
31125,125,31,2012,3675,-49,0,-49,52,62
31125,125,31,2013,3559,-118,0,-118,37,36
31125,125,31,2014,3528,-12,4,-8,37,61
31125,125,31,2015,3574,51,3,54,39,46
31125,125,31,2016,3562,-10,3,-7,43,49
31125,125,31,2017,3558,11,0,11,40,55
31125,125,31,2018,3492,-46,0,-46,37,58
31125,125,31,2019,3482,-5,0,-5,40,44
31125,125,31,2020,3532,47,0,47,41,37
31127,127,31,2010,7238,3,0,3,22,34
31127,127,31,2011,7241,24,0,24,68,89
31127,127,31,2012,7155,-71,1,-70,80,97
31127,127,31,2013,7152,0,1,1,84,87
31127,127,31,2014,7132,-19,4,-15,71,76
31127,127,31,2015,7007,-123,4,-119,69,76
31127,127,31,2016,6980,-20,7,-13,71,86
31127,127,31,2017,6962,-33,6,-27,82,72
31127,127,31,2018,6963,-22,6,-16,99,83
31127,127,31,2019,6943,-15,3,-12,80,86
31127,127,31,2020,7044,94,3,97,78,74
31129,129,31,2010,4514,8,0,8,11,5
31129,129,31,2011,4448,-42,0,-42,42,66
31129,129,31,2012,4431,8,1,9,37,62
31129,129,31,2013,4385,-14,2,-12,34,67
31129,129,31,2014,4349,-22,2,-20,44,59
31129,129,31,2015,4323,-32,8,-24,51,53
31129,129,31,2016,4273,-40,11,-29,43,64
31129,129,31,2017,4269,11,8,19,37,59
31129,129,31,2018,4190,-53,7,-46,46,79
31129,129,31,2019,4152,-38,5,-33,45,48
31129,129,31,2020,4134,4,2,6,44,68
31131,131,31,2010,15747,23,2,25,52,69
31131,131,31,2011,15740,-28,25,-3,182,185
31131,131,31,2012,15689,-80,37,-43,181,190
31131,131,31,2013,15686,-36,35,-1,198,198
31131,131,31,2014,15781,36,42,78,193,175
31131,131,31,2015,15844,29,28,57,217,207
31131,131,31,2016,15930,23,32,55,195,164
31131,131,31,2017,15946,-65,38,-27,220,176
31131,131,31,2018,15991,23,27,50,175,180
31131,131,31,2019,15993,-38,21,-17,193,173
31131,131,31,2020,15965,-51,16,-35,179,172
31133,133,31,2010,2781,13,0,13,1,6
31133,133,31,2011,2791,24,0,24,25,38
31133,133,31,2012,2793,15,0,15,24,36
31133,133,31,2013,2752,-34,0,-34,34,43
31133,133,31,2014,2728,-5,0,-5,28,45
31133,133,31,2015,2693,-38,0,-38,34,32
31133,133,31,2016,2704,10,0,10,39,38
31133,133,31,2017,2624,-79,0,-79,33,34
31133,133,31,2018,2632,20,0,20,32,45
31133,133,31,2019,2639,-5,0,-5,36,23
31133,133,31,2020,2601,-40,0,-40,37,33
31135,135,31,2010,2978,8,0,8,6,3
31135,135,31,2011,2944,-35,0,-35,34,33
31135,135,31,2012,2929,-16,0,-16,33,32
31135,135,31,2013,2890,-42,1,-41,36,35
31135,135,31,2014,2874,-28,0,-28,44,34
31135,135,31,2015,2933,57,0,57,45,44
31135,135,31,2016,2898,-53,1,-52,46,28
31135,135,31,2017,2885,-19,1,-18,37,32
31135,135,31,2018,2911,22,0,22,35,31
31135,135,31,2019,2884,-19,0,-19,28,36
31135,135,31,2020,2867,-18,0,-18,29,27
31137,137,31,2010,9183,7,0,7,22,33
31137,137,31,2011,9141,-24,0,-24,113,131
31137,137,31,2012,9208,45,3,48,131,111
31137,137,31,2013,9179,-23,3,-20,106,114
31137,137,31,2014,9162,-31,3,-28,113,100
31137,137,31,2015,9218,48,4,52,120,114
31137,137,31,2016,9199,-24,7,-17,112,113
31137,137,31,2017,9052,-137,8,-129,119,137
31137,137,31,2018,9003,-63,7,-56,107,101
31137,137,31,2019,8991,-27,5,-22,115,105
31137,137,31,2020,9006,-6,7,1,115,100
31139,139,31,2010,7259,-19,1,-18,19,10
31139,139,31,2011,7192,-85,2,-83,69,53
31139,139,31,2012,7183,-17,1,-16,77,69
31139,139,31,2013,7176,-15,3,-12,90,84
31139,139,31,2014,7200,12,1,13,81,69
31139,139,31,2015,7188,-14,1,-13,97,95
31139,139,31,2016,7134,-85,2,-83,89,61
31139,139,31,2017,7091,-51,0,-51,86,79
31139,139,31,2018,7117,23,0,23,82,78
31139,139,31,2019,7136,-26,0,-26,99,53
31139,139,31,2020,7184,25,1,26,92,70
31141,141,31,2010,32305,-27,4,-23,139,48
31141,141,31,2011,32518,30,19,49,454,289
31141,141,31,2012,32672,-113,30,-83,486,245
31141,141,31,2013,32598,-321,33,-288,482,274
31141,141,31,2014,32744,-96,65,-31,476,297
31141,141,31,2015,32869,-180,73,-107,506,274
31141,141,31,2016,32986,-189,111,-78,485,289
31141,141,31,2017,33226,-59,108,49,483,292
31141,141,31,2018,33259,-202,81,-121,463,309
31141,141,31,2019,33413,-83,53,-30,467,283
31141,141,31,2020,33364,-260,50,-210,459,298
31143,143,31,2010,5394,-5,0,-5,8,11
31143,143,31,2011,5336,-47,2,-45,56,68
31143,143,31,2012,5265,-44,2,-42,43,74
31143,143,31,2013,5241,-11,6,-5,54,72
31143,143,31,2014,5267,21,12,33,62,67
31143,143,31,2015,5169,-84,4,-80,39,58
31143,143,31,2016,5182,9,1,10,55,52
31143,143,31,2017,5299,118,2,120,62,64
31143,143,31,2018,5200,-94,1,-93,56,62
31143,143,31,2019,5154,-50,-1,-51,62,57
31143,143,31,2020,5201,53,0,53,57,61
31145,145,31,2010,11059,-9,1,-8,29,18
31145,145,31,2011,11051,-23,2,-21,140,126
31145,145,31,2012,11047,-11,1,-10,120,113
31145,145,31,2013,11057,1,3,4,122,114
31145,145,31,2014,10909,-169,14,-155,128,125
31145,145,31,2015,10895,-16,8,-8,120,125
31145,145,31,2016,10782,-113,7,-106,137,143
31145,145,31,2017,10765,-53,6,-47,151,121
31145,145,31,2018,10732,-28,4,-24,130,136
31145,145,31,2019,10720,-8,2,-6,131,138
31145,145,31,2020,10627,-93,2,-91,133,134
31147,147,31,2010,8372,-5,0,-5,31,16
31147,147,31,2011,8341,-7,0,-7,86,108
31147,147,31,2012,8285,-24,0,-24,88,120
31147,147,31,2013,8134,-106,-1,-107,85,128
31147,147,31,2014,8112,-28,-1,-29,118,110
31147,147,31,2015,8026,-42,-1,-43,90,134
31147,147,31,2016,8013,11,4,15,83,110
31147,147,31,2017,7980,5,3,8,80,123
31147,147,31,2018,7927,-24,1,-23,85,115
31147,147,31,2019,7854,-51,0,-51,90,111
31147,147,31,2020,7791,-34,1,-33,86,116
31149,149,31,2010,1524,-2,0,-2,1,3
31149,149,31,2011,1480,-39,0,-39,14,18
31149,149,31,2012,1426,-40,0,-40,13,28
31149,149,31,2013,1440,17,0,17,15,19
31149,149,31,2014,1449,14,0,14,14,18
31149,149,31,2015,1417,-11,0,-11,12,34
31149,149,31,2016,1405,-4,0,-4,21,29
31149,149,31,2017,1419,21,0,21,18,26
31149,149,31,2018,1354,-59,0,-59,13,19
31149,149,31,2019,1370,21,0,21,14,19
31149,149,31,2020,1377,5,0,5,17,14
31151,151,31,2010,14220,-7,9,2,46,27
31151,151,31,2011,14324,3,31,34,204,132
31151,151,31,2012,14412,-1,55,54,194,158
31151,151,31,2013,14294,-220,64,-156,182,149
31151,151,31,2014,14291,-155,103,-52,183,136
31151,151,31,2015,14193,-210,58,-152,191,140
31151,151,31,2016,14228,-96,99,3,187,156
31151,151,31,2017,14368,7,90,97,201,157
31151,151,31,2018,14327,-118,51,-67,177,152
31151,151,31,2019,14194,-268,52,-216,193,111
31151,151,31,2020,13987,-305,44,-261,188,132
31153,153,31,2010,159732,302,89,391,629,142
31153,153,31,2011,162597,939,121,1060,2592,787
31153,153,31,2012,165710,791,532,1323,2610,798
31153,153,31,2013,169064,1417,299,1716,2521,877
31153,153,31,2014,171942,807,412,1219,2615,934
31153,153,31,2015,175294,1346,352,1698,2576,920
31153,153,31,2016,178457,1232,289,1521,2527,883
31153,153,31,2017,181468,1418,166,1584,2490,1060
31153,153,31,2018,184106,1073,52,1125,2530,1016
31153,153,31,2019,186893,1345,50,1395,2479,1086
31153,153,31,2020,188856,632,47,679,2458,1186
31155,155,31,2010,20867,49,3,52,68,33
31155,155,31,2011,20839,-115,11,-104,269,193
31155,155,31,2012,20799,-115,11,-104,235,174
31155,155,31,2013,20878,29,9,38,234,190
31155,155,31,2014,20863,-23,5,-18,218,213
31155,155,31,2015,20953,48,4,52,245,202
31155,155,31,2016,20977,4,8,12,237,225
31155,155,31,2017,21035,-6,5,-1,267,208
31155,155,31,2018,21280,222,5,227,258,238
31155,155,31,2019,21562,258,3,261,238,217
31155,155,31,2020,21927,332,4,336,248,216
31157,157,31,2010,37058,44,4,48,151,113
31157,157,31,2011,36965,-173,-7,-180,531,442
31157,157,31,2012,36923,-97,7,-90,467,414
31157,157,31,2013,36878,-147,36,-111,502,434
31157,157,31,2014,36467,-543,34,-509,472,386
31157,157,31,2015,36273,-306,33,-273,473,393
31157,157,31,2016,36439,89,38,127,485,444
31157,157,31,2017,36175,-389,22,-367,507,403
31157,157,31,2018,35923,-291,9,-282,449,420
31157,157,31,2019,35582,-386,10,-376,448,413
31157,157,31,2020,35299,-263,11,-252,419,449
31159,159,31,2010,16800,39,-1,38,59,48
31159,159,31,2011,16707,-126,2,-124,207,177
31159,159,31,2012,16899,134,5,139,206,153
31159,159,31,2013,16997,73,11,84,180,164
31159,159,31,2014,17016,-36,17,-19,187,147
31159,159,31,2015,16998,-44,15,-29,204,192
31159,159,31,2016,17095,101,17,118,166,186
31159,159,31,2017,17204,61,13,74,203,167
31159,159,31,2018,17281,75,17,92,169,184
31159,159,31,2019,17318,6,3,9,193,165
31159,159,31,2020,17186,-163,4,-159,187,159
31161,161,31,2010,5443,-12,0,-12,14,28
31161,161,31,2011,5361,-71,1,-70,54,65
31161,161,31,2012,5330,-28,1,-27,67,71
31161,161,31,2013,5213,-87,0,-87,48,79
31161,161,31,2014,5254,44,0,44,68,71
31161,161,31,2015,5220,-8,4,-4,51,82
31161,161,31,2016,5238,23,9,32,52,64
31161,161,31,2017,5281,49,9,58,68,82
31161,161,31,2018,5175,-81,6,-75,60,91
31161,161,31,2019,5229,55,3,58,61,65
31161,161,31,2020,5150,-78,4,-74,63,67
31163,163,31,2010,3165,7,0,7,8,3
31163,163,31,2011,3103,-46,0,-46,33,48
31163,163,31,2012,3079,-17,0,-17,28,34
31163,163,31,2013,3062,-4,0,-4,29,43
31163,163,31,2014,3034,-32,0,-32,32,28
31163,163,31,2015,3036,24,0,24,25,45
31163,163,31,2016,3006,-6,0,-6,25,49
31163,163,31,2017,3072,64,0,64,33,32
31163,163,31,2018,3029,-50,0,-50,48,42
31163,163,31,2019,2984,-49,0,-49,34,30
31163,163,31,2020,2986,9,0,9,35,43
31165,165,31,2010,1307,-1,0,-1,2,1
31165,165,31,2011,1314,7,0,7,9,8
31165,165,31,2012,1319,0,0,0,9,4
31165,165,31,2013,1326,2,0,2,12,8
31165,165,31,2014,1317,-8,0,-8,9,10
31165,165,31,2015,1272,-42,0,-42,8,11
31165,165,31,2016,1256,-19,0,-19,9,8
31165,165,31,2017,1194,-60,0,-60,6,8
31165,165,31,2018,1181,-25,0,-25,16,5
31165,165,31,2019,1158,-24,0,-24,9,6
31165,165,31,2020,1200,37,0,37,7,2
31167,167,31,2010,6141,-11,0,-11,25,2
31167,167,31,2011,6176,-7,6,-1,85,48
31167,167,31,2012,6092,-121,4,-117,80,50
31167,167,31,2013,6089,-10,3,-7,59,55
31167,167,31,2014,6099,-31,5,-26,75,38
31167,167,31,2015,5946,-185,4,-181,73,47
31167,167,31,2016,5972,9,6,15,59,46
31167,167,31,2017,5978,-37,4,-33,75,38
31167,167,31,2018,5969,-41,3,-38,77,48
31167,167,31,2019,5932,-80,2,-78,78,36
31167,167,31,2020,5880,-94,3,-91,79,41
31169,169,31,2010,5234,2,0,2,11,6
31169,169,31,2011,5169,-41,1,-40,52,76
31169,169,31,2012,5143,-4,0,-4,49,72
31169,169,31,2013,5178,65,0,65,61,92
31169,169,31,2014,5212,46,0,46,69,81
31169,169,31,2015,5129,-61,1,-60,53,77
31169,169,31,2016,5087,-22,2,-20,59,81
31169,169,31,2017,5035,-26,0,-26,56,82
31169,169,31,2018,5017,21,0,21,42,81
31169,169,31,2019,4976,-15,0,-15,48,73
31169,169,31,2020,4887,-57,0,-57,49,80
31171,171,31,2010,647,-4,0,-4,3,0
31171,171,31,2011,697,45,2,47,13,10
31171,171,31,2012,700,5,2,7,5,8
31171,171,31,2013,704,-4,1,-3,11,4
31171,171,31,2014,700,-8,1,-7,7,3
31171,171,31,2015,692,-9,1,-8,5,4
31171,171,31,2016,719,23,1,24,5,3
31171,171,31,2017,720,-2,1,-1,10,8
31171,171,31,2018,711,-13,1,-12,6,2
31171,171,31,2019,723,6,0,6,7,2
31171,171,31,2020,739,10,1,11,6,1
31173,173,31,2010,6971,11,0,11,41,19
31173,173,31,2011,6908,-128,4,-124,138,78
31173,173,31,2012,6931,-62,0,-62,137,55
31173,173,31,2013,6878,-113,3,-110,132,77
31173,173,31,2014,6967,0,7,7,162,78
31173,173,31,2015,7077,15,5,20,165,76
31173,173,31,2016,7141,-20,5,-15,164,85
31173,173,31,2017,7201,-1,4,3,143,85
31173,173,31,2018,7296,-2,4,2,166,73
31173,173,31,2019,7234,-111,3,-108,143,96
31173,173,31,2020,7220,-60,0,-60,138,93
31175,175,31,2010,4267,6,0,6,14,15
31175,175,31,2011,4227,-36,-1,-37,55,58
31175,175,31,2012,4216,-1,0,-1,48,57
31175,175,31,2013,4181,-28,1,-27,48,56
31175,175,31,2014,4217,30,11,41,58,63
31175,175,31,2015,4167,-63,8,-55,52,48
31175,175,31,2016,4191,24,7,31,43,50
31175,175,31,2017,4214,27,6,33,48,57
31175,175,31,2018,4175,-44,6,-38,47,49
31175,175,31,2019,4117,-61,4,-57,50,51
31175,175,31,2020,4103,-8,1,-7,49,57
31177,177,31,2010,19921,-381,0,-381,54,28
31177,177,31,2011,19920,-34,1,-33,196,164
31177,177,31,2012,19951,-29,3,-26,207,152
31177,177,31,2013,19855,-114,9,-105,200,190
31177,177,31,2014,19935,-2,17,15,236,169
31177,177,31,2015,19925,-60,13,-47,224,188
31177,177,31,2016,20217,245,15,260,213,179
31177,177,31,2017,20330,74,12,86,215,186
31177,177,31,2018,20599,252,12,264,205,199
31177,177,31,2019,20683,48,9,57,203,174
31177,177,31,2020,20901,203,2,205,204,191
31179,179,31,2010,9610,4,7,11,30,23
31179,179,31,2011,9456,-217,18,-199,110,67
31179,179,31,2012,9507,10,24,34,90,72
31179,179,31,2013,9448,-124,14,-110,112,64
31179,179,31,2014,9412,-76,0,-76,85,46
31179,179,31,2015,9375,-74,0,-74,98,61
31179,179,31,2016,9427,-28,24,-4,125,69
31179,179,31,2017,9260,-214,18,-196,85,59
31179,179,31,2018,9346,50,12,62,101,78
31179,179,31,2019,9413,31,11,42,88,62
31179,179,31,2020,9492,34,10,44,90,55
31181,181,31,2010,3809,4,0,4,11,18
31181,181,31,2011,3756,-34,0,-34,40,59
31181,181,31,2012,3734,-5,0,-5,41,58
31181,181,31,2013,3644,-56,0,-56,28,64
31181,181,31,2014,3645,21,0,21,35,54
31181,181,31,2015,3594,-19,0,-19,35,69
31181,181,31,2016,3575,0,0,0,39,56
31181,181,31,2017,3508,-31,0,-31,25,61
31181,181,31,2018,3517,31,0,31,39,60
31181,181,31,2019,3465,-46,0,-46,40,46
31181,181,31,2020,3419,-29,0,-29,42,59
31183,183,31,2010,825,3,0,3,5,1
31183,183,31,2011,815,-9,0,-9,4,5
31183,183,31,2012,797,-22,0,-22,9,6
31183,183,31,2013,779,-19,0,-19,6,6
31183,183,31,2014,786,6,0,6,9,7
31183,183,31,2015,779,-13,0,-13,7,2
31183,183,31,2016,803,20,0,20,9,3
31183,183,31,2017,814,8,0,8,8,6
31183,183,31,2018,795,-19,0,-19,8,7
31183,183,31,2019,780,-23,0,-23,14,5
31183,183,31,2020,790,-1,0,-1,14,4
31185,185,31,2010,13669,-30,3,-27,49,19
31185,185,31,2011,13787,101,1,102,164,148
31185,185,31,2012,13839,25,5,30,170,146
31185,185,31,2013,13856,4,5,9,161,154
31185,185,31,2014,13922,24,4,28,202,160
31185,185,31,2015,13804,-140,4,-136,176,159
31185,185,31,2016,13741,-59,3,-56,161,168
31185,185,31,2017,13764,17,4,21,180,176
31185,185,31,2018,13726,-66,5,-61,181,159
31185,185,31,2019,13612,-133,2,-131,154,137
31185,185,31,2020,13511,-126,3,-123,160,136
32001,001,32,2010,24816,-123,24,-99,71,37
32001,001,32,2011,24607,-258,17,-241,310,278
32001,001,32,2012,24267,-517,105,-412,323,265
32001,001,32,2013,23956,-432,68,-364,320,276
32001,001,32,2014,23864,-229,47,-182,338,247
32001,001,32,2015,24006,11,78,89,320,265
32001,001,32,2016,23957,-103,39,-64,305,288
32001,001,32,2017,24088,88,20,108,320,296
32001,001,32,2018,24574,474,-16,458,315,287
32001,001,32,2019,25048,384,33,417,341,284
32001,001,32,2020,25363,244,26,270,348,302
32003,003,32,2010,1952640,-2736,862,-1874,6582,3279
32003,003,32,2011,1962162,-4931,1231,-3700,26876,13610
32003,003,32,2012,1989644,11568,3456,15024,26100,13798
32003,003,32,2013,2017798,11955,4319,16274,26309,14429
32003,003,32,2014,2053929,20037,3706,23743,26344,14272
32003,003,32,2015,2097832,25828,5905,31733,27227,15286
32003,003,32,2016,2140240,27729,2906,30635,27355,15682
32003,003,32,2017,2183273,29131,3034,32165,27255,16539
32003,003,32,2018,2228970,35805,-182,35623,26802,16894
32003,003,32,2019,2275884,32054,5543,37597,26943,17661
32003,003,32,2020,2315963,28502,4322,32824,26886,19618
32005,005,32,2010,47037,23,7,30,95,82
32005,005,32,2011,46982,-13,-8,-21,393,422
32005,005,32,2012,46930,53,-2,51,325,419
32005,005,32,2013,46956,125,5,130,337,430
32005,005,32,2014,47406,531,23,554,375,484
32005,005,32,2015,47422,187,13,200,331,510
32005,005,32,2016,47805,531,5,536,286,438
32005,005,32,2017,48014,469,-4,465,318,572
32005,005,32,2018,48527,799,-15,784,272,544
32005,005,32,2019,48998,678,3,681,325,534
32005,005,32,2020,49088,359,2,361,329,599
32007,007,32,2010,49093,-4,9,5,187,37
32007,007,32,2011,49463,-26,-13,-39,687,276
32007,007,32,2012,50998,1127,-14,1113,622,239
32007,007,32,2013,52378,984,-21,963,629,243
32007,007,32,2014,52616,-286,10,-276,724,212
32007,007,32,2015,51756,-1368,18,-1350,690,223
32007,007,32,2016,52022,-81,-17,-98,674,309
32007,007,32,2017,52307,-116,-16,-132,749,331
32007,007,32,2018,52470,-260,-36,-296,778,321
32007,007,32,2019,52880,-68,9,-59,741,274
32007,007,32,2020,53006,-268,5,-263,725,339
32009,009,32,2010,783,-4,0,-4,4,1
32009,009,32,2011,770,-3,2,-1,2,13
32009,009,32,2012,791,31,-1,30,2,14
32009,009,32,2013,847,68,-1,67,3,16
32009,009,32,2014,834,-11,-1,-12,9,11
32009,009,32,2015,847,5,2,7,9,4
32009,009,32,2016,839,-4,0,-4,5,8
32009,009,32,2017,858,21,2,23,9,14
32009,009,32,2018,827,-30,2,-28,3,7
32009,009,32,2019,870,41,3,44,5,6
32009,009,32,2020,886,14,3,17,4,4
32011,011,32,2010,1990,10,0,10,4,12
32011,011,32,2011,1977,-24,1,-23,22,12
32011,011,32,2012,1991,9,0,9,14,10
32011,011,32,2013,2050,60,0,60,12,16
32011,011,32,2014,1994,-66,0,-66,17,10
32011,011,32,2015,2040,27,0,27,29,10
32011,011,32,2016,1943,-93,0,-93,14,18
32011,011,32,2017,1959,13,0,13,14,11
32011,011,32,2018,2019,55,0,55,14,10
32011,011,32,2019,2078,53,0,53,19,13
32011,011,32,2020,2065,-15,0,-15,16,12
32013,013,32,2010,16580,19,-4,15,59,15
32013,013,32,2011,16640,-69,-13,-82,267,124
32013,013,32,2012,17078,291,-1,290,274,138
32013,013,32,2013,17365,127,6,133,264,112
32013,013,32,2014,17230,-277,5,-272,258,128
32013,013,32,2015,17033,-346,24,-322,266,146
32013,013,32,2016,16814,-347,3,-344,248,127
32013,013,32,2017,16734,-195,7,-188,237,129
32013,013,32,2018,16778,-44,-5,-49,222,129
32013,013,32,2019,16884,-34,16,-18,248,124
32013,013,32,2020,16962,-70,19,-51,251,123
32015,015,32,2010,5795,2,1,3,17,2
32015,015,32,2011,5840,-3,0,-3,85,36
32015,015,32,2012,5922,25,3,28,87,34
32015,015,32,2013,6064,88,9,97,87,43
32015,015,32,2014,5980,-156,15,-141,99,48
32015,015,32,2015,5885,-147,4,-143,90,44
32015,015,32,2016,5700,-237,3,-234,98,50
32015,015,32,2017,5584,-153,-3,-156,88,48
32015,015,32,2018,5512,-89,-5,-94,63,43
32015,015,32,2019,5516,-34,0,-34,82,45
32015,015,32,2020,5514,-26,-2,-28,71,46
32017,017,32,2010,5351,16,0,16,10,16
32017,017,32,2011,5269,-74,-2,-76,32,38
32017,017,32,2012,5369,121,-1,120,22,46
32017,017,32,2013,5268,-76,-1,-77,20,45
32017,017,32,2014,5201,-55,-2,-57,34,45
32017,017,32,2015,5135,-47,-1,-48,32,51
32017,017,32,2016,5143,31,-1,30,35,56
32017,017,32,2017,5179,44,0,44,47,56
32017,017,32,2018,5225,37,0,37,46,37
32017,017,32,2019,5179,-64,0,-64,57,38
32017,017,32,2020,5159,-14,0,-14,55,61
32019,019,32,2010,52049,35,23,58,156,149
32019,019,32,2011,51393,-718,-18,-736,575,498
32019,019,32,2012,50981,-435,-22,-457,534,498
32019,019,32,2013,51114,121,-29,92,558,507
32019,019,32,2014,51359,300,-21,279,550,581
32019,019,32,2015,51999,651,-19,632,589,584
32019,019,32,2016,52770,823,-29,794,599,623
32019,019,32,2017,53945,1254,-36,1218,586,635
32019,019,32,2018,55800,1939,-41,1898,568,621
32019,019,32,2019,57499,1771,-23,1748,609,654
32019,019,32,2020,58319,929,-18,911,614,702
32021,021,32,2010,4791,6,2,8,15,4
32021,021,32,2011,4634,-143,12,-131,48,74
32021,021,32,2012,4663,36,14,50,67,88
32021,021,32,2013,4561,-86,10,-76,48,76
32021,021,32,2014,4473,-83,10,-73,47,65
32021,021,32,2015,4423,-33,6,-27,44,67
32021,021,32,2016,4382,-13,3,-10,47,79
32021,021,32,2017,4458,101,3,104,47,75
32021,021,32,2018,4560,102,0,102,61,61
32021,021,32,2019,4516,-14,4,-10,36,69
32021,021,32,2020,4518,56,3,59,40,96
32023,023,32,2010,43848,-52,4,-48,93,135
32023,023,32,2011,43981,356,-12,344,417,633
32023,023,32,2012,43604,-78,-4,-82,387,675
32023,023,32,2013,42905,-391,-14,-405,340,638
32023,023,32,2014,42877,298,-14,284,359,676
32023,023,32,2015,43008,463,-11,452,360,683
32023,023,32,2016,43295,700,-31,669,356,737
32023,023,32,2017,44046,1121,-30,1091,386,730
32023,023,32,2018,45328,1747,-43,1704,357,783
32023,023,32,2019,46845,1974,-24,1950,410,838
32023,023,32,2020,48054,1672,-11,1661,417,861
32027,027,32,2010,6734,-11,0,-11,13,17
32027,027,32,2011,6609,-123,-3,-126,55,55
32027,027,32,2012,6752,129,-2,127,62,52
32027,027,32,2013,6846,75,1,76,61,46
32027,027,32,2014,6703,-167,-1,-168,66,45
32027,027,32,2015,6620,-90,1,-89,49,44
32027,027,32,2016,6582,-49,-1,-50,56,43
32027,027,32,2017,6475,-106,0,-106,52,52
32027,027,32,2018,6696,220,0,220,57,57
32027,027,32,2019,6628,-53,0,-53,44,60
32027,027,32,2020,6573,-47,1,-46,50,58
32029,029,32,2010,3997,-16,0,-16,3,4
32029,029,32,2011,3905,-79,0,-79,20,33
32029,029,32,2012,3838,-56,0,-56,22,34
32029,029,32,2013,3795,-21,0,-21,12,35
32029,029,32,2014,3801,17,0,17,21,31
32029,029,32,2015,3881,78,-2,76,14,12
32029,029,32,2016,4004,120,-2,118,20,15
32029,029,32,2017,4001,16,-1,15,16,34
32029,029,32,2018,4027,62,-1,61,12,47
32029,029,32,2019,4193,181,-1,180,20,35
32029,029,32,2020,4207,30,-1,29,22,36
32031,031,32,2010,421969,16,64,80,1415,916
32031,031,32,2011,424066,173,-51,122,5369,3380
32031,031,32,2012,427490,1430,175,1605,5201,3367
32031,031,32,2013,431255,1727,196,1923,5427,3557
32031,031,32,2014,436515,3424,110,3534,5333,3650
32031,031,32,2015,442617,3986,400,4386,5460,3769
32031,031,32,2016,449990,5708,-1,5707,5532,3890
32031,031,32,2017,456864,5782,-4,5778,5226,4168
32031,031,32,2018,464593,6591,-316,6275,5344,3931
32031,031,32,2019,472381,6281,253,6534,5345,4103
32031,031,32,2020,477082,3531,209,3740,5388,4440
32033,033,32,2010,10027,16,1,17,30,46
32033,033,32,2011,10129,78,-2,76,116,89
32033,033,32,2012,10022,-139,-3,-142,114,83
32033,033,32,2013,10052,27,1,28,87,83
32033,033,32,2014,10041,-27,2,-25,98,84
32033,033,32,2015,9875,-172,13,-159,84,93
32033,033,32,2016,9746,-131,5,-126,107,110
32033,033,32,2017,9628,-154,3,-151,108,74
32033,033,32,2018,9532,-102,2,-100,100,96
32033,033,32,2019,9478,-86,5,-81,89,63
32033,033,32,2020,9466,-20,3,-17,93,87
32510,510,32,2010,54983,-256,-4,-260,143,187
32510,510,32,2011,54687,-206,-40,-246,584,633
32510,510,32,2012,54330,-202,-43,-245,551,657
32510,510,32,2013,53746,-452,-15,-467,572,699
32510,510,32,2014,54112,437,4,441,552,630
32510,510,32,2015,54152,27,37,64,629,648
32510,510,32,2016,54323,376,-16,360,612,800
32510,510,32,2017,54684,517,-24,493,595,728
32510,510,32,2018,55287,818,-41,777,588,765
32510,510,32,2019,55894,808,-7,801,596,789
32510,510,32,2020,56034,325,1,326,597,786
33001,001,33,2010,60101,-7,16,9,152,128
33001,001,33,2011,60339,135,123,258,586,603
33001,001,33,2012,60450,137,82,219,525,620
33001,001,33,2013,60257,-147,78,-69,531,651
33001,001,33,2014,60313,143,36,179,528,640
33001,001,33,2015,60408,198,59,257,530,688
33001,001,33,2016,60774,492,49,541,509,683
33001,001,33,2017,60907,348,32,380,497,741
33001,001,33,2018,61242,574,31,605,490,758
33001,001,33,2019,61398,416,44,460,477,779
33001,001,33,2020,61551,501,30,531,466,841
33003,003,33,2010,47834,37,5,42,95,122
33003,003,33,2011,47691,-36,29,-7,380,514
33003,003,33,2012,47716,69,47,116,369,451
33003,003,33,2013,47548,-51,35,-16,357,499
33003,003,33,2014,47470,81,31,112,344,522
33003,003,33,2015,47442,116,28,144,376,541
33003,003,33,2016,47527,265,19,284,330,524
33003,003,33,2017,48176,842,15,857,330,543
33003,003,33,2018,48690,792,13,805,302,596
33003,003,33,2019,48745,279,17,296,337,578
33003,003,33,2020,49167,711,18,729,323,624
33005,005,33,2010,77063,-98,2,-96,186,149
33005,005,33,2011,76965,-197,55,-142,742,698
33005,005,33,2012,76957,-67,72,5,714,719
33005,005,33,2013,76787,-231,62,-169,701,700
33005,005,33,2014,76514,-310,81,-229,625,663
33005,005,33,2015,76390,-207,126,-81,643,679
33005,005,33,2016,76104,-346,108,-238,691,738
33005,005,33,2017,76062,12,51,63,645,743
33005,005,33,2018,75925,-29,47,18,652,803
33005,005,33,2019,75880,3,66,69,636,751
33005,005,33,2020,76228,403,56,459,643,755
33007,007,33,2010,32970,-71,4,-67,82,98
33007,007,33,2011,32512,-295,15,-280,255,434
33007,007,33,2012,31980,-386,13,-373,223,391
33007,007,33,2013,31952,113,4,117,262,405
33007,007,33,2014,32787,980,3,983,261,453
33007,007,33,2015,32351,-266,9,-257,257,436
33007,007,33,2016,31923,-207,13,-194,242,476
33007,007,33,2017,31418,-313,6,-307,236,435
33007,007,33,2018,31490,323,6,329,221,479
33007,007,33,2019,31421,111,9,120,245,434
33007,007,33,2020,31174,-45,9,-36,240,450
33009,009,33,2010,89133,-29,45,16,181,189
33009,009,33,2011,89304,-238,405,167,759,755
33009,009,33,2012,89673,-23,385,362,796,770
33009,009,33,2013,89975,120,271,391,726,800
33009,009,33,2014,90041,-126,260,134,769,827
33009,009,33,2015,89566,-778,308,-470,794,803
33009,009,33,2016,90212,371,378,749,707,808
33009,009,33,2017,90176,-164,258,94,718,844
33009,009,33,2018,90206,-12,240,228,685,879
33009,009,33,2019,90369,98,267,365,680,882
33009,009,33,2020,90691,335,218,553,675,909
33011,011,33,2010,401064,-404,280,-124,1131,635
33011,011,33,2011,402832,-1365,1534,169,4547,2944
33011,011,33,2012,404439,-1411,1718,307,4309,2973
33011,011,33,2013,405417,-1622,1281,-341,4367,3026
33011,011,33,2014,407455,-420,1434,1014,4122,3034
33011,011,33,2015,409229,-993,1979,986,4231,3407
33011,011,33,2016,411591,-528,1969,1441,4208,3269
33011,011,33,2017,413545,-271,1470,1199,4255,3483
33011,011,33,2018,414917,-589,1396,807,4086,3517
33011,011,33,2019,417738,624,1403,2027,4218,3436
33011,011,33,2020,418735,-677,1162,485,4196,3708
33013,013,33,2010,146395,-119,55,-64,355,340
33013,013,33,2011,146894,4,317,321,1424,1243
33013,013,33,2012,147149,-144,400,256,1298,1267
33013,013,33,2013,147555,-112,380,268,1391,1243
33013,013,33,2014,148252,241,488,729,1331,1333
33013,013,33,2015,148770,94,540,634,1320,1418
33013,013,33,2016,149246,-59,543,484,1360,1363
33013,013,33,2017,150054,564,363,927,1297,1409
33013,013,33,2018,150981,719,336,1055,1309,1432
33013,013,33,2019,151606,402,412,814,1283,1474
33013,013,33,2020,152622,860,317,1177,1273,1437
33015,015,33,2010,295300,-23,59,36,638,557
33015,015,33,2011,296241,273,296,569,2587,2209
33015,015,33,2012,298250,1231,347,1578,2512,2041
33015,015,33,2013,299603,628,310,938,2609,2142
33015,015,33,2014,301596,1334,350,1684,2598,2245
33015,015,33,2015,302975,747,593,1340,2607,2529
33015,015,33,2016,304748,1066,403,1469,2745,2420
33015,015,33,2017,306970,1865,233,2098,2642,2502
33015,015,33,2018,308377,1107,179,1286,2709,2574
33015,015,33,2019,309647,980,229,1209,2631,2570
33015,015,33,2020,311307,1540,197,1737,2674,2754
33017,017,33,2010,123203,-83,30,-53,319,204
33017,017,33,2011,124157,317,267,584,1296,924
33017,017,33,2012,124823,27,332,359,1219,891
33017,017,33,2013,125109,-310,281,-29,1269,946
33017,017,33,2014,126652,974,332,1306,1253,1037
33017,017,33,2015,127174,-56,456,400,1199,1062
33017,017,33,2016,128481,685,497,1182,1219,1097
33017,017,33,2017,130034,1200,328,1528,1187,1170
33017,017,33,2018,130042,-313,316,3,1174,1168
33017,017,33,2019,130716,356,382,738,1139,1208
33017,017,33,2020,131533,508,299,807,1156,1155
33019,019,33,2010,43744,-8,5,-3,130,116
33019,019,33,2011,43509,-269,37,-232,414,418
33019,019,33,2012,43240,-334,46,-288,409,391
33019,019,33,2013,43069,-109,32,-77,385,473
33019,019,33,2014,43177,114,19,133,383,400
33019,019,33,2015,43175,9,4,13,418,427
33019,019,33,2016,43088,-12,16,4,370,458
33019,019,33,2017,43053,41,7,48,397,478
33019,019,33,2018,43194,210,6,216,374,448
33019,019,33,2019,43263,129,13,142,391,464
33019,019,33,2020,43267,108,7,115,370,481
34001,001,34,2010,274654,-351,232,-119,801,550
34001,001,34,2011,274635,-2001,1137,-864,3409,2569
34001,001,34,2012,274657,-1809,910,-899,3377,2465
34001,001,34,2013,274360,-1711,834,-877,3238,2651
34001,001,34,2014,272634,-3256,827,-2429,3179,2533
34001,001,34,2015,270206,-3718,878,-2840,3010,2633
34001,001,34,2016,267212,-3943,733,-3210,2885,2682
34001,001,34,2017,265446,-2594,818,-1776,2813,2809
34001,001,34,2018,263994,-2081,519,-1562,2842,2736
34001,001,34,2019,263653,-508,310,-198,2747,2895
34001,001,34,2020,262945,-719,295,-424,2761,3055
34003,003,34,2010,906293,-79,670,591,2374,1680
34003,003,34,2011,912024,-407,3794,3387,9350,6980
34003,003,34,2012,916299,-698,3001,2303,8980,6865
34003,003,34,2013,920021,-862,2830,1968,9232,7329
34003,003,34,2014,923475,-1804,3029,1225,9271,6936
34003,003,34,2015,926481,-3407,4141,734,9432,7117
34003,003,34,2016,928381,-4569,3793,-776,9659,6976
34003,003,34,2017,932449,-2389,4503,2114,9276,7289
34003,003,34,2018,932897,-3666,2092,-1574,9303,7267
34003,003,34,2019,932256,-4450,2264,-2186,9031,7490
34003,003,34,2020,930394,-4632,1783,-2849,8901,7939
34005,005,34,2010,449125,-31,193,162,1213,932
34005,005,34,2011,450250,-457,537,80,4758,3701
34005,005,34,2012,450667,-1258,745,-513,4663,3693
34005,005,34,2013,448992,-2791,547,-2244,4477,3931
34005,005,34,2014,449806,-414,534,120,4605,3821
34005,005,34,2015,447906,-3083,743,-2340,4534,4101
34005,005,34,2016,447092,-1808,551,-1257,4433,3984
34005,005,34,2017,446229,-1549,594,-955,4396,4293
34005,005,34,2018,445429,-1226,244,-982,4382,4194
34005,005,34,2019,446160,339,222,561,4390,4220
34005,005,34,2020,446596,280,214,494,4331,4404
34007,007,34,2010,513283,-1020,227,-793,1643,1124
34007,007,34,2011,512610,-3748,996,-2752,6568,4500
34007,007,34,2012,511636,-3995,911,-3084,6459,4377
34007,007,34,2013,509983,-4324,992,-3332,6315,4684
34007,007,34,2014,508409,-4413,1048,-3365,6315,4566
34007,007,34,2015,507760,-3581,1392,-2189,6231,4691
34007,007,34,2016,507119,-3485,1341,-2144,6082,4581
34007,007,34,2017,506488,-3411,1564,-1847,6078,4869
34007,007,34,2018,506685,-2163,1268,-895,6110,5014
34007,007,34,2019,506503,-1756,617,-1139,6073,5125
34007,007,34,2020,506809,-1222,646,-576,6100,5251
34009,009,34,2010,97222,52,39,91,236,351
34009,009,34,2011,96522,-473,159,-314,893,1277
34009,009,34,2012,96267,-122,174,52,960,1246
34009,009,34,2013,95540,-334,113,-221,889,1384
34009,009,34,2014,94961,-323,119,-204,927,1288
34009,009,34,2015,94330,-395,153,-242,922,1302
34009,009,34,2016,93825,-216,105,-111,877,1264
34009,009,34,2017,93283,-100,108,8,776,1319
34009,009,34,2018,92604,-240,125,-115,792,1349
34009,009,34,2019,92247,171,-13,158,816,1329
34009,009,34,2020,91546,-151,32,-119,813,1393
34011,011,34,2010,156667,-193,62,-131,565,374
34011,011,34,2011,157028,-777,329,-448,2244,1435
34011,011,34,2012,156862,-1122,210,-912,2150,1407
34011,011,34,2013,155912,-1835,283,-1552,2027,1461
34011,011,34,2014,155887,-830,337,-493,2011,1534
34011,011,34,2015,154580,-2228,438,-1790,2020,1559
34011,011,34,2016,153003,-2479,455,-2024,1896,1462
34011,011,34,2017,151147,-2412,362,-2050,1841,1659
34011,011,34,2018,150274,-1736,530,-1206,1919,1598
34011,011,34,2019,148995,-1480,-53,-1533,1851,1599
34011,011,34,2020,147008,-2290,87,-2203,1850,1630
34013,013,34,2010,784017,-1913,869,-1044,2579,1432
34013,013,34,2011,785576,-7039,4041,-2998,10509,5982
34013,013,34,2012,785092,-8690,3382,-5308,10382,5711
34013,013,34,2013,786685,-6737,3596,-3141,10420,5737
34013,013,34,2014,788796,-5971,3454,-2517,10352,5733
34013,013,34,2015,790546,-7624,4894,-2730,10189,5737
34013,013,34,2016,793073,-7164,4980,-2184,10462,5760
34013,013,34,2017,797222,-6191,6133,-58,10382,6176
34013,013,34,2018,800530,-5362,4156,-1206,10483,5969
34013,013,34,2019,802162,-6116,3781,-2335,10230,6277
34013,013,34,2020,800501,-8188,3010,-5178,10253,6750
34015,015,34,2010,289158,18,54,72,861,509
34015,015,34,2011,289703,-399,203,-196,3152,2406
34015,015,34,2012,289839,-796,190,-606,3126,2370
34015,015,34,2013,289935,-493,230,-263,2968,2587
34015,015,34,2014,290742,196,193,389,3022,2555
34015,015,34,2015,291022,-399,236,-163,2979,2512
34015,015,34,2016,290795,-711,246,-465,2784,2540
34015,015,34,2017,291088,-160,279,119,2937,2751
34015,015,34,2018,291754,375,208,583,2908,2812
34015,015,34,2019,291842,45,98,143,2760,2816
34015,015,34,2020,293245,1509,109,1618,2719,2937
34017,017,34,2010,635648,-1573,1386,-187,2429,899
34017,017,34,2011,645658,-3498,7046,3548,10341,3880
34017,017,34,2012,652373,-5697,5838,141,10274,3672
34017,017,34,2013,657101,-7824,6042,-1782,10353,3882
34017,017,34,2014,660312,-10092,6641,-3451,10272,3750
34017,017,34,2015,664595,-11343,9022,-2321,10237,3712
34017,017,34,2016,668673,-11111,8388,-2723,10453,3672
34017,017,34,2017,672858,-12053,9783,-2270,10189,3735
34017,017,34,2018,672390,-12700,5755,-6945,10291,3807
34017,017,34,2019,674030,-10387,5861,-4526,10143,3936
34017,017,34,2020,671666,-12630,4638,-7992,10142,4459
34019,019,34,2010,127323,-75,28,-47,243,234
34019,019,34,2011,127348,-272,146,-126,985,839
34019,019,34,2012,126658,-908,88,-820,925,815
34019,019,34,2013,126443,-290,107,-183,839,870
34019,019,34,2014,125902,-638,61,-577,918,896
34019,019,34,2015,125569,-479,153,-326,900,911
34019,019,34,2016,124976,-793,131,-662,930,864
34019,019,34,2017,125076,-35,166,131,931,954
34019,019,34,2018,125265,-14,97,83,993,881
34019,019,34,2019,125201,-185,92,-93,946,913
34019,019,34,2020,124797,-410,82,-328,973,1044
34021,021,34,2010,367717,-493,392,-101,1053,718
34021,021,34,2011,367407,-3523,1760,-1763,4384,2951
34021,021,34,2012,368628,-1532,1429,-103,4175,2809
34021,021,34,2013,369534,-2139,1642,-497,4214,2811
34021,021,34,2014,369031,-3660,1771,-1889,4161,2836
34021,021,34,2015,368266,-4188,2245,-1943,4161,3020
34021,021,34,2016,367929,-3868,2211,-1657,4145,2842
34021,021,34,2017,368489,-3202,2574,-628,4092,2919
34021,021,34,2018,368720,-2543,1665,-878,3983,2883
34021,021,34,2019,368047,-3014,1408,-1606,3951,3031
34021,021,34,2020,367239,-2707,1184,-1523,3920,3219
34023,023,34,2010,810813,-1402,979,-423,2484,1379
34023,023,34,2011,815253,-5214,5300,86,10092,5756
34023,023,34,2012,819389,-4424,4081,-343,9957,5472
34023,023,34,2013,821811,-5645,4106,-1539,9749,5827
34023,023,34,2014,824331,-5873,4609,-1264,9460,5710
34023,023,34,2015,825471,-9059,6365,-2694,9585,5830
34023,023,34,2016,825298,-9805,5922,-3883,9374,5705
34023,023,34,2017,826972,-8349,6668,-1681,9373,6062
34023,023,34,2018,825677,-7880,3504,-4376,9074,6033
34023,023,34,2019,824394,-7427,3511,-3916,8856,6247
34023,023,34,2020,822736,-6424,2837,-3587,8607,6707
34025,025,34,2010,630454,-328,202,-126,1608,1347
34025,025,34,2011,629144,-2864,702,-2162,6235,5390
34025,025,34,2012,627682,-2994,399,-2595,6221,5125
34025,025,34,2013,626964,-1756,513,-1243,6005,5479
34025,025,34,2014,625581,-2699,494,-2205,5996,5174
34025,025,34,2015,624180,-2407,732,-1675,5778,5490
34025,025,34,2016,623055,-2395,626,-1769,5900,5248
34025,025,34,2017,622122,-1874,690,-1184,5741,5481
34025,025,34,2018,620859,-1608,294,-1314,5715,5658
34025,025,34,2019,619687,-1407,198,-1209,5906,5872
34025,025,34,2020,618381,-1032,164,-868,5799,6241
34027,027,34,2010,492623,-326,308,-18,1267,886
34027,027,34,2011,494801,-458,1443,985,4818,3611
34027,027,34,2012,495623,-1233,1121,-112,4618,3636
34027,027,34,2013,496050,-1451,1084,-367,4595,3776
34027,027,34,2014,494931,-3050,1039,-2011,4669,3805
34027,027,34,2015,494370,-3077,1509,-1568,4741,3744
34027,027,34,2016,493831,-2860,1343,-1517,4653,3678
34027,027,34,2017,493994,-2239,1546,-693,4693,3837
34027,027,34,2018,493084,-2365,788,-1577,4678,4017
34027,027,34,2019,491577,-2674,683,-1991,4478,3999
34027,027,34,2020,491087,-1282,570,-712,4419,4204
34029,029,34,2010,577574,637,97,734,1956,1635
34029,029,34,2011,578922,308,221,529,8113,7249
34029,029,34,2012,580013,83,172,255,7965,6982
34029,029,34,2013,582166,1047,208,1255,8144,7175
34029,029,34,2014,584563,1010,296,1306,8141,6939
34029,029,34,2015,587238,1046,430,1476,8510,7229
34029,029,34,2016,591142,2108,402,2510,8644,7210
34029,029,34,2017,595564,3068,296,3364,8535,7449
34029,029,34,2018,601649,4541,106,4647,8815,7357
34029,029,34,2019,607498,4196,-2,4194,9032,7358
34029,029,34,2020,614237,5529,5,5534,9040,7815
34031,031,34,2010,502010,-1048,457,-591,1813,834
34031,031,34,2011,503257,-4772,2502,-2270,7143,3646
34031,031,34,2012,503531,-5398,2012,-3386,7068,3490
34031,031,34,2013,503815,-5189,2180,-3009,6917,3682
34031,031,34,2014,504483,-4916,2167,-2749,6921,3562
34031,031,34,2015,504556,-6393,3207,-3186,6953,3736
34031,031,34,2016,504001,-6999,3141,-3858,6884,3603
34031,031,34,2017,504403,-6327,3609,-2718,6847,3745
34031,031,34,2018,503192,-6621,2497,-4124,6684,3786
34031,031,34,2019,501838,-5961,1995,-3966,6486,3872
34031,031,34,2020,500382,-5366,1662,-3704,6378,4130
34033,033,34,2010,65983,-94,6,-88,202,204
34033,033,34,2011,65880,-154,25,-129,728,700
34033,033,34,2012,65427,-490,6,-484,718,695
34033,033,34,2013,64801,-645,23,-622,697,716
34033,033,34,2014,64342,-478,55,-423,671,712
34033,033,34,2015,63754,-636,89,-547,667,711
34033,033,34,2016,63256,-509,97,-412,664,752
34033,033,34,2017,62944,-287,81,-206,664,768
34033,033,34,2018,62776,-213,118,-95,672,746
34033,033,34,2019,62341,-296,-8,-304,630,761
34033,033,34,2020,62451,289,28,317,597,803
34035,035,34,2010,324120,33,249,282,849,456
34035,035,34,2011,326277,-410,1095,685,3653,2180
34035,035,34,2012,327462,-875,886,11,3398,2209
34035,035,34,2013,329052,-460,936,476,3441,2301
34035,035,34,2014,329378,-1575,879,-696,3320,2291
34035,035,34,2015,329682,-2018,1240,-778,3445,2367
34035,035,34,2016,330003,-1811,1165,-646,3361,2394
34035,035,34,2017,330650,-1452,1347,-105,3169,2421
34035,035,34,2018,330772,-1227,588,-639,3185,2427
34035,035,34,2019,329998,-2077,648,-1429,3200,2557
34035,035,34,2020,329331,-1515,491,-1024,3139,2783
34037,037,34,2010,148859,-200,21,-179,382,287
34037,037,34,2011,148185,-1004,101,-903,1333,1109
34037,037,34,2012,147003,-1470,55,-1415,1319,1125
34037,037,34,2013,145672,-1528,44,-1484,1254,1133
34037,037,34,2014,144639,-1098,26,-1072,1223,1206
34037,037,34,2015,143059,-1656,46,-1610,1184,1171
34037,037,34,2016,142004,-1114,28,-1086,1181,1155
34037,037,34,2017,141267,-705,45,-660,1135,1212
34037,037,34,2018,140995,-244,5,-239,1214,1243
34037,037,34,2019,140710,-185,-4,-189,1220,1318
34037,037,34,2020,140002,-555,14,-541,1210,1378
34039,039,34,2010,537336,-332,568,236,1739,1016
34039,039,34,2011,539918,-3275,2805,-470,6985,3938
34039,039,34,2012,542977,-1913,2167,254,6780,3907
34039,039,34,2013,546051,-1906,2324,418,6745,4029
34039,039,34,2014,548052,-3466,2371,-1095,6868,3772
34039,039,34,2015,549954,-4123,3229,-894,6777,3984
34039,039,34,2016,552814,-3311,3089,-222,6891,3811
34039,039,34,2017,554695,-4578,3688,-890,6697,3931
34039,039,34,2018,556475,-3479,2424,-1055,6845,4022
34039,039,34,2019,556664,-4663,2188,-2475,6752,4099
34039,039,34,2020,555394,-5241,1735,-3506,6643,4423
34041,041,34,2010,108572,-83,31,-52,251,260
34041,041,34,2011,108154,-600,141,-459,1002,960
34041,041,34,2012,107586,-772,125,-647,1001,932
34041,041,34,2013,106933,-744,144,-600,944,1005
34041,041,34,2014,107022,-199,153,-46,1031,884
34041,041,34,2015,106787,-284,195,-89,856,993
34041,041,34,2016,106102,-717,161,-556,865,996
34041,041,34,2017,105761,-353,189,-164,911,1084
34041,041,34,2018,105709,-191,135,-56,1013,1008
34041,041,34,2019,105455,-284,84,-200,973,1026
34041,041,34,2020,105624,134,88,222,1008,1065
35001,001,35,2010,663940,349,196,545,2132,1165
35001,001,35,2011,670356,1346,1695,3041,8437,5048
35001,001,35,2012,673725,-1488,1503,15,8470,4968
35001,001,35,2013,676467,-2407,2044,-363,8268,5092
35001,001,35,2014,676120,-3834,701,-3133,8086,5231
35001,001,35,2015,676440,-3444,1340,-2104,7936,5472
35001,001,35,2016,677883,-1686,1053,-633,7708,5595
35001,001,35,2017,678280,-1948,785,-1163,7349,5755
35001,001,35,2018,677929,-2476,718,-1758,7240,5811
35001,001,35,2019,679425,-777,1241,464,7048,6020
35001,001,35,2020,681666,738,991,1729,6931,6443
35003,003,35,2010,3748,21,0,21,1,3
35003,003,35,2011,3716,-5,0,-5,16,42
35003,003,35,2012,3634,-72,-1,-73,28,39
35003,003,35,2013,3586,-19,1,-18,18,47
35003,003,35,2014,3550,-29,0,-29,24,31
35003,003,35,2015,3480,-53,0,-53,25,42
35003,003,35,2016,3525,61,0,61,22,39
35003,003,35,2017,3557,62,0,62,12,41
35003,003,35,2018,3523,-4,0,-4,18,47
35003,003,35,2019,3507,13,0,13,11,40
35003,003,35,2020,3623,136,0,136,11,30
35005,005,35,2010,65721,26,3,29,234,182
35005,005,35,2011,65721,-353,61,-292,956,663
35005,005,35,2012,65780,-215,18,-197,918,652
35005,005,35,2013,66033,-138,96,-42,947,644
35005,005,35,2014,65839,-505,20,-485,948,659
35005,005,35,2015,65856,-391,131,-260,915,636
35005,005,35,2016,65684,-503,63,-440,917,648
35005,005,35,2017,65091,-828,81,-747,858,709
35005,005,35,2018,64488,-794,17,-777,841,669
35005,005,35,2019,64586,-159,100,-59,816,659
35005,005,35,2020,64711,-90,91,1,798,677
35006,006,35,2010,27319,23,6,29,105,34
35006,006,35,2011,27492,-13,22,9,426,262
35006,006,35,2012,27421,-260,34,-226,372,224
35006,006,35,2013,27414,-212,59,-153,419,271
35006,006,35,2014,27156,-426,12,-414,416,268
35006,006,35,2015,27046,-214,13,-201,347,256
35006,006,35,2016,27061,-54,14,-40,345,289
35006,006,35,2017,26921,-228,13,-215,314,240
35006,006,35,2018,26797,-187,18,-169,315,270
35006,006,35,2019,26681,-149,20,-129,291,278
35006,006,35,2020,26354,-339,16,-323,297,298
35007,007,35,2010,13725,-24,2,-22,30,33
35007,007,35,2011,13620,-143,33,-110,136,132
35007,007,35,2012,13245,-362,11,-351,136,170
35007,007,35,2013,13067,-173,20,-153,127,153
35007,007,35,2014,12703,-352,6,-346,137,167
35007,007,35,2015,12434,-273,7,-266,132,137
35007,007,35,2016,12261,-131,9,-122,113,163
35007,007,35,2017,12178,-62,12,-50,119,150
35007,007,35,2018,12097,-55,8,-47,100,134
35007,007,35,2019,12068,-46,18,-28,113,112
35007,007,35,2020,11927,-112,12,-100,109,150
35009,009,35,2010,48977,357,55,412,216,65
35009,009,35,2011,49836,87,191,278,953,372
35009,009,35,2012,50830,4,414,418,948,388
35009,009,35,2013,50810,-867,315,-552,909,386
35009,009,35,2014,51153,-376,128,-248,959,358
35009,009,35,2015,50344,-1510,228,-1282,896,442
35009,009,35,2016,50334,-552,94,-458,873,423
35009,009,35,2017,49889,-949,54,-895,866,419
35009,009,35,2018,49413,-832,-56,-888,828,416
35009,009,35,2019,49083,-813,63,-750,810,387
35009,009,35,2020,48793,-743,55,-688,802,399
35011,011,35,2010,2031,1,0,1,7,1
35011,011,35,2011,2001,-37,2,-35,23,18
35011,011,35,2012,1958,-33,1,-32,20,31
35011,011,35,2013,1931,-4,4,0,10,38
35011,011,35,2014,1865,-49,4,-45,12,35
35011,011,35,2015,1877,19,1,20,19,27
35011,011,35,2016,1838,-21,2,-19,14,35
35011,011,35,2017,1810,-16,1,-15,13,27
35011,011,35,2018,1781,-17,1,-16,14,25
35011,011,35,2019,1741,-35,1,-34,10,17
35011,011,35,2020,1673,-57,1,-56,10,22
35013,013,35,2010,210096,566,-59,507,747,398
35013,013,35,2011,213123,858,232,1090,3385,1444
35013,013,35,2012,214452,-502,205,-297,3147,1494
35013,013,35,2013,214285,-2374,555,-1819,3066,1445
35013,013,35,2014,213938,-1883,110,-1773,2932,1524
35013,013,35,2015,214028,-1802,431,-1371,2922,1463
35013,013,35,2016,214664,-938,292,-646,2824,1537
35013,013,35,2017,216218,64,275,339,2757,1530
35013,013,35,2018,217470,208,141,349,2533,1624
35013,013,35,2019,218864,-96,442,346,2664,1621
35013,013,35,2020,221262,1206,360,1566,2598,1777
35015,015,35,2010,53912,-2,0,-2,197,104
35015,015,35,2011,54082,-38,22,-16,765,576
35015,015,35,2012,54437,115,53,168,700,509
35015,015,35,2013,55694,816,119,935,894,586
35015,015,35,2014,56720,668,63,731,864,585
35015,015,35,2015,57756,532,123,655,914,538
35015,015,35,2016,57669,-427,62,-365,858,581
35015,015,35,2017,57128,-864,59,-805,811,550
35015,015,35,2018,57718,354,25,379,801,590
35015,015,35,2019,58394,351,74,425,852,599
35015,015,35,2020,58418,-284,53,-231,833,584
35017,017,35,2010,29386,-122,11,-111,94,114
35017,017,35,2011,29350,-99,65,-34,320,320
35017,017,35,2012,29260,-63,23,-40,324,370
35017,017,35,2013,29109,-128,17,-111,295,330
35017,017,35,2014,28876,-239,-3,-242,320,308
35017,017,35,2015,28369,-474,-6,-480,302,332
35017,017,35,2016,28061,-243,3,-240,302,368
35017,017,35,2017,27671,-309,6,-303,266,351
35017,017,35,2018,27274,-350,-2,-352,266,310
35017,017,35,2019,26941,-212,6,-206,249,374
35017,017,35,2020,27007,195,7,202,233,368
35019,019,35,2010,4696,11,0,11,13,16
35019,019,35,2011,4626,-78,0,-78,46,40
35019,019,35,2012,4593,-35,-1,-36,36,34
35019,019,35,2013,4536,-61,0,-61,51,49
35019,019,35,2014,4446,-85,0,-85,40,46
35019,019,35,2015,4355,-83,0,-83,36,44
35019,019,35,2016,4387,6,0,6,56,31
35019,019,35,2017,4418,46,0,46,37,52
35019,019,35,2018,4323,-71,0,-71,39,62
35019,019,35,2019,4278,-36,0,-36,39,47
35019,019,35,2020,4275,1,0,1,37,42
35021,021,35,2010,690,-3,0,-3,1,3
35021,021,35,2011,712,31,0,31,4,14
35021,021,35,2012,700,-10,0,-10,5,7
35021,021,35,2013,689,-13,1,-12,7,6
35021,021,35,2014,691,2,0,2,5,5
35021,021,35,2015,717,29,0,29,3,7
35021,021,35,2016,685,-27,0,-27,5,9
35021,021,35,2017,681,1,0,1,3,8
35021,021,35,2018,649,-24,0,-24,2,10
35021,021,35,2019,636,-9,0,-9,3,8
35021,021,35,2020,638,6,0,6,2,4
35023,023,35,2010,4865,-46,0,-46,12,1
35023,023,35,2011,4845,-38,0,-38,54,35
35023,023,35,2012,4783,-76,1,-75,63,53
35023,023,35,2013,4627,-176,3,-173,60,50
35023,023,35,2014,4551,-74,1,-73,47,51
35023,023,35,2015,4441,-121,4,-117,58,51
35023,023,35,2016,4327,-119,1,-118,58,54
35023,023,35,2017,4303,-35,1,-34,61,52
35023,023,35,2018,4233,-56,1,-55,51,66
35023,023,35,2019,4203,-23,1,-22,35,41
35023,023,35,2020,4106,-87,1,-86,39,50
35025,025,35,2010,64598,-207,16,-191,247,194
35025,025,35,2011,65135,-164,159,-5,1056,514
35025,025,35,2012,66374,524,96,620,1132,518
35025,025,35,2013,68631,1310,271,1581,1162,512
35025,025,35,2014,70178,865,49,914,1162,546
35025,025,35,2015,71480,462,193,655,1186,539
35025,025,35,2016,70275,-1941,97,-1844,1154,526
35025,025,35,2017,69031,-1866,132,-1734,1033,552
35025,025,35,2018,69538,-70,42,-28,1041,506
35025,025,35,2019,71123,914,140,1054,1132,599
35025,025,35,2020,71830,10,114,124,1130,550
35027,027,35,2010,20451,-11,-2,-13,39,65
35027,027,35,2011,20411,-61,2,-59,209,189
35027,027,35,2012,20202,-208,-7,-215,188,187
35027,027,35,2013,19987,-202,9,-193,181,203
35027,027,35,2014,19610,-376,6,-370,186,198
35027,027,35,2015,19365,-263,43,-220,189,216
35027,027,35,2016,19423,30,35,65,185,191
35027,027,35,2017,19502,111,49,160,163,243
35027,027,35,2018,19608,144,20,164,174,231
35027,027,35,2019,19730,113,58,171,179,227
35027,027,35,2020,19939,213,47,260,170,219
35028,028,35,2010,17995,41,8,49,37,43
35028,028,35,2011,18237,52,113,165,187,110
35028,028,35,2012,18248,-131,89,-42,168,121
35028,028,35,2013,17970,-436,122,-314,162,139
35028,028,35,2014,17830,-271,53,-218,182,111
35028,028,35,2015,17848,-90,83,-7,151,125
35028,028,35,2016,18241,280,73,353,166,127
35028,028,35,2017,18778,428,49,477,186,128
35028,028,35,2018,19018,168,53,221,166,146
35028,028,35,2019,19383,243,68,311,163,107
35028,028,35,2020,19462,-43,55,12,176,110
35029,029,35,2010,25082,-4,2,-2,84,93
35029,029,35,2011,25106,-58,-5,-63,381,292
35029,029,35,2012,24922,-270,-21,-291,389,285
35029,029,35,2013,24599,-432,0,-432,389,285
35029,029,35,2014,24430,-261,6,-255,394,313
35029,029,35,2015,24370,-213,46,-167,415,307
35029,029,35,2016,24373,-124,41,-83,399,312
35029,029,35,2017,24154,-351,44,-307,396,306
35029,029,35,2018,23904,-288,25,-263,331,317
35029,029,35,2019,23775,-285,58,-227,372,273
35029,029,35,2020,23905,21,52,73,344,287
35031,031,35,2010,71673,39,2,41,298,147
35031,031,35,2011,72340,-195,61,-134,1293,491
35031,031,35,2012,72379,-716,36,-680,1246,540
35031,031,35,2013,72682,-486,118,-368,1196,525
35031,031,35,2014,72814,-608,109,-499,1192,572
35031,031,35,2015,73485,66,121,187,1118,625
35031,031,35,2016,73040,-881,25,-856,989,580
35031,031,35,2017,72463,-819,29,-790,925,717
35031,031,35,2018,71974,-723,35,-688,844,647
35031,031,35,2019,71478,-731,50,-681,887,704
35031,031,35,2020,70824,-876,44,-832,856,677
35033,033,35,2010,4893,5,0,5,10,3
35033,033,35,2011,4782,-107,-3,-110,43,44
35033,033,35,2012,4683,-92,-2,-94,44,51
35033,033,35,2013,4694,19,0,19,40,49
35033,033,35,2014,4612,-77,0,-77,39,45
35033,033,35,2015,4609,2,0,2,49,53
35033,033,35,2016,4531,-66,0,-66,45,57
35033,033,35,2017,4530,-12,0,-12,41,30
35033,033,35,2018,4472,-54,0,-54,42,46
35033,033,35,2019,4490,29,0,29,29,40
35033,033,35,2020,4478,-2,0,-2,38,48
35035,035,35,2010,64405,358,71,429,207,95
35035,035,35,2011,65659,528,385,913,907,570
35035,035,35,2012,66240,-430,604,174,938,530
35035,035,35,2013,66347,-955,808,-147,813,564
35035,035,35,2014,65394,-1633,352,-1281,887,599
35035,035,35,2015,64838,-1426,547,-879,926,616
35035,035,35,2016,65723,241,329,570,954,640
35035,035,35,2017,66158,-98,209,111,948,620
35035,035,35,2018,66599,-28,186,158,912,626
35035,035,35,2019,67572,353,344,697,895,620
35035,035,35,2020,67967,-84,264,180,862,647
35037,037,35,2010,9065,37,0,37,31,45
35037,037,35,2011,9044,-10,-3,-13,122,130
35037,037,35,2012,8806,-247,-1,-248,117,114
35037,037,35,2013,8675,-104,9,-95,94,131
35037,037,35,2014,8467,-193,10,-183,88,116
35037,037,35,2015,8449,-13,25,12,82,112
35037,037,35,2016,8391,-42,16,-26,82,112
35037,037,35,2017,8291,-77,9,-68,94,128
35037,037,35,2018,8203,-50,6,-44,96,141
35037,037,35,2019,8243,23,9,32,93,83
35037,037,35,2020,8197,-48,8,-40,100,107
35039,039,35,2010,40286,-20,9,-11,158,77
35039,039,35,2011,40241,-310,28,-282,589,351
35039,039,35,2012,40191,-267,44,-223,576,405
35039,039,35,2013,40059,-431,68,-363,595,367
35039,039,35,2014,39726,-495,33,-462,546,425
35039,039,35,2015,39358,-538,40,-498,517,388
35039,039,35,2016,39225,-235,20,-215,509,426
35039,039,35,2017,39204,-103,19,-84,470,406
35039,039,35,2018,38979,-203,14,-189,425,459
35039,039,35,2019,38883,-95,26,-69,392,419
35039,039,35,2020,38521,-303,19,-284,397,474
35041,041,35,2010,20020,134,4,138,76,47
35041,041,35,2011,20429,265,17,282,284,158
35041,041,35,2012,20322,-267,24,-243,294,162
35041,041,35,2013,20033,-474,64,-410,280,167
35041,041,35,2014,19659,-606,29,-577,315,125
35041,041,35,2015,19157,-733,76,-657,296,152
35041,041,35,2016,19163,-167,37,-130,281,145
35041,041,35,2017,18889,-406,47,-359,252,170
35041,041,35,2018,18713,-306,24,-282,266,163
35041,041,35,2019,18501,-386,59,-327,246,132
35041,041,35,2020,18350,-270,45,-225,253,177
35043,043,35,2010,132437,548,15,563,371,159
35043,043,35,2011,134347,1151,105,1256,1599,948
35043,043,35,2012,135415,468,38,506,1472,888
35043,043,35,2013,136356,478,25,503,1445,991
35043,043,35,2014,137076,297,-15,282,1440,975
35043,043,35,2015,138586,1056,25,1081,1468,1035
35043,043,35,2016,140583,1554,32,1586,1471,1059
35043,043,35,2017,142832,1914,30,1944,1450,1145
35043,043,35,2018,145407,2350,49,2399,1386,1210
35043,043,35,2019,147045,1409,64,1473,1378,1209
35043,043,35,2020,148904,1694,58,1752,1365,1252
35045,045,35,2010,130209,-91,4,-87,460,201
35045,045,35,2011,129732,-1566,37,-1529,1921,878
35045,045,35,2012,129792,-952,35,-917,1867,898
35045,045,35,2013,129509,-1442,102,-1340,1936,900
35045,045,35,2014,129143,-1369,12,-1357,1908,938
35045,045,35,2015,128324,-1693,26,-1667,1857,1023
35045,045,35,2016,128011,-1063,16,-1047,1745,1010
35045,045,35,2017,127039,-1522,25,-1497,1624,1108
35045,045,35,2018,125652,-1790,19,-1771,1446,1065
35045,045,35,2019,124027,-1908,29,-1879,1434,1180
35045,045,35,2020,123312,-924,27,-897,1382,1199
35047,047,35,2010,29392,-47,6,-41,92,35
35047,047,35,2011,29352,-143,62,-81,321,280
35047,047,35,2012,29094,-409,74,-335,337,270
35047,047,35,2013,28825,-468,115,-353,351,276
35047,047,35,2014,28501,-439,73,-366,303,270
35047,047,35,2015,28223,-381,72,-309,312,284
35047,047,35,2016,27999,-219,45,-174,259,310
35047,047,35,2017,27737,-284,45,-239,272,295
35047,047,35,2018,27512,-226,52,-174,237,286
35047,047,35,2019,27337,-205,69,-136,254,294
35047,047,35,2020,27144,-189,54,-135,244,301
35049,049,35,2010,144526,97,76,173,340,213
35049,049,35,2011,145876,166,730,896,1484,1024
35049,049,35,2012,146774,224,369,593,1384,1054
35049,049,35,2013,147545,134,441,575,1323,1114
35049,049,35,2014,147876,77,55,132,1312,1081
35049,049,35,2015,148199,-19,165,146,1334,1134
35049,049,35,2016,148884,483,171,654,1252,1214
35049,049,35,2017,149687,552,153,705,1258,1153
35049,049,35,2018,150128,339,126,465,1198,1213
35049,049,35,2019,150951,681,216,897,1195,1264
35049,049,35,2020,151946,993,178,1171,1163,1336
35051,051,35,2010,12043,55,-1,54,19,30
35051,051,35,2011,12027,123,-4,119,92,229
35051,051,35,2012,11858,-7,-5,-12,76,232
35051,051,35,2013,11531,-188,-2,-190,113,249
35051,051,35,2014,11277,-120,1,-119,113,246
35051,051,35,2015,11252,77,4,81,124,229
35051,051,35,2016,11129,49,7,56,99,277
35051,051,35,2017,11094,119,8,127,98,260
35051,051,35,2018,10963,34,6,40,106,276
35051,051,35,2019,10886,25,9,34,91,201
35051,051,35,2020,10867,111,7,118,86,221
35053,053,35,2010,17791,-59,5,-54,52,72
35053,053,35,2011,17777,-132,22,-110,263,167
35053,053,35,2012,17471,-367,30,-337,199,179
35053,053,35,2013,17507,-87,50,-37,230,159
35053,053,35,2014,17255,-328,41,-287,216,189
35053,053,35,2015,17148,-188,66,-122,188,173
35053,053,35,2016,16989,-262,56,-206,227,181
35053,053,35,2017,16825,-175,26,-149,183,198
35053,053,35,2018,16649,-225,30,-195,177,158
35053,053,35,2019,16613,-132,39,-93,193,136
35053,053,35,2020,16541,-122,27,-95,185,163
35055,055,35,2010,32897,-38,5,-33,78,79
35055,055,35,2011,32896,-120,36,-84,339,255
35055,055,35,2012,32767,-212,40,-172,325,284
35055,055,35,2013,32961,80,98,178,296,278
35055,055,35,2014,32967,-52,23,-29,309,265
35055,055,35,2015,32806,-202,29,-173,304,290
35055,055,35,2016,32925,164,-4,160,270,310
35055,055,35,2017,32811,-72,1,-71,292,332
35055,055,35,2018,32708,-24,-7,-31,282,350
35055,055,35,2019,32752,102,0,102,241,299
35055,055,35,2020,32593,-78,0,-78,244,323
35057,057,35,2010,16399,-16,11,-5,41,12
35057,057,35,2011,16447,-41,57,16,172,140
35057,057,35,2012,16153,-365,49,-316,172,165
35057,057,35,2013,15821,-422,85,-337,141,146
35057,057,35,2014,15662,-167,35,-132,133,164
35057,057,35,2015,15592,-119,46,-73,159,156
35057,057,35,2016,15466,-130,15,-115,159,170
35057,057,35,2017,15510,14,27,41,166,163
35057,057,35,2018,15481,-53,18,-35,153,146
35057,057,35,2019,15442,-75,31,-44,154,148
35057,057,35,2020,15486,29,26,55,155,167
35059,059,35,2010,4541,-12,0,-12,15,15
35059,059,35,2011,4416,-124,2,-122,48,53
35059,059,35,2012,4408,12,1,13,37,55
35059,059,35,2013,4354,-60,1,-59,45,41
35059,059,35,2014,4259,-92,0,-92,39,46
35059,059,35,2015,4174,-70,1,-69,38,54
35059,059,35,2016,4166,1,-3,-2,39,44
35059,059,35,2017,4194,30,1,31,35,38
35059,059,35,2018,4099,-93,-1,-94,42,43
35059,059,35,2019,4043,-61,0,-61,42,37
35059,059,35,2020,4026,-17,5,-12,38,43
35061,061,35,2010,76805,85,5,90,218,90
35061,061,35,2011,76973,-273,52,-221,968,578
35061,061,35,2012,76798,-551,56,-495,907,589
35061,061,35,2013,76499,-675,92,-583,868,596
35061,061,35,2014,75892,-775,-1,-776,805,646
35061,061,35,2015,75665,-364,-6,-370,819,673
35061,061,35,2016,75639,-195,8,-187,836,673
35061,061,35,2017,75970,101,61,162,827,651
35061,061,35,2018,76452,334,55,389,826,728
35061,061,35,2019,76953,306,99,405,790,693
35061,061,35,2020,77574,536,70,606,783,767
36001,001,36,2010,304085,-594,243,-351,791,563
36001,001,36,2011,304627,-929,1072,143,3091,2689
36001,001,36,2012,305776,-116,1021,905,3124,2803
36001,001,36,2013,306661,-508,903,395,3195,2656
36001,001,36,2014,307246,-1053,1100,47,3170,2600
36001,001,36,2015,307521,-1313,1103,-210,3172,2668
36001,001,36,2016,307810,-1414,1218,-196,3212,2724
36001,001,36,2017,307919,-1171,915,-256,3108,2741
36001,001,36,2018,306691,-2050,700,-1350,2964,2846
36001,001,36,2019,304752,-2543,540,-2003,2863,2804
36001,001,36,2020,303654,-1447,470,-977,2831,2964
36003,003,36,2010,48973,-6,13,7,121,73
36003,003,36,2011,48808,-291,60,-231,538,473
36003,003,36,2012,48221,-660,57,-603,466,472
36003,003,36,2013,47918,-360,43,-317,498,489
36003,003,36,2014,47671,-348,52,-296,492,443
36003,003,36,2015,47352,-362,50,-312,502,510
36003,003,36,2016,47063,-363,58,-305,490,475
36003,003,36,2017,46669,-438,43,-395,494,496
36003,003,36,2018,46286,-374,39,-335,460,510
36003,003,36,2019,45915,-393,25,-368,471,474
36003,003,36,2020,45587,-307,26,-281,446,494
36005,005,36,2010,1386929,-3401,2720,-681,5428,2169
36005,005,36,2011,1396954,-16589,13327,-3262,22097,8901
36005,005,36,2012,1411087,-12441,13679,1238,21739,8949
36005,005,36,2013,1421498,-14083,12258,-1825,21403,9274
36005,005,36,2014,1430474,-16451,13185,-3266,21291,9224
36005,005,36,2015,1439480,-16399,13267,-3132,21482,9437
36005,005,36,2016,1443678,-21746,14235,-7511,21120,9479
36005,005,36,2017,1439956,-27069,12100,-14969,20755,9609
36005,005,36,2018,1432316,-29971,11458,-18513,20520,9732
36005,005,36,2019,1418187,-31170,8199,-22971,19565,10675
36005,005,36,2020,1401142,-30848,6795,-24053,19182,12017
36007,007,36,2010,200474,-355,95,-260,494,431
36007,007,36,2011,199367,-1414,416,-998,2053,2166
36007,007,36,2012,198689,-1209,465,-744,2097,2039
36007,007,36,2013,197953,-1032,398,-634,2032,2133
36007,007,36,2014,197295,-1171,464,-707,2151,2112
36007,007,36,2015,195981,-1697,501,-1196,2044,2170
36007,007,36,2016,194575,-1943,565,-1378,1959,1991
36007,007,36,2017,193255,-1598,445,-1153,2019,2190
36007,007,36,2018,192222,-1250,338,-912,1943,2067
36007,007,36,2019,190737,-1442,261,-1181,1834,2142
36007,007,36,2020,189420,-1121,225,-896,1823,2249
36009,009,36,2010,80220,-119,5,-114,260,262
36009,009,36,2011,79820,-546,43,-503,934,832
36009,009,36,2012,79354,-635,34,-601,927,803
36009,009,36,2013,79003,-502,49,-453,908,806
36009,009,36,2014,78690,-518,48,-470,934,782
36009,009,36,2015,77941,-832,23,-809,898,841
36009,009,36,2016,77711,-319,25,-294,904,837
36009,009,36,2017,77199,-502,17,-485,821,849
36009,009,36,2018,76748,-402,13,-389,838,899
36009,009,36,2019,76230,-527,8,-519,849,850
36009,009,36,2020,75863,-291,8,-283,834,914
36011,011,36,2010,79905,-135,8,-127,212,202
36011,011,36,2011,79707,-324,47,-277,819,741
36011,011,36,2012,79524,-296,65,-231,792,737
36011,011,36,2013,79112,-494,54,-440,798,777
36011,011,36,2014,78782,-398,58,-340,734,717
36011,011,36,2015,78323,-507,58,-449,781,793
36011,011,36,2016,77696,-623,66,-557,743,815
36011,011,36,2017,77495,-290,52,-238,784,744
36011,011,36,2018,77121,-398,48,-350,744,769
36011,011,36,2019,76450,-620,32,-588,707,790
36011,011,36,2020,76029,-377,23,-354,691,759
36013,013,36,2010,134726,-111,24,-87,311,393
36013,013,36,2011,134227,-570,187,-383,1386,1500
36013,013,36,2012,133333,-1109,197,-912,1411,1411
36013,013,36,2013,132884,-616,182,-434,1393,1407
36013,013,36,2014,131792,-1418,223,-1195,1431,1354
36013,013,36,2015,130582,-1354,189,-1165,1424,1479
36013,013,36,2016,129310,-1484,173,-1311,1451,1414
36013,013,36,2017,128424,-820,168,-652,1318,1553
36013,013,36,2018,127516,-877,208,-669,1343,1584
36013,013,36,2019,126636,-688,32,-656,1255,1482
36013,013,36,2020,126032,-430,67,-363,1263,1505
36015,015,36,2010,88895,-13,16,3,253,197
36015,015,36,2011,88916,-91,63,-28,1024,972
36015,015,36,2012,89162,67,67,134,1048,914
36015,015,36,2013,88230,-1101,48,-1053,1023,924
36015,015,36,2014,87239,-1101,43,-1058,918,874
36015,015,36,2015,86771,-538,47,-491,1026,1000
36015,015,36,2016,85692,-1134,55,-1079,933,937
36015,015,36,2017,84825,-786,42,-744,937,1062
36015,015,36,2018,84033,-715,38,-677,878,995
36015,015,36,2019,83404,-532,21,-511,861,981
36015,015,36,2020,82622,-637,24,-613,846,1014
36017,017,36,2010,50404,-49,1,-48,108,168
36017,017,36,2011,50196,-217,3,-214,533,528
36017,017,36,2012,49898,-268,11,-257,505,545
36017,017,36,2013,49489,-407,7,-400,534,545
36017,017,36,2014,49339,-171,14,-157,542,533
36017,017,36,2015,48794,-490,11,-479,528,597
36017,017,36,2016,48325,-405,10,-395,495,570
36017,017,36,2017,47842,-440,11,-429,536,590
36017,017,36,2018,47502,-214,10,-204,452,586
36017,017,36,2019,47234,-154,6,-148,445,565
36017,017,36,2020,46730,-381,4,-377,445,571
36019,019,36,2010,82099,-118,24,-94,220,159
36019,019,36,2011,81735,-572,112,-460,796,704
36019,019,36,2012,81730,-189,104,-85,786,692
36019,019,36,2013,81544,-290,96,-194,740,735
36019,019,36,2014,81497,-250,109,-141,765,663
36019,019,36,2015,80759,-922,99,-823,776,700
36019,019,36,2016,80521,-373,104,-269,732,700
36019,019,36,2017,80595,-68,74,6,765,695
36019,019,36,2018,80675,13,54,67,747,731
36019,019,36,2019,80031,-666,49,-617,738,768
36019,019,36,2020,79778,-204,46,-158,707,806
36021,021,36,2010,63035,-49,11,-38,155,138
36021,021,36,2011,62532,-423,47,-376,573,700
36021,021,36,2012,62450,-1,41,40,535,645
36021,021,36,2013,62153,-258,67,-191,562,669
36021,021,36,2014,61956,-113,91,-22,511,670
36021,021,36,2015,61451,-372,70,-302,507,708
36021,021,36,2016,60801,-571,78,-493,524,684
36021,021,36,2017,60312,-381,53,-328,486,643
36021,021,36,2018,59852,-273,51,-222,471,708
36021,021,36,2019,59582,-113,47,-66,476,679
36021,021,36,2020,59534,176,36,212,449,710
36023,023,36,2010,49277,-54,7,-47,121,83
36023,023,36,2011,49382,39,19,58,477,430
36023,023,36,2012,49028,-375,11,-364,454,448
36023,023,36,2013,48913,-91,18,-73,465,503
36023,023,36,2014,48747,-280,29,-251,487,401
36023,023,36,2015,48299,-523,34,-489,465,428
36023,023,36,2016,47950,-425,38,-387,505,468
36023,023,36,2017,47834,-194,27,-167,505,453
36023,023,36,2018,47721,-123,23,-100,444,457
36023,023,36,2019,47410,-363,22,-341,460,430
36023,023,36,2020,47173,-243,17,-226,444,458
36025,025,36,2010,47888,-95,1,-94,120,101
36025,025,36,2011,47584,-240,21,-219,467,552
36025,025,36,2012,47217,-268,21,-247,401,519
36025,025,36,2013,46806,-257,18,-239,408,575
36025,025,36,2014,46567,-121,37,-84,388,533
36025,025,36,2015,45895,-581,33,-548,390,519
36025,025,36,2016,45399,-353,57,-296,338,536
36025,025,36,2017,45061,-226,43,-183,364,518
36025,025,36,2018,44624,-325,47,-278,374,532
36025,025,36,2019,44356,-109,36,-73,378,573
36025,025,36,2020,43938,-190,26,-164,368,622
36027,027,36,2010,297721,-87,182,95,766,555
36027,027,36,2011,298141,-723,677,-46,2754,2286
36027,027,36,2012,297028,-2016,578,-1438,2664,2374
36027,027,36,2013,296292,-1538,453,-1085,2746,2406
36027,027,36,2014,295162,-1866,475,-1391,2570,2329
36027,027,36,2015,294105,-1918,474,-1444,2684,2300
36027,027,36,2016,293065,-1683,454,-1229,2596,2408
36027,027,36,2017,293512,162,310,472,2502,2510
36027,027,36,2018,293814,77,266,343,2582,2613
36027,027,36,2019,293934,144,178,322,2580,2781
36027,027,36,2020,293293,-383,190,-193,2549,3006
36029,029,36,2010,919160,-701,515,-186,2553,2252
36029,029,36,2011,919901,-1632,2373,741,9775,9741
36029,029,36,2012,919998,-2858,2639,-219,9814,9384
36029,029,36,2013,921015,-1559,2528,969,10023,9848
36029,029,36,2014,921934,-2173,2840,667,10027,9640
36029,029,36,2015,920858,-4386,2963,-1423,10367,9977
36029,029,36,2016,918992,-5219,3099,-2120,10087,9819
36029,029,36,2017,919378,-2080,2559,479,9771,9831
36029,029,36,2018,919941,-1786,2400,614,9833,9864
36029,029,36,2019,918813,-2430,1193,-1237,9814,9725
36029,029,36,2020,917241,-2042,1213,-829,9679,10469
36031,031,36,2010,39359,-48,8,-40,97,66
36031,031,36,2011,39277,-103,67,-36,307,353
36031,031,36,2012,38884,-383,58,-325,341,415
36031,031,36,2013,38610,-201,42,-159,325,441
36031,031,36,2014,38333,-217,26,-191,290,377
36031,031,36,2015,37973,-263,19,-244,323,439
36031,031,36,2016,37695,-170,29,-141,294,430
36031,031,36,2017,37521,-82,21,-61,305,416
36031,031,36,2018,37309,-100,19,-81,311,439
36031,031,36,2019,36987,-254,14,-240,294,375
36031,031,36,2020,36891,58,12,70,285,450
36033,033,36,2010,51642,-5,11,6,127,82
36033,033,36,2011,51544,-247,52,-195,542,446
36033,033,36,2012,51791,185,44,229,493,472
36033,033,36,2013,51222,-725,24,-701,542,429
36033,033,36,2014,51110,-206,15,-191,485,405
36033,033,36,2015,50552,-594,16,-578,476,463
36033,033,36,2016,51073,518,15,533,468,483
36033,033,36,2017,50478,-645,14,-631,488,459
36033,033,36,2018,50325,-142,16,-126,446,473
36033,033,36,2019,50102,-210,-4,-214,489,499
36033,033,36,2020,49965,-37,1,-36,464,567
36035,035,36,2010,55453,-25,2,-23,139,167
36035,035,36,2011,55116,-317,21,-296,559,601
36035,035,36,2012,54851,-209,20,-189,555,625
36035,035,36,2013,54353,-402,23,-379,538,658
36035,035,36,2014,53940,-388,15,-373,525,573
36035,035,36,2015,53812,-116,21,-95,549,576
36035,035,36,2016,53643,-105,11,-94,540,612
36035,035,36,2017,53815,266,9,275,510,610
36035,035,36,2018,53654,-103,10,-93,532,597
36035,035,36,2019,53336,-223,2,-221,490,587
36035,035,36,2020,52812,-408,5,-403,492,612
36037,037,36,2010,59932,0,9,9,160,169
36037,037,36,2011,59894,-124,68,-56,640,621
36037,037,36,2012,59684,-265,49,-216,603,595
36037,037,36,2013,59127,-532,32,-500,583,648
36037,037,36,2014,58745,-385,20,-365,575,598
36037,037,36,2015,58488,-309,19,-290,636,601
36037,037,36,2016,58024,-432,17,-415,557,607
36037,037,36,2017,57828,-153,14,-139,555,609
36037,037,36,2018,57509,-255,18,-237,589,672
36037,037,36,2019,57414,-58,4,-54,589,631
36037,037,36,2020,56994,-329,5,-324,579,676
36039,039,36,2010,49137,-30,3,-27,119,161
36039,039,36,2011,48858,-220,29,-191,432,520
36039,039,36,2012,48589,-250,54,-196,429,493
36039,039,36,2013,48308,-293,48,-245,413,450
36039,039,36,2014,47963,-371,82,-289,433,492
36039,039,36,2015,47621,-207,60,-147,365,557
36039,039,36,2016,47481,-53,35,-18,391,510
36039,039,36,2017,47403,17,39,56,380,510
36039,039,36,2018,47401,94,50,144,418,561
36039,039,36,2019,47211,-73,2,-71,433,553
36039,039,36,2020,47177,103,15,118,436,589
36041,041,36,2010,4852,5,0,5,10,4
36041,041,36,2011,4827,-13,0,-13,37,49
36041,041,36,2012,4803,8,0,8,35,67
36041,041,36,2013,4766,-13,0,-13,35,58
36041,041,36,2014,4701,-15,0,-15,22,72
36041,041,36,2015,4700,26,-1,25,29,54
36041,041,36,2016,4558,-117,-1,-118,29,52
36041,041,36,2017,4477,-44,0,-44,29,67
36041,041,36,2018,4453,32,0,32,22,79
36041,041,36,2019,4438,23,0,23,15,52
36041,041,36,2020,4345,-44,0,-44,18,67
36043,043,36,2010,64470,3,11,14,172,178
36043,043,36,2011,64388,-141,48,-93,658,644
36043,043,36,2012,64232,-183,27,-156,650,646
36043,043,36,2013,63888,-327,22,-305,664,702
36043,043,36,2014,63393,-498,23,-475,675,701
36043,043,36,2015,62659,-673,12,-661,637,714
36043,043,36,2016,62434,-154,22,-132,604,695
36043,043,36,2017,62193,-207,15,-192,633,680
36043,043,36,2018,61760,-359,13,-346,600,687
36043,043,36,2019,61356,-296,9,-287,565,681
36043,043,36,2020,60945,-284,8,-276,565,701
36045,045,36,2010,116609,-3,146,143,491,246
36045,045,36,2011,117809,-201,156,-45,2139,890
36045,045,36,2012,120335,25,1177,1202,2201,881
36045,045,36,2013,118617,-3741,561,-3180,2269,882
36045,045,36,2014,118121,-2172,404,-1768,2096,859
36045,045,36,2015,116539,-3476,634,-2842,2138,913
36045,045,36,2016,113280,-4814,346,-4468,2055,868
36045,045,36,2017,113488,-973,133,-840,1969,917
36045,045,36,2018,112266,-2170,-27,-2197,1910,934
36045,045,36,2019,110143,-2995,15,-2980,1793,926
36045,045,36,2020,108095,-2843,55,-2788,1750,988
36047,047,36,2010,2509954,-5394,3869,-1525,10335,3733
36047,047,36,2011,2540918,-12941,17854,4913,42204,16116
36047,047,36,2012,2568538,-15535,17170,1635,41802,15380
36047,047,36,2013,2587759,-21661,14555,-7106,42474,15990
36047,047,36,2014,2601527,-27666,15676,-11990,41645,15852
36047,047,36,2015,2608797,-34130,15115,-19015,41999,15810
36047,047,36,2016,2608146,-41753,15518,-26235,41404,15859
36047,047,36,2017,2594357,-49631,11676,-37955,40121,16010
36047,047,36,2018,2580088,-46164,8908,-37256,39091,16067
36047,047,36,2019,2562329,-45373,7228,-38145,37873,17340
36047,047,36,2020,2538934,-46757,5772,-40985,37399,19573
36049,049,36,2010,27072,-26,-1,-27,93,81
36049,049,36,2011,27021,-112,13,-99,285,236
36049,049,36,2012,27190,23,40,63,340,232
36049,049,36,2013,27092,-219,20,-199,338,239
36049,049,36,2014,27085,-132,23,-109,350,247
36049,049,36,2015,26824,-358,24,-334,333,264
36049,049,36,2016,26656,-281,16,-265,336,239
36049,049,36,2017,26606,-154,12,-142,335,244
36049,049,36,2018,26503,-168,7,-161,310,251
36049,049,36,2019,26329,-257,10,-247,328,256
36049,049,36,2020,26187,-170,8,-162,315,295
36051,051,36,2010,65226,-10,13,3,144,108
36051,051,36,2011,64834,-497,94,-403,565,558
36051,051,36,2012,64780,-151,70,-81,573,536
36051,051,36,2013,64612,-213,65,-148,517,537
36051,051,36,2014,64574,-115,81,-34,520,517
36051,051,36,2015,64336,-314,100,-214,492,515
36051,051,36,2016,64013,-417,100,-317,555,563
36051,051,36,2017,63503,-547,78,-469,502,545
36051,051,36,2018,63281,-180,79,-101,506,627
36051,051,36,2019,62893,-388,46,-342,500,548
36051,051,36,2020,62398,-443,39,-404,502,592
36053,053,36,2010,73442,2,4,6,174,187
36053,053,36,2011,72898,-630,29,-601,661,607
36053,053,36,2012,72438,-615,29,-586,718,603
36053,053,36,2013,72490,-74,36,-38,675,577
36053,053,36,2014,72251,-307,38,-269,666,637
36053,053,36,2015,71779,-545,40,-505,644,612
36053,053,36,2016,71426,-393,43,-350,635,636
36053,053,36,2017,70993,-503,34,-469,643,610
36053,053,36,2018,71180,73,24,97,683,590
36053,053,36,2019,70875,-378,22,-356,665,616
36053,053,36,2020,70478,-371,18,-353,640,686
36055,055,36,2010,744589,-888,436,-452,2209,1540
36055,055,36,2011,746821,-1987,2060,73,8611,6435
36055,055,36,2012,747468,-3305,2206,-1099,8307,6525
36055,055,36,2013,748456,-3068,2037,-1031,8520,6484
36055,055,36,2014,747583,-4993,2254,-2739,8252,6403
36055,055,36,2015,745847,-5753,2322,-3431,8460,6782
36055,055,36,2016,744150,-5781,2589,-3192,8024,6536
36055,055,36,2017,743528,-4267,2396,-1871,7892,6646
36055,055,36,2018,744239,-3048,2589,-459,7987,6818
36055,055,36,2019,742605,-3286,761,-2525,7715,6842
36055,055,36,2020,740900,-3135,1041,-2094,7653,7288
36057,057,36,2010,50312,-1,11,10,149,109
36057,057,36,2011,49919,-444,79,-365,566,595
36057,057,36,2012,49836,-164,95,-69,552,565
36057,057,36,2013,49754,-165,117,-48,594,628
36057,057,36,2014,49689,-253,162,-91,608,579
36057,057,36,2015,49576,-249,128,-121,607,599
36057,057,36,2016,49242,-554,151,-403,661,594
36057,057,36,2017,49203,-206,153,-53,585,570
36057,057,36,2018,49502,69,210,279,616,591
36057,057,36,2019,49355,-218,19,-199,612,561
36057,057,36,2020,49170,-281,56,-225,608,569
36059,059,36,2010,1341642,278,583,861,3708,2604
36059,059,36,2011,1346207,-1817,2999,1182,14304,10887
36059,059,36,2012,1349753,-3029,3278,249,14165,10734
36059,059,36,2013,1352355,-2636,2952,316,13781,11382
36059,059,36,2014,1354851,-4155,3072,-1083,14232,10549
36059,059,36,2015,1354987,-6239,3125,-3114,14316,11025
36059,059,36,2016,1356067,-5751,3278,-2473,14436,10862
36059,059,36,2017,1357260,-4462,2506,-1956,14213,11024
36059,059,36,2018,1357423,-4936,1890,-3046,14258,11018
36059,059,36,2019,1356073,-5603,1445,-4158,14029,11215
36059,059,36,2020,1351334,-7704,1155,-6549,13892,12111
36061,061,36,2010,1589041,-2625,2515,-110,5027,2290
36061,061,36,2011,1608717,-1565,11542,9977,19712,10080
36061,061,36,2012,1624573,-6469,12505,6036,19441,9482
36061,061,36,2013,1628379,-16531,11212,-5319,19015,9889
36061,061,36,2014,1631733,-17308,12379,-4929,18450,10106
36061,061,36,2015,1637327,-14395,11980,-2415,18295,10213
36061,061,36,2016,1636721,-20690,12590,-8100,17512,10022
36061,061,36,2017,1632337,-21780,9924,-11856,17363,9867
36061,061,36,2018,1632393,-14841,7909,-6932,17134,10067
36061,061,36,2019,1632326,-11592,6313,-5279,16906,11627
36061,061,36,2020,1611989,-28743,5118,-23625,16643,13234
36063,063,36,2010,216474,40,39,79,542,595
36063,063,36,2011,215726,-680,150,-530,2163,2376
36063,063,36,2012,214724,-1016,160,-856,2164,2299
36063,063,36,2013,214125,-581,129,-452,2208,2334
36063,063,36,2014,213331,-688,159,-529,2153,2394
36063,063,36,2015,212391,-957,174,-783,2220,2368
36063,063,36,2016,211555,-787,201,-586,2104,2350
36063,063,36,2017,210911,-442,158,-284,2124,2476
36063,063,36,2018,210300,-499,164,-335,2125,2396
36063,063,36,2019,209563,-503,59,-444,2097,2392
36063,063,36,2020,208396,-759,74,-685,2041,2530
36065,065,36,2010,234752,-254,132,-122,671,638
36065,065,36,2011,234226,-1215,589,-626,2620,2519
36065,065,36,2012,233778,-1298,620,-678,2688,2455
36065,065,36,2013,233370,-1016,579,-437,2653,2615
36065,065,36,2014,232634,-1623,652,-971,2583,2350
36065,065,36,2015,231315,-1865,640,-1225,2549,2650
36065,065,36,2016,230372,-1495,602,-893,2521,2569
36065,065,36,2017,229980,-814,512,-302,2482,2568
36065,065,36,2018,229431,-1092,500,-592,2595,2553
36065,065,36,2019,228240,-1346,216,-1130,2455,2520
36065,065,36,2020,227346,-932,240,-692,2443,2651
36067,067,36,2010,467549,-282,292,10,1369,858
36067,067,36,2011,467679,-2364,1353,-1011,5318,4178
36067,067,36,2012,467138,-3335,1466,-1869,5435,4132
36067,067,36,2013,468302,-1389,1387,-2,5373,4170
36067,067,36,2014,467472,-3405,1558,-1847,5163,4172
36067,067,36,2015,466320,-3713,1646,-2067,5339,4436
36067,067,36,2016,464139,-4701,1645,-3056,5259,4393
36067,067,36,2017,461843,-4419,1331,-3088,5173,4400
36067,067,36,2018,461890,-1984,1141,-843,5211,4321
36067,067,36,2019,460870,-2730,757,-1973,5176,4234
36067,067,36,2020,459214,-2963,695,-2268,5148,4546
36069,069,36,2010,108183,107,15,122,249,284
36069,069,36,2011,108616,322,117,439,1048,1049
36069,069,36,2012,108641,-94,120,26,1039,1023
36069,069,36,2013,109081,344,99,443,1044,1033
36069,069,36,2014,109378,146,140,286,1099,1062
36069,069,36,2015,109324,-139,136,-3,1026,1067
36069,069,36,2016,109348,-130,174,44,1050,1065
36069,069,36,2017,109652,303,150,453,954,1096
36069,069,36,2018,109962,206,172,378,1009,1071
36069,069,36,2019,109984,162,51,213,935,1125
36069,069,36,2020,110091,263,74,337,953,1186
36071,071,36,2010,373451,-236,126,-110,1264,522
36071,071,36,2011,374171,-2031,422,-1609,4925,2601
36071,071,36,2012,373795,-3456,555,-2901,4892,2445
36071,071,36,2013,374417,-1841,410,-1431,4696,2660
36071,071,36,2014,374945,-2064,404,-1660,4808,2637
36071,071,36,2015,375911,-1699,448,-1251,4879,2663
36071,071,36,2016,377894,-659,459,-200,4866,2674
36071,071,36,2017,379896,-606,334,-272,5013,2730
36071,071,36,2018,382411,-1,297,296,5055,2824
36071,071,36,2019,384950,137,137,274,5126,2857
36071,071,36,2020,385234,-1800,142,-1658,5072,3131
36073,073,36,2010,42850,-42,8,-34,110,117
36073,073,36,2011,42653,-241,22,-219,433,412
36073,073,36,2012,42396,-265,28,-237,401,423
36073,073,36,2013,42233,-166,21,-145,408,423
36073,073,36,2014,41864,-380,17,-363,403,416
36073,073,36,2015,41482,-414,26,-388,448,444
36073,073,36,2016,41270,-301,37,-264,441,392
36073,073,36,2017,40815,-418,39,-379,383,459
36073,073,36,2018,40708,-120,58,-62,390,434
36073,073,36,2019,40351,-298,-2,-300,342,399
36073,073,36,2020,39978,-277,15,-262,336,448
36075,075,36,2010,122141,-99,12,-87,343,220
36075,075,36,2011,121987,-468,49,-419,1339,1073
36075,075,36,2012,121469,-930,56,-874,1335,998
36075,075,36,2013,121187,-540,47,-493,1331,1117
36075,075,36,2014,120611,-887,71,-816,1309,1076
36075,075,36,2015,119764,-1092,66,-1026,1267,1097
36075,075,36,2016,118907,-1160,60,-1100,1260,1022
36075,075,36,2017,118444,-709,43,-666,1302,1101
36075,075,36,2018,117520,-1047,44,-1003,1239,1165
36075,075,36,2019,116934,-748,15,-733,1192,1049
36075,075,36,2020,116346,-629,22,-607,1189,1174
36077,077,36,2010,62260,-39,9,-30,128,112
36077,077,36,2011,61979,-229,32,-197,531,614
36077,077,36,2012,61763,-157,34,-123,518,601
36077,077,36,2013,61637,-120,46,-74,545,589
36077,077,36,2014,60973,-658,45,-613,541,607
36077,077,36,2015,60524,-413,47,-366,533,617
36077,077,36,2016,60135,-385,61,-324,485,549
36077,077,36,2017,59955,-109,46,-63,510,626
36077,077,36,2018,59828,30,36,66,476,666
36077,077,36,2019,59347,-394,27,-367,520,633
36077,077,36,2020,58701,-462,21,-441,489,694
36079,079,36,2010,99644,-75,28,-47,247,187
36079,079,36,2011,99805,-180,109,-71,909,676
36079,079,36,2012,99600,-526,109,-417,833,627
36079,079,36,2013,99546,-273,99,-174,822,704
36079,079,36,2014,99407,-419,133,-286,792,644
36079,079,36,2015,99158,-525,135,-390,859,715
36079,079,36,2016,98753,-651,170,-481,801,728
36079,079,36,2017,98901,-55,131,76,773,695
36079,079,36,2018,98871,-280,109,-171,878,735
36079,079,36,2019,98511,-582,95,-487,830,704
36079,079,36,2020,98532,-29,76,47,830,856
36081,081,36,2010,2234574,-4565,4313,-252,7602,3340
36081,081,36,2011,2255261,-15800,19537,3737,30802,13884
36081,081,36,2012,2271920,-19372,19681,309,30122,13827
36081,081,36,2013,2286788,-18183,16700,-1483,30887,14452
36081,081,36,2014,2298234,-22396,17610,-4786,30297,14087
36081,081,36,2015,2305252,-26284,17401,-8883,30566,14763
36081,081,36,2016,2306249,-33801,18551,-15250,30352,14192
36081,081,36,2017,2295226,-39899,13651,-26248,29772,14648
36081,081,36,2018,2275286,-44732,10456,-34276,28877,14637
36081,081,36,2019,2253942,-41418,8604,-32814,27322,15759
36081,081,36,2020,2225821,-43870,6849,-37021,26781,17672
36083,083,36,2010,159342,-154,58,-96,429,418
36083,083,36,2011,159606,-235,266,31,1720,1482
36083,083,36,2012,159466,-668,316,-352,1676,1457
36083,083,36,2013,159590,-235,255,20,1665,1547
36083,083,36,2014,159719,-410,291,-119,1731,1461
36083,083,36,2015,159413,-666,256,-410,1616,1503
36083,083,36,2016,159311,-600,288,-312,1679,1466
36083,083,36,2017,159214,-439,209,-230,1647,1505
36083,083,36,2018,159452,-2,174,172,1588,1518
36083,083,36,2019,158981,-651,123,-528,1584,1531
36083,083,36,2020,158108,-836,113,-723,1568,1724
36085,085,36,2010,469607,180,156,336,1378,780
36085,085,36,2011,471014,-1773,807,-966,5696,3322
36085,085,36,2012,470597,-3596,908,-2688,5400,3188
36085,085,36,2013,471783,-1152,662,-490,5368,3640
36085,085,36,2014,471899,-2442,799,-1643,5352,3566
36085,085,36,2015,472301,-1964,857,-1107,5273,3740
36085,085,36,2016,474160,-974,1020,46,5456,3628
36085,085,36,2017,475819,-712,679,-33,5407,3694
36085,085,36,2018,476531,-1282,457,-825,5332,3785
36085,085,36,2019,476141,-1814,266,-1548,5136,3986
36085,085,36,2020,475327,-1681,250,-1431,5086,4496
36087,087,36,2010,312497,-189,333,144,1122,451
36087,087,36,2011,315448,-759,1132,373,4556,1972
36087,087,36,2012,317201,-2060,1120,-940,4640,1975
36087,087,36,2013,319290,-1206,836,-370,4622,2156
36087,087,36,2014,321120,-1870,839,-1031,4846,2002
36087,087,36,2015,322938,-2249,895,-1354,5218,2054
36087,087,36,2016,323231,-3611,845,-2766,5211,2168
36087,087,36,2017,324600,-2464,699,-1765,5320,2196
36087,087,36,2018,325656,-2840,572,-2268,5582,2270
36087,087,36,2019,326352,-3096,421,-2675,5750,2385
36087,087,36,2020,326225,-3458,342,-3116,5617,2631
36089,089,36,2010,111821,-172,21,-151,310,282
36089,089,36,2011,112290,78,133,211,1273,1012
36089,089,36,2012,112388,-256,191,-65,1219,1038
36089,089,36,2013,111967,-825,137,-688,1245,989
36089,089,36,2014,111476,-906,154,-752,1225,968
36089,089,36,2015,110399,-1484,164,-1320,1142,917
36089,089,36,2016,109506,-1263,174,-1089,1138,947
36089,089,36,2017,108768,-981,138,-843,1090,990
36089,089,36,2018,108534,-419,96,-323,1088,998
36089,089,36,2019,107766,-802,92,-710,1032,1092
36089,089,36,2020,107185,-529,80,-449,1045,1180
36091,091,36,2010,220123,197,85,282,629,369
36091,091,36,2011,221136,337,191,528,2172,1678
36091,091,36,2012,222527,432,432,864,2193,1625
36091,091,36,2013,224151,746,361,1107,2248,1721
36091,091,36,2014,224605,-435,338,-97,2240,1671
36091,091,36,2015,226182,698,422,1120,2267,1789
36091,091,36,2016,227189,283,327,610,2218,1809
36091,091,36,2017,229314,1670,185,1855,2157,1881
36091,091,36,2018,230127,706,84,790,2068,2037
36091,091,36,2019,229635,-597,91,-506,2014,2004
36091,091,36,2020,230298,830,81,911,1989,2244
36093,093,36,2010,154867,-35,76,41,448,358
36093,093,36,2011,154882,-577,287,-290,1826,1518
36093,093,36,2012,155044,-488,329,-159,1858,1513
36093,093,36,2013,154978,-633,302,-331,1837,1563
36093,093,36,2014,155050,-544,371,-173,1758,1499
36093,093,36,2015,154773,-844,439,-405,1792,1658
36093,093,36,2016,154473,-1004,418,-586,1717,1430
36093,093,36,2017,154716,-204,348,144,1744,1637
36093,093,36,2018,155334,46,327,373,1892,1640
36093,093,36,2019,155548,-302,199,-103,1806,1493
36093,093,36,2020,155358,-634,185,-449,1828,1575
36095,095,36,2010,32684,-32,2,-30,80,88
36095,095,36,2011,32619,-112,15,-97,299,266
36095,095,36,2012,32038,-640,24,-616,265,252
36095,095,36,2013,31902,-121,9,-112,251,276
36095,095,36,2014,31768,-118,8,-110,270,290
36095,095,36,2015,31408,-309,9,-300,240,300
36095,095,36,2016,31318,-67,10,-57,247,280
36095,095,36,2017,31260,-13,8,-5,240,290
36095,095,36,2018,31182,-67,5,-62,281,296
36095,095,36,2019,31052,-82,5,-77,262,315
36095,095,36,2020,31132,138,4,142,277,338
36097,097,36,2010,18341,-3,0,-3,47,69
36097,097,36,2011,18421,119,7,126,167,214
36097,097,36,2012,18505,75,13,88,192,193
36097,097,36,2013,18391,-96,8,-88,171,196
36097,097,36,2014,18184,-191,8,-183,153,184
36097,097,36,2015,18037,-146,10,-136,174,186
36097,097,36,2016,17976,-51,4,-47,183,195
36097,097,36,2017,17910,-7,5,-2,156,219
36097,097,36,2018,17842,-15,4,-11,148,204
36097,097,36,2019,17812,-30,4,-26,182,187
36097,097,36,2020,17685,-102,1,-101,172,197
36099,099,36,2010,35271,-28,3,-25,113,66
36099,099,36,2011,35325,-4,8,4,366,314
36099,099,36,2012,35354,-34,17,-17,384,331
36099,099,36,2013,35244,-148,11,-137,354,329
36099,099,36,2014,34891,-460,23,-437,414,336
36099,099,36,2015,34814,-105,15,-90,385,370
36099,099,36,2016,34725,-112,36,-76,343,356
36099,099,36,2017,34293,-427,30,-397,353,390
36099,099,36,2018,34277,-25,26,1,382,397
36099,099,36,2019,34189,-142,14,-128,369,328
36099,099,36,2020,33991,-256,15,-241,381,339
36101,101,36,2010,98969,-83,13,-70,316,215
36101,101,36,2011,99117,-52,56,4,1105,959
36101,101,36,2012,98903,-400,50,-350,1126,980
36101,101,36,2013,98826,-283,40,-243,1116,945
36101,101,36,2014,98153,-782,54,-728,1057,1010
36101,101,36,2015,97549,-795,90,-705,1093,994
36101,101,36,2016,96975,-776,102,-674,1060,960
36101,101,36,2017,96379,-669,78,-591,984,989
36101,101,36,2018,95876,-510,57,-453,1058,1107
36101,101,36,2019,95328,-608,53,-555,1027,1021
36101,101,36,2020,94657,-634,41,-593,1018,1097
36103,103,36,2010,1494337,-1138,788,-350,4372,2713
36103,103,36,2011,1498910,-3738,3442,-296,16465,11569
36103,103,36,2012,1497017,-9978,3352,-6626,16060,11443
36103,103,36,2013,1497389,-6071,2830,-3241,15620,11940
36103,103,36,2014,1495553,-8728,2903,-5825,15554,11572
36103,103,36,2015,1491997,-10498,2882,-7616,15817,11774
36103,103,36,2016,1486699,-12614,3233,-9381,15856,11797
36103,103,36,2017,1483862,-8311,2645,-5666,15298,12473
36103,103,36,2018,1482275,-6933,2165,-4768,15494,12326
36103,103,36,2019,1478325,-7731,1611,-6120,15223,13092
36103,103,36,2020,1474273,-6376,1315,-5061,15140,14189
36105,105,36,2010,77480,-110,28,-82,210,150
36105,105,36,2011,77061,-684,146,-538,845,728
36105,105,36,2012,76940,-384,160,-224,867,766
36105,105,36,2013,76957,-325,161,-164,916,734
36105,105,36,2014,75651,-1550,157,-1393,783,726
36105,105,36,2015,74850,-1067,144,-923,817,706
36105,105,36,2016,74913,-125,144,19,797,749
36105,105,36,2017,75000,-182,123,-59,847,696
36105,105,36,2018,75381,145,168,313,804,734
36105,105,36,2019,75551,20,10,30,892,751
36105,105,36,2020,75802,180,48,228,859,837
36107,107,36,2010,51012,-44,0,-44,131,125
36107,107,36,2011,50889,-172,-7,-179,469,413
36107,107,36,2012,50297,-633,-5,-638,473,443
36107,107,36,2013,50128,-272,-9,-281,518,407
36107,107,36,2014,49855,-362,-4,-366,492,400
36107,107,36,2015,49390,-550,4,-546,527,452
36107,107,36,2016,48858,-536,6,-530,466,470
36107,107,36,2017,48659,-181,2,-179,449,467
36107,107,36,2018,48515,-138,2,-136,445,453
36107,107,36,2019,48221,-227,-2,-229,429,494
36107,107,36,2020,47904,-215,0,-215,427,530
36109,109,36,2010,101743,-150,184,34,245,121
36109,109,36,2011,101861,-898,859,-39,843,691
36109,109,36,2012,102800,-217,878,661,933,654
36109,109,36,2013,103668,-136,779,643,917,677
36109,109,36,2014,103530,-1204,869,-335,855,686
36109,109,36,2015,103187,-1379,863,-516,862,707
36109,109,36,2016,103042,-1077,813,-264,791,678
36109,109,36,2017,102731,-1030,616,-414,805,709
36109,109,36,2018,102382,-804,459,-345,724,735
36109,109,36,2019,101971,-906,406,-500,736,652
36109,109,36,2020,101058,-1278,331,-947,721,686
36111,111,36,2010,182422,-159,66,-93,419,416
36111,111,36,2011,182458,-411,295,-116,1738,1582
36111,111,36,2012,181555,-1228,291,-937,1638,1614
36111,111,36,2013,180722,-1107,291,-816,1594,1617
36111,111,36,2014,180435,-527,324,-203,1562,1620
36111,111,36,2015,179696,-872,305,-567,1554,1718
36111,111,36,2016,179045,-742,303,-439,1531,1739
36111,111,36,2017,178650,-339,245,-94,1491,1783
36111,111,36,2018,178510,-75,215,140,1472,1743
36111,111,36,2019,177933,-571,139,-432,1567,1716
36111,111,36,2020,177716,-11,139,128,1517,1868
36113,113,36,2010,65668,8,5,13,152,185
36113,113,36,2011,65750,81,20,101,619,635
36113,113,36,2012,65438,-280,24,-256,611,662
36113,113,36,2013,65111,-322,27,-295,599,632
36113,113,36,2014,64893,-109,39,-70,565,700
36113,113,36,2015,64449,-261,51,-210,531,763
36113,113,36,2016,64525,95,52,147,608,675
36113,113,36,2017,64406,65,33,98,517,731
36113,113,36,2018,64269,-22,26,4,586,723
36113,113,36,2019,63980,-135,22,-113,539,715
36113,113,36,2020,63756,-61,16,-45,547,727
36115,115,36,2010,63359,88,0,88,131,112
36115,115,36,2011,63100,-288,13,-275,638,624
36115,115,36,2012,63016,-143,13,-130,658,601
36115,115,36,2013,62785,-244,9,-235,623,614
36115,115,36,2014,62504,-305,13,-292,584,572
36115,115,36,2015,62277,-197,18,-179,600,644
36115,115,36,2016,61812,-449,21,-428,543,580
36115,115,36,2017,61600,-164,13,-151,569,627
36115,115,36,2018,61335,-169,10,-159,563,666
36115,115,36,2019,61168,-8,8,0,536,703
36115,115,36,2020,60606,-367,5,-362,531,732
36117,117,36,2010,93751,-38,19,-19,257,230
36117,117,36,2011,93258,-695,63,-632,992,856
36117,117,36,2012,93038,-479,62,-417,1014,820
36117,117,36,2013,92360,-859,30,-829,991,851
36117,117,36,2014,91819,-723,56,-667,930,815
36117,117,36,2015,91316,-655,53,-602,960,861
36117,117,36,2016,90823,-650,35,-615,1002,880
36117,117,36,2017,90429,-471,18,-453,931,871
36117,117,36,2018,90110,-379,26,-353,974,941
36117,117,36,2019,89816,-412,17,-395,979,877
36117,117,36,2020,89339,-505,17,-488,962,953
36119,119,36,2010,950760,-615,723,108,2857,1514
36119,119,36,2011,956423,-1815,3620,1805,10976,7088
36119,119,36,2012,959731,-3837,3458,-379,10619,6904
36119,119,36,2013,964713,-1041,2866,1825,10549,7229
36119,119,36,2014,967180,-4476,3339,-1137,10585,6906
36119,119,36,2015,968891,-5562,3543,-2019,10774,7019
36119,119,36,2016,970461,-6110,3980,-2130,10507,6810
36119,119,36,2017,970033,-6465,2960,-3505,10349,7280
36119,119,36,2018,968928,-6550,2487,-4063,10273,7321
36119,119,36,2019,968467,-4942,1882,-3060,10050,7472
36119,119,36,2020,965802,-5988,1500,-4488,9924,8141
36121,121,36,2010,42125,-50,4,-46,91,72
36121,121,36,2011,41852,-322,14,-308,414,382
36121,121,36,2012,41702,-188,14,-174,379,357
36121,121,36,2013,41369,-330,11,-319,377,395
36121,121,36,2014,41145,-270,10,-260,396,362
36121,121,36,2015,40939,-217,5,-212,386,379
36121,121,36,2016,40450,-532,23,-509,389,373
36121,121,36,2017,40296,-145,11,-134,354,374
36121,121,36,2018,40068,-224,19,-205,373,397
36121,121,36,2019,39858,-180,5,-175,345,380
36121,121,36,2020,39465,-368,5,-363,355,384
36123,123,36,2010,25376,-27,2,-25,75,37
36123,123,36,2011,25453,2,7,9,311,241
36123,123,36,2012,25341,-183,16,-167,307,255
36123,123,36,2013,25219,-188,9,-179,323,269
36123,123,36,2014,25162,-158,34,-124,298,230
36123,123,36,2015,25145,-42,21,-21,289,283
36123,123,36,2016,25080,-148,17,-131,321,255
36123,123,36,2017,25021,-149,13,-136,325,248
36123,123,36,2018,24959,-101,10,-91,328,298
36123,123,36,2019,24902,-134,9,-125,333,264
36123,123,36,2020,24780,-171,7,-164,331,290
37001,001,37,2010,151437,176,16,192,479,391
37001,001,37,2011,152712,938,38,976,1759,1459
37001,001,37,2012,153299,331,79,410,1703,1494
37001,001,37,2013,154209,629,93,722,1797,1591
37001,001,37,2014,155439,950,108,1058,1727,1548
37001,001,37,2015,157104,1379,140,1519,1782,1635
37001,001,37,2016,160358,3021,64,3085,1845,1693
37001,001,37,2017,163326,2694,70,2764,1834,1640
37001,001,37,2018,166516,2764,82,2846,2016,1680
37001,001,37,2019,169173,2537,25,2562,1904,1805
37001,001,37,2020,171346,2078,36,2114,1942,1879
37003,003,37,2010,37232,26,6,32,80,57
37003,003,37,2011,37029,-225,-3,-228,355,331
37003,003,37,2012,36926,-103,4,-99,363,365
37003,003,37,2013,37016,68,18,86,373,363
37003,003,37,2014,36993,-37,9,-28,349,338
37003,003,37,2015,36960,15,10,25,347,400
37003,003,37,2016,37120,222,4,226,327,391
37003,003,37,2017,37105,30,2,32,374,420
37003,003,37,2018,37272,230,-1,229,369,431
37003,003,37,2019,37417,184,0,184,345,382
37003,003,37,2020,37441,109,0,109,344,431
37005,005,37,2010,11136,10,0,10,26,48
37005,005,37,2011,11016,-74,-2,-76,93,135
37005,005,37,2012,10944,-36,0,-36,85,122
37005,005,37,2013,10903,-9,-3,-12,86,114
37005,005,37,2014,10891,1,1,2,100,112
37005,005,37,2015,10855,-4,6,2,97,135
37005,005,37,2016,10928,107,14,121,99,146
37005,005,37,2017,11004,120,8,128,94,146
37005,005,37,2018,11165,181,13,194,105,138
37005,005,37,2019,11134,26,7,33,81,145
37005,005,37,2020,11194,125,6,131,84,154
37007,007,37,2010,26853,-43,5,-38,60,97
37007,007,37,2011,26515,-310,-3,-313,277,304
37007,007,37,2012,26315,-189,7,-182,254,274
37007,007,37,2013,25966,-328,2,-326,264,296
37007,007,37,2014,25976,17,24,41,255,293
37007,007,37,2015,25616,-318,33,-285,237,314
37007,007,37,2016,25173,-364,32,-332,240,353
37007,007,37,2017,24856,-307,35,-272,264,312
37007,007,37,2018,24487,-352,28,-324,244,293
37007,007,37,2019,23538,-933,33,-900,274,325
37007,007,37,2020,24097,590,29,619,256,312
37009,009,37,2010,27226,27,3,30,62,102
37009,009,37,2011,26983,-172,8,-164,249,329
37009,009,37,2012,26921,1,19,20,244,319
37009,009,37,2013,26837,-3,0,-3,252,327
37009,009,37,2014,26761,52,-7,45,221,336
37009,009,37,2015,26625,13,-6,7,218,358
37009,009,37,2016,26595,122,-4,118,207,352
37009,009,37,2017,26795,316,-6,310,217,327
37009,009,37,2018,27122,447,0,447,206,326
37009,009,37,2019,27215,236,-8,228,202,338
37009,009,37,2020,27166,143,-2,141,203,391
37011,011,37,2010,17797,11,-1,10,37,55
37011,011,37,2011,17771,-9,1,-8,176,193
37011,011,37,2012,17617,-109,10,-99,133,189
37011,011,37,2013,17663,81,8,89,141,184
37011,011,37,2014,17658,31,7,38,138,180
37011,011,37,2015,17494,-106,9,-97,122,188
37011,011,37,2016,17450,20,9,29,149,222
37011,011,37,2017,17522,112,14,126,130,182
37011,011,37,2018,17509,60,14,74,145,231
37011,011,37,2019,17496,30,12,42,140,195
37011,011,37,2020,17571,158,12,170,148,242
37013,013,37,2010,47826,8,8,16,143,113
37013,013,37,2011,47685,-128,14,-114,513,537
37013,013,37,2012,47442,-185,-4,-189,496,547
37013,013,37,2013,47394,7,-7,0,510,549
37013,013,37,2014,47349,69,3,72,496,605
37013,013,37,2015,47403,217,13,230,431,603
37013,013,37,2016,47407,114,21,135,464,592
37013,013,37,2017,47097,-136,27,-109,437,634
37013,013,37,2018,47127,176,25,201,463,634
37013,013,37,2019,47096,130,23,153,417,601
37013,013,37,2020,47073,184,18,202,424,648
37015,015,37,2010,21244,-47,0,-47,49,33
37015,015,37,2011,20855,-321,1,-320,196,266
37015,015,37,2012,20490,-347,5,-342,192,226
37015,015,37,2013,20325,-90,6,-84,181,259
37015,015,37,2014,20317,51,16,67,170,246
37015,015,37,2015,20167,-79,35,-44,165,269
37015,015,37,2016,19414,-705,12,-693,178,244
37015,015,37,2017,19246,-114,13,-101,171,236
37015,015,37,2018,19072,-115,7,-108,186,251
37015,015,37,2019,18962,-27,12,-15,173,268
37015,015,37,2020,18712,-142,8,-134,165,280
37017,017,37,2010,35178,36,7,43,91,120
37017,017,37,2011,34877,-298,26,-272,354,384
37017,017,37,2012,34805,-53,11,-42,360,389
37017,017,37,2013,34621,-175,-1,-176,356,364
37017,017,37,2014,34365,-262,14,-248,377,388
37017,017,37,2015,34090,-182,11,-171,339,442
37017,017,37,2016,33657,-374,12,-362,352,423
37017,017,37,2017,33446,-146,0,-146,343,404
37017,017,37,2018,33169,-167,16,-151,321,446
37017,017,37,2019,32864,-250,-4,-254,370,420
37017,017,37,2020,32911,190,2,192,345,490
37019,019,37,2010,108070,578,6,584,252,242
37019,019,37,2011,110196,2107,-12,2095,1040,1022
37019,019,37,2012,112039,1934,33,1967,1013,1203
37019,019,37,2013,114977,2968,8,2976,1087,1204
37019,019,37,2014,118382,3517,1,3518,990,1234
37019,019,37,2015,122322,4070,22,4092,1114,1337
37019,019,37,2016,126422,4436,3,4439,999,1367
37019,019,37,2017,130996,4994,14,5008,986,1459
37019,019,37,2018,137071,6626,0,6626,967,1551
37019,019,37,2019,142987,6404,-3,6401,1048,1522
37019,019,37,2020,149039,6875,4,6879,1035,1821
37021,021,37,2010,238743,355,47,402,609,592
37021,021,37,2011,241226,2175,97,2272,2567,2366
37021,021,37,2012,243761,2123,92,2215,2552,2276
37021,021,37,2013,246952,2742,174,2916,2650,2448
37021,021,37,2014,249265,1983,145,2128,2588,2446
37021,021,37,2015,252160,2584,229,2813,2643,2586
37021,021,37,2016,255222,2846,245,3091,2587,2631
37021,021,37,2017,257408,2164,231,2395,2476,2691
37021,021,37,2018,259726,2414,196,2610,2440,2743
37021,021,37,2019,262049,2314,165,2479,2503,2664
37021,021,37,2020,263477,1676,142,1818,2465,2857
37023,023,37,2010,90567,-219,22,-197,232,298
37023,023,37,2011,90533,82,73,155,808,994
37023,023,37,2012,89965,-545,86,-459,879,984
37023,023,37,2013,89348,-493,54,-439,861,1033
37023,023,37,2014,89292,35,71,106,854,994
37023,023,37,2015,89337,124,84,208,895,1045
37023,023,37,2016,89444,197,83,280,895,1064
37023,023,37,2017,90143,675,87,762,918,979
37023,023,37,2018,90309,303,70,373,865,1070
37023,023,37,2019,90424,179,71,250,909,1043
37023,023,37,2020,90418,208,53,261,863,1133
37025,025,37,2010,178564,231,43,274,570,388
37025,025,37,2011,181187,1586,93,1679,2327,1386
37025,025,37,2012,184358,2149,120,2269,2273,1408
37025,025,37,2013,187265,1998,127,2125,2251,1488
37025,025,37,2014,191737,3225,203,3428,2394,1419
37025,025,37,2015,196483,3681,247,3928,2337,1553
37025,025,37,2016,201737,4077,230,4307,2462,1529
37025,025,37,2017,206987,4064,187,4251,2568,1582
37025,025,37,2018,211483,3429,158,3587,2546,1643
37025,025,37,2019,216340,3809,124,3933,2545,1613
37025,025,37,2020,221479,4317,94,4411,2574,1821
37027,027,37,2010,83025,4,4,8,176,206
37027,027,37,2011,82460,-487,8,-479,811,898
37027,027,37,2012,82094,-358,21,-337,823,846
37027,027,37,2013,82067,135,49,184,757,952
37027,027,37,2014,81698,-335,49,-286,846,921
37027,027,37,2015,81554,-24,68,44,799,975
37027,027,37,2016,81829,327,73,400,825,944
37027,027,37,2017,81961,266,62,328,767,956
37027,027,37,2018,82116,286,57,343,803,989
37027,027,37,2019,82275,298,55,353,827,1020
37027,027,37,2020,82100,42,51,93,828,1100
37029,029,37,2010,10011,14,3,17,21,6
37029,029,37,2011,10026,-13,11,-2,93,76
37029,029,37,2012,10006,-37,12,-25,78,71
37029,029,37,2013,10119,92,21,113,79,79
37029,029,37,2014,10280,108,15,123,105,66
37029,029,37,2015,10284,-4,9,5,86,88
37029,029,37,2016,10385,100,4,104,84,87
37029,029,37,2017,10517,124,3,127,100,92
37029,029,37,2018,10613,84,3,87,84,75
37029,029,37,2019,10770,123,3,126,114,84
37029,029,37,2020,10984,186,2,188,101,74
37031,031,37,2010,66700,234,31,265,131,174
37031,031,37,2011,67432,782,60,842,616,728
37031,031,37,2012,67792,325,152,477,646,756
37031,031,37,2013,68417,684,91,775,615,773
37031,031,37,2014,68670,308,64,372,624,737
37031,031,37,2015,68766,198,95,293,591,779
37031,031,37,2016,68875,257,53,310,600,797
37031,031,37,2017,69014,331,29,360,559,774
37031,031,37,2018,69547,902,7,909,509,885
37031,031,37,2019,69513,326,19,345,524,904
37031,031,37,2020,69558,489,20,509,504,964
37033,033,37,2010,23745,13,1,14,35,31
37033,033,37,2011,23453,-238,4,-234,212,271
37033,033,37,2012,23044,-357,12,-345,212,286
37033,033,37,2013,23096,121,12,133,210,289
37033,033,37,2014,22808,-265,11,-254,209,250
37033,033,37,2015,22813,50,14,64,204,260
37033,033,37,2016,22749,4,14,18,188,268
37033,033,37,2017,22623,-57,15,-42,213,295
37033,033,37,2018,22691,105,17,122,207,259
37033,033,37,2019,22590,-37,12,-25,216,293
37033,033,37,2020,22443,-99,13,-86,210,271
37035,035,37,2010,154758,-137,29,-108,440,307
37035,035,37,2011,154501,-554,48,-506,1789,1537
37035,035,37,2012,154739,-175,161,-14,1816,1543
37035,035,37,2013,155024,-39,198,159,1753,1612
37035,035,37,2014,155157,-180,185,5,1712,1557
37035,035,37,2015,155607,128,274,402,1775,1706
37035,035,37,2016,156517,614,220,834,1721,1638
37035,035,37,2017,157822,1117,199,1316,1688,1692
37035,035,37,2018,158521,657,176,833,1646,1779
37035,035,37,2019,159363,670,164,834,1699,1691
37035,035,37,2020,160307,940,136,1076,1688,1819
37037,037,37,2010,63845,287,9,296,159,110
37037,037,37,2011,64120,197,7,204,671,597
37037,037,37,2012,64551,429,27,456,609,630
37037,037,37,2013,65276,744,12,756,595,631
37037,037,37,2014,66708,1425,-13,1412,624,645
37037,037,37,2015,68307,1576,10,1586,646,651
37037,037,37,2016,69680,1369,-9,1360,649,638
37037,037,37,2017,71248,1685,-8,1677,609,724
37037,037,37,2018,73171,1957,-6,1951,678,711
37037,037,37,2019,74419,1383,-17,1366,643,758
37037,037,37,2020,75748,1567,-13,1554,629,845
37039,039,37,2010,27435,28,3,31,57,98
37039,039,37,2011,27185,-139,4,-135,234,347
37039,039,37,2012,27044,6,5,11,207,353
37039,039,37,2013,27139,237,6,243,221,372
37039,039,37,2014,27093,126,-12,114,222,382
37039,039,37,2015,27126,207,-8,199,197,362
37039,039,37,2016,27860,835,-3,832,253,354
37039,039,37,2017,28000,288,6,294,236,390
37039,039,37,2018,28425,577,13,590,232,399
37039,039,37,2019,28708,386,-12,374,259,349
37039,039,37,2020,29073,497,2,499,248,379
37041,041,37,2010,14737,-34,1,-33,39,62
37041,041,37,2011,14805,110,17,127,139,198
37041,041,37,2012,14696,-134,23,-111,158,156
37041,041,37,2013,14669,-8,-3,-11,169,184
37041,041,37,2014,14504,-119,1,-118,129,177
37041,041,37,2015,14251,-237,2,-235,161,180
37041,041,37,2016,14209,11,-4,7,145,193
37041,041,37,2017,14015,-96,-5,-101,116,208
37041,041,37,2018,14019,80,-5,75,124,194
37041,041,37,2019,13917,-58,-5,-63,141,181
37041,041,37,2020,13815,-9,-2,-11,126,216
37043,043,37,2010,10609,11,2,13,22,16
37043,043,37,2011,10684,119,-3,116,77,118
37043,043,37,2012,10660,29,4,33,88,142
37043,043,37,2013,10606,12,2,14,82,148
37043,043,37,2014,10578,46,-2,44,83,154
37043,043,37,2015,10644,126,1,127,69,131
37043,043,37,2016,10785,183,3,186,99,143
37043,043,37,2017,11033,306,0,306,93,151
37043,043,37,2018,11149,210,-5,205,84,174
37043,043,37,2019,11277,177,-1,176,86,133
37043,043,37,2020,11505,293,-2,291,84,144
37045,045,37,2010,97922,-64,7,-57,255,303
37045,045,37,2011,97452,-547,30,-517,1112,1065
37045,045,37,2012,97332,-124,52,-72,1083,1117
37045,045,37,2013,96893,-436,49,-387,1081,1129
37045,045,37,2014,97030,189,65,254,1059,1154
37045,045,37,2015,96881,-5,62,57,1041,1235
37045,045,37,2016,97037,227,74,301,1107,1245
37045,045,37,2017,97198,271,70,341,1044,1217
37045,045,37,2018,97593,422,47,469,1143,1212
37045,045,37,2019,97964,482,46,528,1127,1285
37045,045,37,2020,99035,1240,44,1284,1151,1358
37047,047,37,2010,57997,-121,1,-120,142,153
37047,047,37,2011,57710,-269,4,-265,652,675
37047,047,37,2012,57546,-240,18,-222,653,591
37047,047,37,2013,57099,-352,15,-337,633,747
37047,047,37,2014,56906,-85,14,-71,616,731
37047,047,37,2015,56698,-155,30,-125,601,679
37047,047,37,2016,56324,-299,21,-278,603,697
37047,047,37,2017,56000,-169,5,-164,567,724
37047,047,37,2018,55764,-140,12,-128,596,702
37047,047,37,2019,55452,-178,1,-177,563,698
37047,047,37,2020,54754,-438,6,-432,558,822
37049,049,37,2010,104180,287,143,430,410,194
37049,049,37,2011,104866,-219,177,-42,1743,1013
37049,049,37,2012,105381,-857,713,-144,1631,958
37049,049,37,2013,104369,-2008,441,-1567,1529,1009
37049,049,37,2014,104168,-1007,288,-719,1502,980
37049,049,37,2015,102988,-1998,401,-1597,1480,1079
37049,049,37,2016,102784,-699,191,-508,1439,1129
37049,049,37,2017,102740,-434,86,-348,1400,1089
37049,049,37,2018,102663,-247,-61,-308,1386,1145
37049,049,37,2019,102031,-892,63,-829,1329,1127
37049,049,37,2020,101233,-1009,59,-950,1304,1146
37051,051,37,2010,327247,5596,472,6068,1375,512
37051,051,37,2011,330625,-924,604,-320,5968,2262
37051,051,37,2012,330161,-7052,3028,-4024,5651,2285
37051,051,37,2013,333253,-1952,1922,-30,5553,2386
37051,051,37,2014,332680,-5727,1527,-4200,5915,2385
37051,051,37,2015,331598,-5952,1788,-4164,5471,2436
37051,051,37,2016,333723,-2027,1256,-771,5459,2551
37051,051,37,2017,331702,-5781,882,-4899,5406,2559
37051,051,37,2018,334495,-545,389,-156,5545,2586
37051,051,37,2019,336524,-1228,581,-647,5399,2735
37051,051,37,2020,336364,-3184,559,-2625,5379,2912
37053,053,37,2010,23672,81,3,84,66,29
37053,053,37,2011,23909,217,4,221,216,201
37053,053,37,2012,24030,121,0,121,233,230
37053,053,37,2013,24260,217,4,221,242,234
37053,053,37,2014,24834,515,7,522,253,213
37053,053,37,2015,25128,259,0,259,261,226
37053,053,37,2016,25668,499,4,503,260,224
37053,053,37,2017,26330,620,2,622,256,218
37053,053,37,2018,27084,737,9,746,249,244
37053,053,37,2019,27916,762,-9,753,271,192
37053,053,37,2020,29052,1075,1,1076,271,205
37055,055,37,2010,33981,57,0,57,95,91
37055,055,37,2011,34161,132,-13,119,359,300
37055,055,37,2012,34389,139,12,151,385,305
37055,055,37,2013,34823,339,14,353,367,292
37055,055,37,2014,34914,29,20,49,352,304
37055,055,37,2015,35499,453,65,518,347,284
37055,055,37,2016,35905,324,66,390,358,344
37055,055,37,2017,36257,365,57,422,306,375
37055,055,37,2018,36710,417,47,464,336,348
37055,055,37,2019,37071,360,50,410,308,358
37055,055,37,2020,37547,479,43,522,312,355
37057,057,37,2010,162841,-68,18,-50,412,328
37057,057,37,2011,162934,-80,37,-43,1728,1586
37057,057,37,2012,163064,-62,73,11,1745,1600
37057,057,37,2013,163337,305,58,363,1681,1740
37057,057,37,2014,163437,33,35,68,1766,1706
37057,057,37,2015,163548,195,25,220,1704,1788
37057,057,37,2016,164497,762,142,904,1806,1750
37057,057,37,2017,165489,894,174,1068,1771,1841
37057,057,37,2018,166726,1286,144,1430,1710,1897
37057,057,37,2019,168238,1477,107,1584,1786,1858
37057,057,37,2020,169234,1134,96,1230,1768,2002
37059,059,37,2010,41252,62,4,66,76,106
37059,059,37,2011,41333,102,9,111,370,399
37059,059,37,2012,41285,-60,18,-42,402,401
37059,059,37,2013,41443,181,22,203,389,430
37059,059,37,2014,41262,-159,3,-156,391,419
37059,059,37,2015,41652,485,10,495,358,463
37059,059,37,2016,41927,374,0,374,408,504
37059,059,37,2017,42297,483,-8,475,383,487
37059,059,37,2018,42504,292,-9,283,388,463
37059,059,37,2019,42699,280,-14,266,402,472
37059,059,37,2020,43286,692,-11,681,401,490
37061,061,37,2010,58663,112,55,167,175,92
37061,061,37,2011,59215,147,106,253,780,480
37061,061,37,2012,59449,-144,95,-49,785,498
37061,061,37,2013,59323,-447,80,-367,781,544
37061,061,37,2014,59426,-179,61,-118,754,528
37061,061,37,2015,58879,-841,133,-708,716,562
37061,061,37,2016,59284,103,138,241,748,579
37061,061,37,2017,58942,-653,145,-508,680,515
37061,061,37,2018,59001,-184,120,-64,658,536
37061,061,37,2019,58802,-505,117,-388,734,544
37061,061,37,2020,58794,-176,93,-83,700,625
37063,063,37,2010,271366,284,294,578,1108,359
37063,063,37,2011,276609,1817,1002,2819,4213,1808
37063,063,37,2012,282757,2075,1367,3442,4323,1691
37063,063,37,2013,288856,2153,1503,3656,4250,1877
37063,063,37,2014,295324,2446,1423,3869,4345,1824
37063,063,37,2015,301014,1680,1615,3295,4345,1989
37063,063,37,2016,308105,2868,1825,4693,4297,1926
37063,063,37,2017,312466,221,1971,2192,4269,2094
37063,063,37,2018,317478,1369,1545,2914,4127,2034
37063,063,37,2019,322969,1823,1634,3457,4208,2174
37063,063,37,2020,327306,1314,1271,2585,4188,2429
37065,065,37,2010,56595,-6,-2,-8,204,104
37065,065,37,2011,56038,-634,-5,-639,645,566
37065,065,37,2012,55667,-498,9,-489,686,587
37065,065,37,2013,55419,-268,10,-258,629,617
37065,065,37,2014,54860,-634,-1,-635,650,580
37065,065,37,2015,53734,-1101,24,-1077,608,673
37065,065,37,2016,53281,-419,20,-399,595,651
37065,065,37,2017,52793,-477,19,-458,606,636
37065,065,37,2018,52015,-710,29,-681,610,708
37065,065,37,2019,51429,-426,11,-415,587,758
37065,065,37,2020,50829,-450,11,-439,572,730
37067,067,37,2010,351378,103,158,261,1194,685
37067,067,37,2011,354545,1129,398,1527,4644,2997
37067,067,37,2012,357644,1108,480,1588,4584,3034
37067,067,37,2013,360677,1292,344,1636,4587,3162
37067,067,37,2014,364555,2078,386,2464,4512,3095
37067,067,37,2015,367516,1287,588,1875,4407,3288
37067,067,37,2016,371437,2218,566,2784,4438,3296
37067,067,37,2017,375901,2910,599,3509,4387,3435
37067,067,37,2018,379196,1853,550,2403,4441,3549
37067,067,37,2019,382118,1698,382,2080,4357,3520
37067,067,37,2020,383843,716,333,1049,4367,3714
37069,069,37,2010,60835,178,8,186,173,96
37069,069,37,2011,60945,-114,5,-109,681,461
37069,069,37,2012,61405,308,27,335,647,522
37069,069,37,2013,62078,536,32,568,665,562
37069,069,37,2014,62694,437,36,473,670,528
37069,069,37,2015,63667,756,92,848,703,586
37069,069,37,2016,64681,769,87,856,713,556
37069,069,37,2017,66175,1286,82,1368,697,575
37069,069,37,2018,67646,1332,116,1448,692,674
37069,069,37,2019,69775,1983,64,2047,746,661
37069,069,37,2020,71859,1998,60,2058,752,714
37071,071,37,2010,206114,-90,47,-43,624,548
37071,071,37,2011,206894,150,97,247,2598,2057
37071,071,37,2012,207915,477,136,613,2572,2122
37071,071,37,2013,209242,995,170,1165,2463,2281
37071,071,37,2014,210599,1009,118,1127,2408,2166
37071,071,37,2015,212998,1896,135,2031,2630,2271
37071,071,37,2016,216727,3357,124,3481,2522,2287
37071,071,37,2017,219788,2767,119,2886,2500,2333
37071,071,37,2018,222862,2739,106,2845,2612,2388
37071,071,37,2019,224652,1653,65,1718,2547,2478
37071,071,37,2020,226568,1929,71,2000,2561,2646
37073,073,37,2010,12165,4,0,4,29,51
37073,073,37,2011,12043,-105,0,-105,100,118
37073,073,37,2012,11888,-171,3,-168,120,109
37073,073,37,2013,11700,-180,7,-173,90,110
37073,073,37,2014,11632,-106,8,-98,115,86
37073,073,37,2015,11530,-71,8,-63,100,138
37073,073,37,2016,11570,42,1,43,117,121
37073,073,37,2017,11502,-42,1,-41,98,123
37073,073,37,2018,11524,69,1,70,99,148
37073,073,37,2019,11536,18,1,19,95,99
37073,073,37,2020,11464,-36,1,-35,94,131
37075,075,37,2010,8866,21,0,21,22,35
37075,075,37,2011,8809,-51,1,-50,103,110
37075,075,37,2012,8703,-88,0,-88,89,107
37075,075,37,2013,8713,37,-2,35,91,116
37075,075,37,2014,8617,-71,3,-68,86,115
37075,075,37,2015,8587,-14,2,-12,79,97
37075,075,37,2016,8540,-34,3,-31,84,99
37075,075,37,2017,8529,9,-1,8,81,99
37075,075,37,2018,8490,-19,4,-15,83,106
37075,075,37,2019,8470,13,-1,12,79,113
37075,075,37,2020,8474,32,-1,31,83,109
37077,077,37,2010,57683,42,8,50,146,63
37077,077,37,2011,57512,-296,5,-291,607,488
37077,077,37,2012,57573,-19,14,-5,544,469
37077,077,37,2013,57792,177,-11,166,544,487
37077,077,37,2014,58027,233,-16,217,557,528
37077,077,37,2015,58201,150,-9,141,559,519
37077,077,37,2016,58719,465,28,493,549,524
37077,077,37,2017,59452,668,22,690,610,570
37077,077,37,2018,60100,566,39,605,608,562
37077,077,37,2019,60358,267,5,272,567,581
37077,077,37,2020,60486,162,16,178,582,632
37079,079,37,2010,21257,-131,-4,-135,53,24
37079,079,37,2011,21518,182,-16,166,263,171
37079,079,37,2012,21198,-387,0,-387,223,167
37079,079,37,2013,21017,-202,-6,-208,206,181
37079,079,37,2014,21016,4,-2,2,203,205
37079,079,37,2015,20952,-81,20,-61,210,211
37079,079,37,2016,21087,106,6,112,210,187
37079,079,37,2017,20965,-95,6,-89,187,219
37079,079,37,2018,21041,48,28,76,210,210
37079,079,37,2019,20915,-155,3,-152,227,202
37079,079,37,2020,20928,33,1,34,215,237
37081,081,37,2010,489626,223,331,554,1455,786
37081,081,37,2011,495022,2257,946,3203,6056,3862
37081,081,37,2012,500618,1977,1413,3390,6068,3812
37081,081,37,2013,506537,2248,1535,3783,6211,4049
37081,081,37,2014,512414,2169,1645,3814,6121,3995
37081,081,37,2015,517281,1700,1349,3049,6176,4315
37081,081,37,2016,524520,3829,1564,5393,6113,4276
37081,081,37,2017,528622,735,1687,2422,6248,4536
37081,081,37,2018,533244,1751,1272,3023,6206,4596
37081,081,37,2019,537872,1926,1369,3295,6049,4721
37081,081,37,2020,540521,520,1087,1607,6074,5065
37083,083,37,2010,54476,-144,6,-138,158,178
37083,083,37,2011,54122,-319,15,-304,599,650
37083,083,37,2012,53739,-364,16,-348,600,635
37083,083,37,2013,53193,-439,5,-434,557,672
37083,083,37,2014,52840,-250,16,-234,569,685
37083,083,37,2015,52190,-599,19,-580,588,662
37083,083,37,2016,51814,-315,15,-300,559,633
37083,083,37,2017,51329,-433,19,-414,590,662
37083,083,37,2018,50696,-511,12,-499,562,697
37083,083,37,2019,50074,-476,15,-461,537,697
37083,083,37,2020,49479,-355,14,-341,516,770
37085,085,37,2010,115757,759,67,826,430,248
37085,085,37,2011,119201,2401,72,2473,1735,782
37085,085,37,2012,122250,1627,437,2064,1777,837
37085,085,37,2013,125093,1656,287,1943,1788,915
37085,085,37,2014,126769,382,280,662,1975,952
37085,085,37,2015,128145,128,330,458,1900,974
37085,085,37,2016,130822,1585,228,1813,1842,985
37085,085,37,2017,132584,708,160,868,1847,956
37085,085,37,2018,134649,1110,123,1233,1863,1039
37085,085,37,2019,136172,732,47,779,1859,1122
37085,085,37,2020,137058,133,71,204,1850,1175
37087,087,37,2010,58930,-24,-1,-25,130,196
37087,087,37,2011,58731,-60,-13,-73,529,653
37087,087,37,2012,58666,73,-4,69,579,702
37087,087,37,2013,59006,517,-13,504,550,718
37087,087,37,2014,59192,366,-11,355,544,712
37087,087,37,2015,59724,695,7,702,610,784
37087,087,37,2016,60493,924,22,946,578,758
37087,087,37,2017,61167,844,15,859,636,825
37087,087,37,2018,62170,1204,16,1220,590,811
37087,087,37,2019,62510,656,5,661,522,842
37087,087,37,2020,62972,778,6,784,531,850
37089,089,37,2010,106894,155,16,171,292,282
37089,089,37,2011,107391,693,1,694,1076,1270
37089,089,37,2012,107811,585,4,589,1079,1248
37089,089,37,2013,108942,1427,-13,1414,1022,1336
37089,089,37,2014,110338,1606,30,1636,1040,1319
37089,089,37,2015,111943,1847,25,1872,1135,1424
37089,089,37,2016,113711,2067,28,2095,1055,1389
37089,089,37,2017,115431,2082,8,2090,1071,1448
37089,089,37,2018,116557,1432,25,1457,1065,1400
37089,089,37,2019,117347,1163,-7,1156,1069,1431
37089,089,37,2020,118445,1598,4,1602,1055,1553
37091,091,37,2010,24773,81,13,94,59,73
37091,091,37,2011,24732,-49,42,-7,235,269
37091,091,37,2012,24619,-136,34,-102,249,256
37091,091,37,2013,24603,-37,38,1,253,266
37091,091,37,2014,24615,15,35,50,226,259
37091,091,37,2015,24404,-197,38,-159,219,271
37091,091,37,2016,24211,-175,13,-162,222,255
37091,091,37,2017,23917,-286,15,-271,237,262
37091,091,37,2018,23882,12,11,23,229,284
37091,091,37,2019,23642,-198,13,-185,212,269
37091,091,37,2020,23108,-429,11,-418,206,317
37093,093,37,2010,47498,377,47,424,221,78
37093,093,37,2011,49473,1239,51,1290,985,312
37093,093,37,2012,50499,90,271,361,960,298
37093,093,37,2013,51190,-124,188,64,912,291
37093,093,37,2014,51633,-309,152,-157,901,295
37093,093,37,2015,52805,311,218,529,951,312
37093,093,37,2016,53086,-511,138,-373,980,324
37093,093,37,2017,54207,465,80,545,922,351
37093,093,37,2018,54661,-50,60,10,839,393
37093,093,37,2019,55166,-32,23,-9,856,342
37093,093,37,2020,55830,201,38,239,846,422
37095,095,37,2010,5812,-5,3,-2,19,21
37095,095,37,2011,5798,-5,-2,-7,44,52
37095,095,37,2012,5689,-117,7,-110,60,64
37095,095,37,2013,5653,-38,9,-29,48,54
37095,095,37,2014,5599,-51,0,-51,49,53
37095,095,37,2015,5425,-153,-3,-156,42,61
37095,095,37,2016,5434,39,-2,37,46,74
37095,095,37,2017,5230,-171,-2,-173,35,69
37095,095,37,2018,5006,-203,-2,-205,37,57
37095,095,37,2019,4932,-50,-2,-52,30,52
37095,095,37,2020,4843,-63,-2,-65,34,56
37097,097,37,2010,159788,144,44,188,435,291
37097,097,37,2011,161077,741,132,873,1812,1393
37097,097,37,2012,162729,1152,247,1399,1689,1436
37097,097,37,2013,164661,1398,222,1620,1769,1465
37097,097,37,2014,166598,1466,209,1675,1757,1494
37097,097,37,2015,169592,2365,225,2590,1877,1490
37097,097,37,2016,172600,2387,205,2592,1930,1515
37097,097,37,2017,175673,2584,232,2816,1883,1628
37097,097,37,2018,178358,2267,163,2430,1870,1609
37097,097,37,2019,181866,3059,173,3232,1892,1610
37097,097,37,2020,185770,3680,138,3818,1921,1814
37099,099,37,2010,40376,37,16,53,107,55
37099,099,37,2011,40256,-287,61,-226,435,329
37099,099,37,2012,40661,293,72,365,366,328
37099,099,37,2013,41034,321,30,351,388,375
37099,099,37,2014,40960,-158,55,-103,367,328
37099,099,37,2015,41352,247,109,356,385,349
37099,099,37,2016,42645,1231,50,1281,396,393
37099,099,37,2017,43220,552,32,584,397,409
37099,099,37,2018,43540,272,66,338,388,407
37099,099,37,2019,43736,226,5,231,353,387
37099,099,37,2020,44033,319,17,336,365,405
37101,101,37,2010,169676,469,26,495,570,302
37101,101,37,2011,172457,1738,13,1751,2258,1236
37101,101,37,2012,174387,847,34,881,2247,1197
37101,101,37,2013,177240,1897,59,1956,2153,1276
37101,101,37,2014,180732,2297,94,2391,2282,1227
37101,101,37,2015,185130,3287,221,3508,2216,1360
37101,101,37,2016,190937,4707,207,4914,2325,1454
37101,101,37,2017,196541,4579,216,4795,2280,1492
37101,101,37,2018,203031,5365,231,5596,2356,1478
37101,101,37,2019,209786,5846,125,5971,2426,1631
37101,101,37,2020,216246,5680,123,5803,2481,1794
37103,103,37,2010,10139,6,2,8,21,53
37103,103,37,2011,10056,-50,3,-47,110,146
37103,103,37,2012,10065,21,12,33,99,123
37103,103,37,2013,9996,-49,10,-39,90,120
37103,103,37,2014,9841,-126,3,-123,98,131
37103,103,37,2015,9770,-60,3,-57,113,126
37103,103,37,2016,9571,-163,1,-162,76,113
37103,103,37,2017,9550,10,2,12,96,128
37103,103,37,2018,9557,43,3,46,100,140
37103,103,37,2019,9339,-201,0,-201,87,104
37103,103,37,2020,9250,-47,0,-47,84,126
37105,105,37,2010,57879,-117,12,-105,225,89
37105,105,37,2011,58537,348,17,365,841,549
37105,105,37,2012,59257,370,58,428,811,510
37105,105,37,2013,59783,258,37,295,781,546
37105,105,37,2014,59425,-722,89,-633,796,522
37105,105,37,2015,59402,-278,86,-192,778,604
37105,105,37,2016,59653,-4,92,88,744,578
37105,105,37,2017,60418,489,104,593,769,598
37105,105,37,2018,61219,531,82,613,813,626
37105,105,37,2019,61772,318,69,387,780,615
37105,105,37,2020,62353,346,65,411,791,624
37107,107,37,2010,59491,-79,19,-60,181,138
37107,107,37,2011,59425,-80,14,-66,663,661
37107,107,37,2012,59132,-311,17,-294,670,667
37107,107,37,2013,58754,-323,20,-303,641,717
37107,107,37,2014,58275,-467,25,-442,680,716
37107,107,37,2015,58012,-272,67,-205,674,728
37107,107,37,2016,57264,-668,22,-646,633,739
37107,107,37,2017,56644,-514,14,-500,604,724
37107,107,37,2018,56050,-536,58,-478,633,752
37107,107,37,2019,56074,146,9,155,632,761
37107,107,37,2020,55720,-179,9,-170,620,805
37109,109,37,2010,78127,91,5,96,199,167
37109,109,37,2011,78301,86,12,98,773,695
37109,109,37,2012,78743,339,8,347,778,675
37109,109,37,2013,79140,371,-12,359,770,728
37109,109,37,2014,79479,292,2,294,777,717
37109,109,37,2015,80646,1074,68,1142,798,779
37109,109,37,2016,81235,619,41,660,770,840
37109,109,37,2017,82608,1285,57,1342,821,792
37109,109,37,2018,84334,1631,74,1705,832,815
37109,109,37,2019,86627,2241,26,2267,880,849
37109,109,37,2020,88097,1535,31,1566,874,965
37111,111,37,2010,45102,33,1,34,127,57
37111,111,37,2011,45056,-10,-6,-16,461,489
37111,111,37,2012,45005,8,12,20,441,500
37111,111,37,2013,45027,83,23,106,445,524
37111,111,37,2014,45017,11,27,38,482,519
37111,111,37,2015,44982,-23,57,34,462,525
37111,111,37,2016,44876,-93,13,-80,480,504
37111,111,37,2017,45089,325,14,339,429,554
37111,111,37,2018,45481,422,21,443,460,511
37111,111,37,2019,45784,433,1,434,414,544
37111,111,37,2020,45782,124,5,129,423,554
37113,113,37,2010,33959,12,3,15,89,64
37113,113,37,2011,33889,86,7,93,298,458
37113,113,37,2012,33816,8,19,27,324,417
37113,113,37,2013,33756,18,14,32,359,445
37113,113,37,2014,33849,128,32,160,349,416
37113,113,37,2015,34117,318,61,379,334,445
37113,113,37,2016,34299,254,44,298,352,466
37113,113,37,2017,34610,471,33,504,324,515
37113,113,37,2018,35226,721,42,763,320,469
37113,113,37,2019,35729,598,25,623,340,458
37113,113,37,2020,35994,390,20,410,325,467
37115,115,37,2010,20798,22,3,25,38,68
37115,115,37,2011,20872,123,0,123,180,230
37115,115,37,2012,20913,49,3,52,180,187
37115,115,37,2013,21178,282,6,288,209,238
37115,115,37,2014,21217,80,9,89,176,225
37115,115,37,2015,21175,-42,25,-17,214,239
37115,115,37,2016,21402,244,15,259,215,246
37115,115,37,2017,21603,252,13,265,194,259
37115,115,37,2018,21659,124,12,136,189,269
37115,115,37,2019,21638,39,11,50,202,273
37115,115,37,2020,21740,174,7,181,197,275
37117,117,37,2010,24505,3,3,6,63,78
37117,117,37,2011,24186,-238,1,-237,243,325
37117,117,37,2012,23851,-261,1,-260,233,313
37117,117,37,2013,23643,-126,-3,-129,244,322
37117,117,37,2014,23441,-138,0,-138,253,316
37117,117,37,2015,23267,-90,0,-90,252,335
37117,117,37,2016,23121,-103,2,-101,243,286
37117,117,37,2017,22773,-242,2,-240,233,341
37117,117,37,2018,22696,-21,1,-20,264,319
37117,117,37,2019,22451,-152,1,-151,228,322
37117,117,37,2020,22178,-181,0,-181,228,320
37119,119,37,2010,923292,473,916,1389,3390,1124
37119,119,37,2011,944015,9319,2840,12159,13728,5225
37119,119,37,2012,967418,10354,4055,14409,13793,5128
37119,119,37,2013,991182,10567,4567,15134,13852,5475
37119,119,37,2014,1010878,6578,4630,11208,14034,5647
37119,119,37,2015,1034049,9330,5051,14381,14592,5911
37119,119,37,2016,1058056,9095,5968,15063,14926,6049
37119,119,37,2017,1079656,6295,6580,12875,14856,6192
37119,119,37,2018,1095911,2796,4971,7767,14688,6227
37119,119,37,2019,1113283,3995,5375,9370,14571,6621
37119,119,37,2020,1128945,4008,4206,8214,14706,7302
37121,121,37,2010,15511,-34,0,-34,32,68
37121,121,37,2011,15354,-72,4,-68,135,224
37121,121,37,2012,15327,7,6,13,153,190
37121,121,37,2013,15278,24,12,36,137,220
37121,121,37,2014,15167,-75,15,-60,135,186
37121,121,37,2015,15062,-42,21,-21,146,227
37121,121,37,2016,15003,5,26,31,153,242
37121,121,37,2017,14992,51,10,61,139,210
37121,121,37,2018,14989,80,16,96,142,240
37121,121,37,2019,14928,32,5,37,129,228
37121,121,37,2020,14881,58,7,65,135,245
37123,123,37,2010,27725,-35,-1,-36,78,99
37123,123,37,2011,27700,-98,-15,-113,357,266
37123,123,37,2012,27513,-243,-10,-253,335,274
37123,123,37,2013,27439,-101,-10,-111,329,289
37123,123,37,2014,27280,-151,-13,-164,287,279
37123,123,37,2015,27432,97,1,98,333,276
37123,123,37,2016,27288,-134,3,-131,294,306
37123,123,37,2017,27274,11,-2,9,288,310
37123,123,37,2018,27104,-157,20,-137,276,309
37123,123,37,2019,27209,150,-8,142,277,313
37123,123,37,2020,27238,83,-1,82,280,333
37125,125,37,2010,88595,274,21,295,257,219
37125,125,37,2011,89265,741,-11,730,928,988
37125,125,37,2012,90205,848,110,958,972,1005
37125,125,37,2013,91391,1154,119,1273,990,1094
37125,125,37,2014,92849,1388,114,1502,972,1053
37125,125,37,2015,94057,1151,151,1302,1059,1158
37125,125,37,2016,95458,1238,125,1363,1102,1065
37125,125,37,2017,97376,1863,97,1960,1132,1179
37125,125,37,2018,98961,1525,49,1574,1159,1148
37125,125,37,2019,101167,2187,80,2267,1125,1180
37125,125,37,2020,103352,2223,65,2288,1178,1266
37127,127,37,2010,95819,-44,22,-22,262,271
37127,127,37,2011,95778,-147,-2,-149,1117,1005
37127,127,37,2012,95225,-717,19,-698,1103,968
37127,127,37,2013,94463,-953,47,-906,1116,994
37127,127,37,2014,94253,-400,50,-350,1103,959
37127,127,37,2015,93855,-474,57,-417,1027,1001
37127,127,37,2016,94060,162,84,246,1035,1070
37127,127,37,2017,94095,-15,73,58,1079,1097
37127,127,37,2018,94161,54,51,105,1071,1107
37127,127,37,2019,94258,113,58,171,1064,1137
37127,127,37,2020,94859,670,45,715,1061,1174
37129,129,37,2010,203295,346,46,392,530,320
37129,129,37,2011,206006,2011,150,2161,2232,1694
37129,129,37,2012,209118,2214,259,2473,2263,1675
37129,129,37,2013,213033,3176,206,3382,2199,1740
37129,129,37,2014,216112,2319,148,2467,2305,1756
37129,129,37,2015,219619,2923,200,3123,2281,1933
37129,129,37,2016,224922,4872,137,5009,2235,1979
37129,129,37,2017,228863,3419,142,3561,2265,1908
37129,129,37,2018,232566,3271,100,3371,2279,1962
37129,129,37,2019,234275,1571,105,1676,2128,2098
37129,129,37,2020,236613,2391,82,2473,2137,2276
37131,131,37,2010,22037,-33,-1,-34,47,78
37131,131,37,2011,21918,-28,-3,-31,184,271
37131,131,37,2012,21287,-601,4,-597,199,251
37131,131,37,2013,20860,-352,9,-343,196,288
37131,131,37,2014,20658,-121,17,-104,172,266
37131,131,37,2015,20539,-46,25,-21,167,263
37131,131,37,2016,20135,-313,12,-301,189,292
37131,131,37,2017,19898,-170,11,-159,199,275
37131,131,37,2018,19741,-98,7,-91,185,250
37131,131,37,2019,19498,-156,9,-147,166,261
37131,131,37,2020,19088,-268,6,-262,164,309
37133,133,37,2010,186918,6699,519,7218,1037,158
37133,133,37,2011,185068,-5738,271,-5467,4433,862
37133,133,37,2012,190813,-595,3068,2473,4189,924
37133,133,37,2013,192522,-3438,1456,-1982,4558,898
37133,133,37,2014,192061,-4660,829,-3831,4253,982
37133,133,37,2015,193402,-3457,1578,-1879,4296,1082
37133,133,37,2016,192745,-4462,708,-3754,4211,1127
37133,133,37,2017,195332,-188,33,-155,3933,1190
37133,133,37,2018,197069,-311,-604,-915,3920,1260
37133,133,37,2019,202795,3062,27,3089,3905,1262
37133,133,37,2020,203943,-1430,48,-1382,3802,1269
37135,135,37,2010,133985,47,183,230,312,239
37135,135,37,2011,134853,-83,465,382,1234,750
37135,135,37,2012,137870,1736,685,2421,1276,716
37135,135,37,2013,139471,297,760,1057,1281,722
37135,135,37,2014,140432,-132,711,579,1159,766
37135,135,37,2015,141449,-53,617,564,1230,774
37135,135,37,2016,142849,448,586,1034,1157,786
37135,135,37,2017,143624,-188,642,454,1182,862
37135,135,37,2018,148029,3576,438,4014,1169,804
37135,135,37,2019,148192,-683,515,-168,1164,836
37135,135,37,2020,149077,284,392,676,1127,925
37137,137,37,2010,13108,2,1,3,19,54
37137,137,37,2011,13242,188,-2,186,104,158
37137,137,37,2012,13016,-192,8,-184,86,130
37137,137,37,2013,12878,-108,6,-102,102,138
37137,137,37,2014,12870,65,8,73,78,160
37137,137,37,2015,12739,-50,4,-46,89,174
37137,137,37,2016,12771,107,2,109,98,174
37137,137,37,2017,12631,-48,-2,-50,81,169
37137,137,37,2018,12600,68,-2,66,76,173
37137,137,37,2019,12650,138,-2,136,79,165
37137,137,37,2020,12715,181,-2,179,76,188
37139,139,37,2010,40632,-77,32,-45,135,121
37139,139,37,2011,40290,-483,43,-440,519,424
37139,139,37,2012,40411,-60,118,58,463,396
37139,139,37,2013,39587,-985,92,-893,486,440
37139,139,37,2014,39479,-331,81,-250,523,386
37139,139,37,2015,39433,-243,85,-158,516,408
37139,139,37,2016,39418,-111,38,-73,490,431
37139,139,37,2017,39420,-116,68,-48,474,422
37139,139,37,2018,39693,169,86,255,467,449
37139,139,37,2019,39970,206,4,210,474,409
37139,139,37,2020,40372,330,25,355,455,408
37141,141,37,2010,52415,147,10,157,124,70
37141,141,37,2011,53180,631,-7,624,599,460
37141,141,37,2012,53730,396,15,411,589,457
37141,141,37,2013,54804,936,26,962,608,512
37141,141,37,2014,55931,1005,24,1029,601,526
37141,141,37,2015,57463,1416,10,1426,625,538
37141,141,37,2016,58829,1278,22,1300,643,580
37141,141,37,2017,60787,1861,25,1886,629,566
37141,141,37,2018,62121,1266,22,1288,640,598
37141,141,37,2019,63046,918,12,930,638,641
37141,141,37,2020,64671,1654,15,1669,619,650
37143,143,37,2010,13480,39,0,39,36,49
37143,143,37,2011,13499,22,2,24,134,139
37143,143,37,2012,13590,104,4,108,120,137
37143,143,37,2013,13638,68,5,73,138,161
37143,143,37,2014,13541,-67,-2,-69,141,168
37143,143,37,2015,13474,-26,-3,-29,111,146
37143,143,37,2016,13425,10,-3,7,123,178
37143,143,37,2017,13464,76,-3,73,126,160
37143,143,37,2018,13427,29,-3,26,125,186
37143,143,37,2019,13578,176,-3,173,112,132
37143,143,37,2020,13667,122,-3,119,119,148
37145,145,37,2010,39412,-30,1,-29,101,137
37145,145,37,2011,39525,137,-9,128,427,442
37145,145,37,2012,39188,-324,-3,-327,381,391
37145,145,37,2013,39253,68,-3,65,407,401
37145,145,37,2014,39130,-132,-6,-138,438,417
37145,145,37,2015,39214,121,2,123,410,445
37145,145,37,2016,39315,119,8,127,407,430
37145,145,37,2017,39412,122,11,133,416,450
37145,145,37,2018,39533,156,6,162,426,466
37145,145,37,2019,39621,124,10,134,416,462
37145,145,37,2020,39925,372,10,382,414,492
37147,147,37,2010,168865,295,49,344,547,215
37147,147,37,2011,170813,842,151,993,2094,1142
37147,147,37,2012,173021,1020,207,1227,2158,1185
37147,147,37,2013,174443,297,212,509,2125,1195
37147,147,37,2014,175052,-514,179,-335,2136,1173
37147,147,37,2015,176178,84,187,271,2133,1257
37147,147,37,2016,177291,135,126,261,2115,1259
37147,147,37,2017,178661,533,134,667,2017,1312
37147,147,37,2018,179673,137,127,264,2060,1310
37147,147,37,2019,181257,745,92,837,2110,1371
37147,147,37,2020,182924,1068,75,1143,2062,1548
37149,149,37,2010,20474,-24,0,-24,39,54
37149,149,37,2011,20289,-11,-3,-14,116,285
37149,149,37,2012,20251,93,-2,91,135,260
37149,149,37,2013,20390,286,0,286,130,278
37149,149,37,2014,20372,113,1,114,150,280
37149,149,37,2015,20417,177,19,196,152,301
37149,149,37,2016,20418,130,14,144,140,282
37149,149,37,2017,20567,279,16,295,149,295
37149,149,37,2018,20673,246,17,263,166,322
37149,149,37,2019,20723,160,14,174,150,273
37149,149,37,2020,21030,446,8,454,153,296
37151,151,37,2010,141985,86,2,88,398,312
37151,151,37,2011,141861,-443,5,-438,1610,1294
37151,151,37,2012,142274,116,26,142,1611,1312
37151,151,37,2013,142313,-168,53,-115,1621,1446
37151,151,37,2014,142467,-15,26,11,1545,1371
37151,151,37,2015,142560,-92,72,-20,1619,1488
37151,151,37,2016,143070,383,67,450,1586,1518
37151,151,37,2017,143000,-102,37,-65,1595,1593
37151,151,37,2018,143176,143,98,241,1532,1591
37151,151,37,2019,143495,364,18,382,1539,1603
37151,151,37,2020,144557,1251,2,1253,1531,1720
37153,153,37,2010,46636,-20,5,-15,150,141
37153,153,37,2011,46654,-24,-14,-38,610,553
37153,153,37,2012,46364,-330,8,-322,554,527
37153,153,37,2013,46134,-216,-4,-220,504,511
37153,153,37,2014,45770,-376,8,-368,532,529
37153,153,37,2015,45427,-315,23,-292,525,575
37153,153,37,2016,45034,-374,9,-365,557,585
37153,153,37,2017,44786,-215,-3,-218,538,567
37153,153,37,2018,44881,108,4,112,559,572
37153,153,37,2019,44764,-113,-6,-119,563,562
37153,153,37,2020,44332,-358,-5,-363,552,621
37155,155,37,2010,134469,24,10,34,504,259
37155,155,37,2011,135168,-113,21,-92,1998,1204
37155,155,37,2012,135458,-329,59,-270,1806,1226
37155,155,37,2013,135135,-1056,44,-1012,1936,1251
37155,155,37,2014,134920,-873,47,-826,1885,1272
37155,155,37,2015,134446,-975,70,-905,1782,1351
37155,155,37,2016,133344,-1527,69,-1458,1753,1399
37155,155,37,2017,132606,-1196,58,-1138,1813,1414
37155,155,37,2018,131890,-1066,77,-989,1708,1435
37155,155,37,2019,130440,-1709,32,-1677,1735,1507
37155,155,37,2020,129999,-617,35,-582,1661,1525
37157,157,37,2010,93681,-4,8,4,238,212
37157,157,37,2011,93309,-316,2,-314,963,1018
37157,157,37,2012,92722,-450,27,-423,893,1051
37157,157,37,2013,91930,-591,23,-568,944,1172
37157,157,37,2014,91825,29,25,54,962,1100
37157,157,37,2015,91697,72,20,92,955,1162
37157,157,37,2016,91326,-149,3,-146,904,1124
37157,157,37,2017,90844,-201,2,-199,917,1196
37157,157,37,2018,90680,93,11,104,867,1129
37157,157,37,2019,91118,770,-5,765,908,1233
37157,157,37,2020,91285,590,0,590,898,1320
37159,159,37,2010,138329,-138,11,-127,382,408
37159,159,37,2011,137819,-591,-5,-596,1539,1453
37159,159,37,2012,137505,-417,26,-391,1531,1441
37159,159,37,2013,137689,246,28,274,1539,1609
37159,159,37,2014,138091,447,66,513,1521,1613
37159,159,37,2015,138520,359,91,450,1590,1592
37159,159,37,2016,139417,795,61,856,1650,1605
37159,159,37,2017,140289,922,59,981,1595,1700
37159,159,37,2018,140870,605,82,687,1549,1656
37159,159,37,2019,141818,993,-10,983,1624,1658
37159,159,37,2020,142495,805,20,825,1573,1723
37161,161,37,2010,67739,-28,6,-22,156,204
37161,161,37,2011,67424,-216,13,-203,715,824
37161,161,37,2012,67227,-98,25,-73,681,790
37161,161,37,2013,66866,-188,20,-168,690,873
37161,161,37,2014,66587,-86,15,-71,631,831
37161,161,37,2015,66408,36,-2,34,701,904
37161,161,37,2016,66318,96,4,100,662,847
37161,161,37,2017,66558,428,-4,424,689,869
37161,161,37,2018,66721,404,-7,397,657,889
37161,161,37,2019,67031,461,-7,454,674,816
37161,161,37,2020,67076,316,-6,310,663,928
37163,163,37,2010,63536,-58,26,-32,209,110
37163,163,37,2011,63515,-273,46,-227,853,645
37163,163,37,2012,63710,-134,73,-61,873,608
37163,163,37,2013,63903,-145,119,-26,835,608
37163,163,37,2014,63806,-385,132,-253,840,681
37163,163,37,2015,63562,-554,156,-398,843,693
37163,163,37,2016,63200,-641,134,-507,833,687
37163,163,37,2017,63188,-266,141,-125,841,726
37163,163,37,2018,63277,-159,123,-36,830,704
37163,163,37,2019,63372,-91,117,26,784,715
37163,163,37,2020,63382,-105,86,-19,780,752
37165,165,37,2010,36062,-99,4,-95,121,129
37165,165,37,2011,36274,87,10,97,475,360
37165,165,37,2012,36094,-257,22,-235,446,391
37165,165,37,2013,35916,-241,17,-224,448,404
37165,165,37,2014,35662,-365,23,-342,452,365
37165,165,37,2015,35333,-410,20,-390,438,380
37165,165,37,2016,35315,-62,14,-48,449,417
37165,165,37,2017,35178,-235,17,-218,493,414
37165,165,37,2018,34701,-489,13,-476,422,422
37165,165,37,2019,34776,26,13,39,444,406
37165,165,37,2020,34637,-138,14,-124,435,451
37167,167,37,2010,60578,-20,11,-9,140,132
37167,167,37,2011,60531,-123,23,-100,680,625
37167,167,37,2012,60464,-15,17,2,635,689
37167,167,37,2013,60635,166,32,198,627,645
37167,167,37,2014,60621,-71,38,-33,695,670
37167,167,37,2015,60624,5,15,20,701,710
37167,167,37,2016,60829,244,9,253,688,732
37167,167,37,2017,61458,628,9,637,707,714
37167,167,37,2018,62077,655,15,670,704,755
37167,167,37,2019,62645,588,7,595,667,692
37167,167,37,2020,63239,713,3,716,675,795
37169,169,37,2010,47330,-27,1,-26,107,147
37169,169,37,2011,47128,-129,-2,-131,427,497
37169,169,37,2012,46716,-332,1,-331,388,477
37169,169,37,2013,46500,-101,1,-100,383,494
37169,169,37,2014,46309,-107,1,-106,395,476
37169,169,37,2015,46143,-17,16,-1,402,562
37169,169,37,2016,45895,-136,28,-108,385,524
37169,169,37,2017,45710,-14,33,19,402,603
37169,169,37,2018,45459,-67,26,-41,394,603
37169,169,37,2019,45634,314,32,346,389,558
37169,169,37,2020,45743,301,23,324,384,599
37171,171,37,2010,73779,7,15,22,196,182
37171,171,37,2011,73499,-205,4,-201,797,874
37171,171,37,2012,73292,-191,-6,-197,795,799
37171,171,37,2013,72637,-514,-9,-523,727,863
37171,171,37,2014,72480,-79,22,-57,747,832
37171,171,37,2015,71990,-399,85,-314,738,912
37171,171,37,2016,72024,117,54,171,756,886
37171,171,37,2017,72114,285,41,326,731,962
37171,171,37,2018,71957,5,85,90,746,990
37171,171,37,2019,71741,-15,3,-12,767,971
37171,171,37,2020,71683,172,15,187,759,1006
37173,173,37,2010,14006,3,2,5,51,25
37173,173,37,2011,14005,23,7,30,173,203
37173,173,37,2012,14054,-2,2,0,212,161
37173,173,37,2013,13976,-65,2,-63,189,201
37173,173,37,2014,14238,215,-1,214,206,162
37173,173,37,2015,14325,47,-1,46,220,180
37173,173,37,2016,14189,-145,2,-143,189,182
37173,173,37,2017,14268,122,3,125,150,197
37173,173,37,2018,14259,39,15,54,154,217
37173,173,37,2019,14312,110,3,113,159,217
37173,173,37,2020,14179,-46,1,-45,161,250
37175,175,37,2010,33087,20,4,24,61,82
37175,175,37,2011,32812,-132,-5,-137,280,415
37175,175,37,2012,32849,154,-1,153,257,368
37175,175,37,2013,32847,178,10,188,234,426
37175,175,37,2014,32971,217,2,219,292,389
37175,175,37,2015,33185,318,6,324,286,396
37175,175,37,2016,33433,377,11,388,273,412
37175,175,37,2017,33812,576,8,584,249,456
37175,175,37,2018,34182,501,14,515,285,431
37175,175,37,2019,34270,239,4,243,256,411
37175,175,37,2020,34498,406,6,412,268,448
37177,177,37,2010,4415,-3,0,-3,15,4
37177,177,37,2011,4336,-57,-1,-58,43,65
37177,177,37,2012,4122,-216,0,-216,39,46
37177,177,37,2013,4102,-21,1,-20,37,36
37177,177,37,2014,4119,-2,2,0,51,32
37177,177,37,2015,4137,22,1,23,37,44
37177,177,37,2016,4017,-114,0,-114,42,49
37177,177,37,2017,4172,149,0,149,44,40
37177,177,37,2018,4113,-51,0,-51,35,44
37177,177,37,2019,3813,-291,0,-291,33,42
37177,177,37,2020,3774,-25,0,-25,27,41
37179,179,37,2010,202110,435,40,475,591,300
37179,179,37,2011,204916,1598,57,1655,2367,1215
37179,179,37,2012,208106,1882,83,1965,2380,1157
37179,179,37,2013,212261,2955,105,3060,2338,1277
37179,179,37,2014,217767,4326,74,4400,2353,1319
37179,179,37,2015,222051,3117,118,3235,2366,1332
37179,179,37,2016,226501,3212,128,3340,2464,1353
37179,179,37,2017,231525,4037,147,4184,2336,1496
37179,179,37,2018,236217,3563,123,3686,2496,1481
37179,179,37,2019,240028,3040,70,3110,2287,1573
37179,179,37,2020,244562,3774,80,3854,2374,1673
37181,181,37,2010,45293,-121,-3,-124,156,154
37181,181,37,2011,45293,-92,-14,-106,558,450
37181,181,37,2012,45104,-348,-14,-362,600,433
37181,181,37,2013,44507,-648,-2,-650,560,518
37181,181,37,2014,44533,-52,14,-38,572,500
37181,181,37,2015,44477,-159,51,-108,547,491
37181,181,37,2016,44558,-22,89,67,543,527
37181,181,37,2017,44387,-259,103,-156,556,572
37181,181,37,2018,44735,225,98,323,575,547
37181,181,37,2019,44670,-200,88,-112,570,524
37181,181,37,2020,44718,-8,64,56,558,567
37183,183,37,2010,906875,2730,762,3492,3209,1055
37183,183,37,2011,928905,11435,2367,13802,12539,4387
37183,183,37,2012,952266,11766,3581,15347,12259,4550
37183,183,37,2013,974508,10790,3750,14540,12299,4778
37183,183,37,2014,998221,12082,3620,15702,12620,4840
37183,183,37,2015,1022871,13241,3835,17076,12764,5319
37183,183,37,2016,1048933,14251,4182,18433,12901,5336
37183,183,37,2017,1072463,11973,4544,16517,12690,5729
37183,183,37,2018,1092202,9248,3468,12716,12841,5831
37183,183,37,2019,1112795,10251,3654,13905,12676,6011
37183,183,37,2020,1132271,10635,2854,13489,12716,6757
37185,185,37,2010,20974,-27,1,-26,46,59
37185,185,37,2011,20986,7,5,12,219,217
37185,185,37,2012,20750,-203,14,-189,157,206
37185,185,37,2013,20584,-89,-8,-97,174,246
37185,185,37,2014,20364,-171,-4,-175,195,236
37185,185,37,2015,20190,-108,-6,-114,174,234
37185,185,37,2016,19874,-244,-5,-249,192,258
37185,185,37,2017,19829,75,-7,68,172,284
37185,185,37,2018,19815,79,-7,72,172,256
37185,185,37,2019,19692,-18,-7,-25,157,255
37185,185,37,2020,19522,-40,-4,-44,148,272
37187,187,37,2010,13119,-34,2,-32,29,73
37187,187,37,2011,12904,-215,11,-204,122,134
37187,187,37,2012,12662,-247,10,-237,132,143
37187,187,37,2013,12669,46,10,56,129,177
37187,187,37,2014,12479,-210,11,-199,137,131
37187,187,37,2015,12251,-190,-6,-196,115,149
37187,187,37,2016,12081,-130,-4,-134,128,163
37187,187,37,2017,11947,-89,-5,-94,133,172
37187,187,37,2018,11793,-123,-5,-128,129,155
37187,187,37,2019,11635,-111,-5,-116,125,166
37187,187,37,2020,11485,-94,-3,-97,128,179
37189,189,37,2010,50972,-67,1,-66,73,97
37189,189,37,2011,51636,659,1,660,360,362
37189,189,37,2012,52079,365,20,385,362,314
37189,189,37,2013,52320,191,29,220,343,320
37189,189,37,2014,52421,47,14,61,352,300
37189,189,37,2015,53129,596,57,653,372,327
37189,189,37,2016,54176,989,60,1049,337,347
37189,189,37,2017,55250,970,58,1028,383,346
37189,189,37,2018,56205,854,56,910,390,352
37189,189,37,2019,56271,68,45,113,332,381
37189,189,37,2020,56441,232,31,263,328,424
37191,191,37,2010,122891,-12,79,67,399,224
37191,191,37,2011,124055,530,121,651,1659,1146
37191,191,37,2012,124587,-566,455,-111,1770,1116
37191,191,37,2013,124625,-950,369,-581,1727,1114
37191,191,37,2014,124634,-964,338,-626,1740,1107
37191,191,37,2015,124400,-1200,419,-781,1697,1155
37191,191,37,2016,124368,-806,320,-486,1634,1178
37191,191,37,2017,123201,-1775,285,-1490,1574,1260
37191,191,37,2018,123483,-290,218,-72,1647,1289
37191,191,37,2019,123904,-69,229,160,1635,1375
37191,191,37,2020,123967,-236,207,-29,1609,1521
37193,193,37,2010,69265,-44,-1,-45,171,165
37193,193,37,2011,68949,-288,-11,-299,680,695
37193,193,37,2012,68910,7,3,10,674,710
37193,193,37,2013,68610,-199,27,-172,686,806
37193,193,37,2014,68418,-24,23,-1,651,828
37193,193,37,2015,68302,-37,64,27,690,824
37193,193,37,2016,68573,335,47,382,707,814
37193,193,37,2017,68461,4,40,44,662,814
37193,193,37,2018,68481,143,46,189,693,858
37193,193,37,2019,68296,-48,37,-11,677,848
37193,193,37,2020,68043,-57,30,-27,679,906
37195,195,37,2010,81294,51,13,64,235,221
37195,195,37,2011,81153,-400,44,-356,1016,801
37195,195,37,2012,81393,-56,73,17,985,745
37195,195,37,2013,81186,-318,89,-229,922,895
37195,195,37,2014,80996,-363,62,-301,942,825
37195,195,37,2015,81228,61,74,135,944,837
37195,195,37,2016,81298,-168,94,-74,963,815
37195,195,37,2017,81446,-18,79,61,944,853
37195,195,37,2018,81396,-187,85,-102,990,935
37195,195,37,2019,81775,338,46,384,964,971
37195,195,37,2020,81979,190,51,241,973,1011
37197,197,37,2010,38435,-8,-4,-12,131,92
37197,197,37,2011,38344,-76,-15,-91,390,389
37197,197,37,2012,38149,-205,-9,-214,389,370
37197,197,37,2013,38070,-83,-1,-84,405,396
37197,197,37,2014,37852,-185,3,-182,412,444
37197,197,37,2015,37630,-171,28,-143,359,436
37197,197,37,2016,37650,90,5,95,375,447
37197,197,37,2017,37599,28,-3,25,376,450
37197,197,37,2018,37456,-89,12,-77,393,457
37197,197,37,2019,37617,243,-10,233,377,447
37197,197,37,2020,37625,116,-4,112,364,469
37199,199,37,2010,17805,-18,1,-17,43,37
37199,199,37,2011,17691,-45,1,-44,154,222
37199,199,37,2012,17625,-12,1,-11,185,237
37199,199,37,2013,17550,-9,-1,-10,168,232
37199,199,37,2014,17543,51,1,52,160,216
37199,199,37,2015,17550,44,-1,43,188,223
37199,199,37,2016,17590,117,2,119,145,221
37199,199,37,2017,17709,149,1,150,181,213
37199,199,37,2018,17893,233,5,238,181,234
37199,199,37,2019,18059,240,-1,239,170,242
37199,199,37,2020,18099,108,3,111,178,249
38001,001,38,2010,2351,6,0,6,9,7
38001,001,38,2011,2312,-34,0,-34,19,23
38001,001,38,2012,2334,30,3,33,17,28
38001,001,38,2013,2391,53,4,57,35,38
38001,001,38,2014,2387,4,5,9,21,31
38001,001,38,2015,2396,5,8,13,25,31
38001,001,38,2016,2339,-50,8,-42,21,35
38001,001,38,2017,2329,-26,19,-7,25,28
38001,001,38,2018,2272,-48,7,-41,24,39
38001,001,38,2019,2227,-58,6,-52,21,16
38001,001,38,2020,2188,-35,6,-29,23,30
38003,003,38,2010,11065,4,10,14,33,45
38003,003,38,2011,11115,32,26,58,114,121
38003,003,38,2012,11009,-97,6,-91,118,135
38003,003,38,2013,11116,133,1,134,110,138
38003,003,38,2014,11068,-44,-4,-48,135,132
38003,003,38,2015,11017,-20,-1,-21,100,130
38003,003,38,2016,10910,-90,-3,-93,110,124
38003,003,38,2017,10694,-200,-1,-201,108,123
38003,003,38,2018,10540,-107,-2,-109,95,139
38003,003,38,2019,10414,-79,-2,-81,89,135
38003,003,38,2020,10402,30,0,30,89,130
38005,005,38,2010,6677,3,1,4,37,25
38005,005,38,2011,6688,-45,7,-38,132,81
38005,005,38,2012,6771,-7,1,-6,155,65
38005,005,38,2013,6900,43,0,43,160,75
38005,005,38,2014,6887,-86,0,-86,154,82
38005,005,38,2015,6822,-134,0,-134,144,75
38005,005,38,2016,6848,-68,1,-67,173,79
38005,005,38,2017,6920,-12,1,-11,155,73
38005,005,38,2018,6934,-66,1,-65,135,55
38005,005,38,2019,6837,-200,1,-199,158,56
38005,005,38,2020,6762,-137,1,-136,141,81
38007,007,38,2010,783,-6,4,-2,1,0
38007,007,38,2011,845,49,11,60,5,4
38007,007,38,2012,921,60,6,66,9,1
38007,007,38,2013,913,-24,3,-21,14,1
38007,007,38,2014,922,-5,0,-5,15,2
38007,007,38,2015,950,10,2,12,18,1
38007,007,38,2016,950,-14,2,-12,18,7
38007,007,38,2017,924,-35,2,-33,15,8
38007,007,38,2018,923,-1,0,-1,9,9
38007,007,38,2019,937,9,0,9,12,7
38007,007,38,2020,890,-49,0,-49,10,7
38009,009,38,2010,6441,3,5,8,16,11
38009,009,38,2011,6500,64,13,77,77,96
38009,009,38,2012,6606,120,5,125,50,73
38009,009,38,2013,6744,127,2,129,80,73
38009,009,38,2014,6689,-71,3,-68,83,72
38009,009,38,2015,6742,44,9,53,68,68
38009,009,38,2016,6582,-145,3,-142,66,85
38009,009,38,2017,6531,-29,9,-20,65,96
38009,009,38,2018,6398,-122,6,-116,72,88
38009,009,38,2019,6292,-96,2,-94,62,74
38009,009,38,2020,6287,11,3,14,64,84
38011,011,38,2010,3142,0,2,2,10,21
38011,011,38,2011,3142,9,0,9,39,47
38011,011,38,2012,3210,68,0,68,43,44
38011,011,38,2013,3213,13,0,13,44,54
38011,011,38,2014,3236,30,0,30,40,46
38011,011,38,2015,3276,35,0,35,48,45
38011,011,38,2016,3222,-67,0,-67,42,29
38011,011,38,2017,3149,-75,0,-75,39,37
38011,011,38,2018,3061,-82,0,-82,27,34
38011,011,38,2019,3036,-36,0,-36,39,27
38011,011,38,2020,2986,-51,0,-51,33,32
38013,013,38,2010,1972,2,0,2,2,0
38013,013,38,2011,2063,91,0,91,25,25
38013,013,38,2012,2184,109,-1,108,29,22
38013,013,38,2013,2307,106,0,106,37,23
38013,013,38,2014,2263,-53,0,-53,39,29
38013,013,38,2015,2346,62,1,63,44,25
38013,013,38,2016,2226,-138,0,-138,37,22
38013,013,38,2017,2136,-111,3,-108,39,20
38013,013,38,2018,2100,-49,2,-47,32,21
38013,013,38,2019,2131,13,2,15,27,10
38013,013,38,2020,2118,-23,2,-21,24,15
38015,015,38,2010,81708,239,13,252,299,164
38015,015,38,2011,83315,1126,32,1158,1107,664
38015,015,38,2012,85787,1848,12,1860,1197,646
38015,015,38,2013,88472,2080,23,2103,1187,656
38015,015,38,2014,90571,1354,45,1399,1313,648
38015,015,38,2015,93284,1825,173,1998,1403,712
38015,015,38,2016,94642,625,128,753,1320,714
38015,015,38,2017,95343,-96,212,116,1317,730
38015,015,38,2018,95530,-473,157,-316,1272,767
38015,015,38,2019,95816,-168,55,-113,1144,748
38015,015,38,2020,96212,-9,64,55,1160,822
38017,017,38,2010,150321,52,208,260,540,254
38017,017,38,2011,153363,1009,710,1719,2202,889
38017,017,38,2012,157534,2061,520,2581,2355,829
38017,017,38,2013,163027,3286,626,3912,2431,951
38017,017,38,2014,166792,1816,411,2227,2502,1014
38017,017,38,2015,171028,1803,937,2740,2546,1071
38017,017,38,2016,174562,1333,595,1928,2628,1030
38017,017,38,2017,178122,836,1221,2057,2603,1102
38017,017,38,2018,180861,900,456,1356,2478,1099
38017,017,38,2019,182238,-172,284,112,2460,1202
38017,017,38,2020,183904,264,225,489,2446,1278
38019,019,38,2010,3986,-1,0,-1,8,14
38019,019,38,2011,3944,-33,-1,-34,44,52
38019,019,38,2012,3921,3,0,3,44,69
38019,019,38,2013,3854,-57,0,-57,35,45
38019,019,38,2014,3843,-21,1,-20,46,38
38019,019,38,2015,3824,-26,9,-17,47,49
38019,019,38,2016,3815,-25,8,-17,45,36
38019,019,38,2017,3787,-55,10,-45,61,44
38019,019,38,2018,3797,3,13,16,58,64
38019,019,38,2019,3734,-57,1,-56,40,45
38019,019,38,2020,3713,-26,3,-23,45,44
38021,021,38,2010,5278,-1,1,0,15,23
38021,021,38,2011,5253,10,1,11,39,74
38021,021,38,2012,5219,6,0,6,38,78
38021,021,38,2013,5194,-42,2,-40,73,59
38021,021,38,2014,5100,-93,2,-91,70,74
38021,021,38,2015,5052,-34,14,-20,53,81
38021,021,38,2016,4995,-70,9,-61,81,77
38021,021,38,2017,4834,-147,10,-137,50,75
38021,021,38,2018,4899,61,2,63,68,66
38021,021,38,2019,4851,-64,1,-63,62,49
38021,021,38,2020,4705,-146,2,-144,55,56
38023,023,38,2010,2080,11,1,12,6,9
38023,023,38,2011,2143,53,4,57,23,18
38023,023,38,2012,2247,111,5,116,19,35
38023,023,38,2013,2326,67,4,71,35,29
38023,023,38,2014,2427,90,6,96,29,26
38023,023,38,2015,2457,7,18,25,35,31
38023,023,38,2016,2389,-76,12,-64,27,31
38023,023,38,2017,2287,-115,13,-102,22,22
38023,023,38,2018,2249,-37,5,-32,21,28
38023,023,38,2019,2244,-9,3,-6,28,26
38023,023,38,2020,2277,27,2,29,27,23
38025,025,38,2010,3536,2,6,8,11,19
38025,025,38,2011,3723,170,16,186,39,40
38025,025,38,2012,3957,207,7,214,45,35
38025,025,38,2013,4139,170,2,172,49,44
38025,025,38,2014,4372,182,8,190,59,22
38025,025,38,2015,4576,136,13,149,91,38
38025,025,38,2016,4364,-251,10,-241,62,35
38025,025,38,2017,4268,-142,17,-125,61,34
38025,025,38,2018,4302,-2,5,3,68,36
38025,025,38,2019,4412,53,3,56,78,23
38025,025,38,2020,4465,0,3,3,72,23
38027,027,38,2010,2386,-1,0,-1,5,2
38027,027,38,2011,2347,-3,0,-3,22,59
38027,027,38,2012,2350,28,1,29,27,53
38027,027,38,2013,2366,44,0,44,22,50
38027,027,38,2014,2330,-27,0,-27,28,38
38027,027,38,2015,2304,-6,1,-5,27,49
38027,027,38,2016,2299,-11,0,-11,44,38
38027,027,38,2017,2315,38,0,38,32,54
38027,027,38,2018,2274,-27,0,-27,29,42
38027,027,38,2019,2241,-30,0,-30,27,30
38027,027,38,2020,2179,-50,0,-50,28,39
38029,029,38,2010,3531,4,0,4,7,24
38029,029,38,2011,3506,6,0,6,26,57
38029,029,38,2012,3471,-18,1,-17,27,47
38029,029,38,2013,3477,22,2,24,26,43
38029,029,38,2014,3412,-42,1,-41,32,56
38029,029,38,2015,3397,-10,3,-7,33,41
38029,029,38,2016,3330,-45,3,-42,27,53
38029,029,38,2017,3297,-18,3,-15,31,48
38029,029,38,2018,3261,-27,2,-25,27,38
38029,029,38,2019,3235,-20,1,-19,35,42
38029,029,38,2020,3187,-29,1,-28,29,49
38031,031,38,2010,3343,6,1,7,5,7
38031,031,38,2011,3343,6,5,11,29,40
38031,031,38,2012,3380,46,2,48,30,40
38031,031,38,2013,3355,-16,0,-16,40,50
38031,031,38,2014,3337,-14,0,-14,38,41
38031,031,38,2015,3325,-7,-2,-9,43,46
38031,031,38,2016,3308,-9,-2,-11,36,43
38031,031,38,2017,3251,-47,-2,-49,43,50
38031,031,38,2018,3212,-39,-2,-41,32,31
38031,031,38,2019,3217,5,-2,3,38,35
38031,031,38,2020,3165,-43,-2,-45,38,45
38033,033,38,2010,1682,6,0,6,5,9
38033,033,38,2011,1758,67,0,67,22,13
38033,033,38,2012,1806,47,0,47,20,22
38033,033,38,2013,1825,25,0,25,17,23
38033,033,38,2014,1854,26,0,26,28,25
38033,033,38,2015,1881,19,0,19,23,15
38033,033,38,2016,1863,-34,0,-34,28,13
38033,033,38,2017,1780,-89,0,-89,18,13
38033,033,38,2018,1765,-31,0,-31,29,13
38033,033,38,2019,1762,-14,0,-14,18,7
38033,033,38,2020,1737,-38,0,-38,21,7
38035,035,38,2010,66994,-77,86,9,259,133
38035,035,38,2011,66651,-1036,219,-817,949,482
38035,035,38,2012,67651,222,243,465,991,453
38035,035,38,2013,69198,889,205,1094,935,506
38035,035,38,2014,69865,-26,141,115,1014,453
38035,035,38,2015,70448,-309,288,-21,1056,447
38035,035,38,2016,70666,-545,188,-357,1061,485
38035,035,38,2017,70722,-794,345,-449,1020,519
38035,035,38,2018,70675,-581,76,-505,971,516
38035,035,38,2019,69670,-1460,44,-1416,932,522
38035,035,38,2020,69481,-615,43,-572,926,543
38037,037,38,2010,2394,0,0,0,3,3
38037,037,38,2011,2358,-50,2,-48,33,21
38037,037,38,2012,2348,3,3,6,17,33
38037,037,38,2013,2393,37,3,40,33,29
38037,037,38,2014,2374,-1,2,1,22,42
38037,037,38,2015,2396,31,1,32,23,33
38037,037,38,2016,2383,-20,0,-20,32,25
38037,037,38,2017,2361,-26,0,-26,30,27
38037,037,38,2018,2353,-12,0,-12,37,32
38037,037,38,2019,2272,-74,0,-74,16,22
38037,037,38,2020,2215,-51,0,-51,22,29
38039,039,38,2010,2416,-2,0,-2,10,12
38039,039,38,2011,2370,-27,0,-27,20,39
38039,039,38,2012,2345,-5,0,-5,16,36
38039,039,38,2013,2284,-35,0,-35,19,45
38039,039,38,2014,2292,29,0,29,19,40
38039,039,38,2015,2288,13,0,13,26,43
38039,039,38,2016,2252,-9,0,-9,13,40
38039,039,38,2017,2243,11,0,11,20,39
38039,039,38,2018,2213,-22,0,-22,20,30
38039,039,38,2019,2218,15,0,15,25,34
38039,039,38,2020,2207,2,0,2,21,34
38041,041,38,2010,2476,0,0,0,9,11
38041,041,38,2011,2504,44,0,44,26,44
38041,041,38,2012,2542,49,0,49,28,39
38041,041,38,2013,2644,105,0,105,31,37
38041,041,38,2014,2627,-11,0,-11,37,41
38041,041,38,2015,2658,24,1,25,31,25
38041,041,38,2016,2600,-63,0,-63,38,32
38041,041,38,2017,2480,-131,0,-131,34,25
38041,041,38,2018,2517,25,0,25,40,27
38041,041,38,2019,2521,-1,0,-1,31,26
38041,041,38,2020,2438,-90,0,-90,32,24
38043,043,38,2010,2447,11,0,11,0,0
38043,043,38,2011,2442,-19,0,-19,38,24
38043,043,38,2012,2447,3,0,3,21,18
38043,043,38,2013,2445,-7,0,-7,25,19
38043,043,38,2014,2449,-18,0,-18,36,15
38043,043,38,2015,2451,-12,3,-9,31,20
38043,043,38,2016,2472,10,1,11,24,12
38043,043,38,2017,2477,0,-2,-2,34,27
38043,043,38,2018,2453,-38,5,-33,27,18
38043,043,38,2019,2481,13,1,14,29,15
38043,043,38,2020,2458,-33,1,-32,27,18
38045,045,38,2010,4130,-2,0,-2,8,17
38045,045,38,2011,4095,-16,0,-16,31,50
38045,045,38,2012,4085,0,0,0,30,41
38045,045,38,2013,4101,10,0,10,47,39
38045,045,38,2014,4096,1,0,1,40,46
38045,045,38,2015,4136,28,0,28,56,42
38045,045,38,2016,4116,-23,5,-18,47,49
38045,045,38,2017,4106,-27,12,-15,48,43
38045,045,38,2018,4079,-43,5,-38,45,33
38045,045,38,2019,4049,-49,5,-44,55,42
38045,045,38,2020,4033,-27,5,-22,49,41
38047,047,38,2010,1998,9,0,9,3,2
38047,047,38,2011,1972,-18,1,-17,20,28
38047,047,38,2012,1941,-27,1,-26,22,29
38047,047,38,2013,1932,2,1,3,16,27
38047,047,38,2014,1941,18,2,20,19,30
38047,047,38,2015,1927,-15,6,-9,25,29
38047,047,38,2016,1924,5,4,9,17,28
38047,047,38,2017,1912,-11,4,-7,23,28
38047,047,38,2018,1887,-31,3,-28,32,30
38047,047,38,2019,1851,-39,2,-37,21,19
38047,047,38,2020,1880,21,0,21,26,18
38049,049,38,2010,5402,1,0,1,14,4
38049,049,38,2011,5501,98,3,101,57,61
38049,049,38,2012,5798,275,2,277,66,56
38049,049,38,2013,5906,91,1,92,86,71
38049,049,38,2014,5976,73,-1,72,64,67
38049,049,38,2015,5975,2,0,2,66,69
38049,049,38,2016,5981,-18,1,-17,78,55
38049,049,38,2017,5894,-97,2,-95,70,63
38049,049,38,2018,5802,-87,1,-86,72,78
38049,049,38,2019,5753,-64,1,-63,60,46
38049,049,38,2020,5695,-64,1,-63,62,56
38051,051,38,2010,2800,-8,0,-8,2,7
38051,051,38,2011,2758,-14,1,-13,24,54
38051,051,38,2012,2750,21,3,24,22,55
38051,051,38,2013,2737,15,1,16,29,59
38051,051,38,2014,2744,35,0,35,24,52
38051,051,38,2015,2716,-8,0,-8,30,50
38051,051,38,2016,2600,-94,0,-94,25,47
38051,051,38,2017,2607,25,0,25,19,38
38051,051,38,2018,2556,-18,0,-18,29,62
38051,051,38,2019,2473,-59,0,-59,24,47
38051,051,38,2020,2440,-13,0,-13,26,47
38053,053,38,2010,6412,40,3,43,10,2
38053,053,38,2011,7018,565,1,566,90,55
38053,053,38,2012,7989,897,1,898,103,69
38053,053,38,2013,9295,1177,3,1180,155,73
38053,053,38,2014,10997,1520,0,1520,188,61
38053,053,38,2015,12817,1597,8,1605,236,52
38053,053,38,2016,12604,-379,-7,-386,248,80
38053,053,38,2017,12715,-56,0,-56,232,65
38053,053,38,2018,13581,683,-6,677,246,60
38053,053,38,2019,15038,1253,-6,1247,267,53
38053,053,38,2020,15242,-2,-4,-6,288,79
38055,055,38,2010,8998,32,1,33,24,22
38055,055,38,2011,9082,81,7,88,107,112
38055,055,38,2012,9388,279,6,285,135,122
38055,055,38,2013,9466,101,4,105,93,123
38055,055,38,2014,9553,63,1,64,118,95
38055,055,38,2015,9664,81,1,82,122,94
38055,055,38,2016,9650,-41,1,-40,122,95
38055,055,38,2017,9638,-10,2,-8,120,123
38055,055,38,2018,9510,-111,1,-110,105,123
38055,055,38,2019,9440,-92,1,-91,116,95
38055,055,38,2020,9416,-21,1,-20,104,107
38057,057,38,2010,8418,-8,0,-8,31,29
38057,057,38,2011,8424,-26,5,-21,97,71
38057,057,38,2012,8474,17,4,21,102,76
38057,057,38,2013,8589,92,5,97,97,80
38057,057,38,2014,8712,107,0,107,108,90
38057,057,38,2015,8790,65,1,66,98,87
38057,057,38,2016,8634,-178,0,-178,110,87
38057,057,38,2017,8470,-188,5,-183,90,73
38057,057,38,2018,8291,-202,1,-201,101,79
38057,057,38,2019,8228,-82,-1,-83,90,72
38057,057,38,2020,8174,-57,1,-56,88,85
38059,059,38,2010,27570,79,1,80,102,87
38059,059,38,2011,27725,29,2,31,375,249
38059,059,38,2012,28092,231,-3,228,396,268
38059,059,38,2013,28939,653,-6,647,437,260
38059,059,38,2014,29792,644,15,659,446,271
38059,059,38,2015,30273,226,64,290,475,285
38059,059,38,2016,30775,168,72,240,524,263
38059,059,38,2017,30971,-64,83,19,505,325
38059,059,38,2018,31041,-149,110,-39,419,310
38059,059,38,2019,31301,125,3,128,442,311
38059,059,38,2020,31503,43,26,69,441,309
38061,061,38,2010,7708,42,0,42,28,29
38061,061,38,2011,8102,331,0,331,135,75
38061,061,38,2012,8739,545,-1,544,151,83
38061,061,38,2013,9342,499,1,500,159,74
38061,061,38,2014,9755,313,1,314,160,74
38061,061,38,2015,10311,469,22,491,150,94
38061,061,38,2016,10239,-181,20,-161,181,94
38061,061,38,2017,10273,-88,22,-66,186,89
38061,061,38,2018,10217,-174,19,-155,203,104
38061,061,38,2019,10507,180,13,193,177,78
38061,061,38,2020,10502,-114,8,-106,193,91
38063,063,38,2010,3121,6,0,6,8,19
38063,063,38,2011,3059,-25,1,-24,32,69
38063,063,38,2012,3055,30,1,31,29,64
38063,063,38,2013,3054,7,4,11,35,46
38063,063,38,2014,3017,-19,1,-18,38,58
38063,063,38,2015,2916,-62,4,-58,26,68
38063,063,38,2016,2887,-17,12,-5,25,49
38063,063,38,2017,2905,54,-1,53,30,66
38063,063,38,2018,2881,-22,21,-1,23,45
38063,063,38,2019,2856,-2,9,7,26,56
38063,063,38,2020,2789,-47,4,-43,24,48
38065,065,38,2010,1841,-7,0,-7,6,7
38065,065,38,2011,1849,2,-1,1,18,10
38065,065,38,2012,1849,-8,0,-8,20,13
38065,065,38,2013,1891,32,0,32,18,10
38065,065,38,2014,1870,-29,0,-29,28,18
38065,065,38,2015,1866,-11,0,-11,19,12
38065,065,38,2016,1896,21,0,21,25,17
38065,065,38,2017,1932,24,0,24,21,8
38065,065,38,2018,1950,-1,0,-1,29,11
38065,065,38,2019,1951,-6,0,-6,18,10
38065,065,38,2020,1926,-43,0,-43,23,5
38067,067,38,2010,7402,11,2,13,14,26
38067,067,38,2011,7355,-62,7,-55,88,80
38067,067,38,2012,7221,-137,9,-128,73,83
38067,067,38,2013,7099,-105,6,-99,71,96
38067,067,38,2014,7067,-36,14,-22,83,92
38067,067,38,2015,7033,-73,28,-45,87,77
38067,067,38,2016,7043,-22,17,-5,77,61
38067,067,38,2017,6936,-124,6,-118,95,84
38067,067,38,2018,6857,-70,1,-69,80,91
38067,067,38,2019,6754,-76,1,-75,54,80
38067,067,38,2020,6658,-69,1,-68,61,89
38069,069,38,2010,4360,4,0,4,4,7
38069,069,38,2011,4368,33,0,33,41,66
38069,069,38,2012,4444,101,0,101,49,76
38069,069,38,2013,4415,-15,0,-15,55,68
38069,069,38,2014,4360,-38,0,-38,51,68
38069,069,38,2015,4269,-76,0,-76,49,64
38069,069,38,2016,4209,-49,3,-46,42,57
38069,069,38,2017,4098,-111,16,-95,35,52
38069,069,38,2018,4072,-20,6,-14,45,57
38069,069,38,2019,3997,-77,4,-73,38,39
38069,069,38,2020,3928,-55,2,-53,35,50
38071,071,38,2010,11451,10,1,11,39,50
38071,071,38,2011,11524,12,9,21,186,133
38071,071,38,2012,11588,48,10,58,154,148
38071,071,38,2013,11584,-59,10,-49,149,105
38071,071,38,2014,11619,21,0,21,158,141
38071,071,38,2015,11667,18,17,35,172,158
38071,071,38,2016,11561,-170,21,-149,157,113
38071,071,38,2017,11594,-27,44,17,156,141
38071,071,38,2018,11574,-91,17,-74,180,126
38071,071,38,2019,11488,-120,14,-106,160,138
38071,071,38,2020,11388,-135,11,-124,160,134
38073,073,38,2010,5440,-21,0,-21,8,5
38073,073,38,2011,5432,12,0,12,62,83
38073,073,38,2012,5472,49,1,50,75,83
38073,073,38,2013,5498,32,3,35,61,70
38073,073,38,2014,5446,-46,1,-45,70,78
38073,073,38,2015,5455,27,4,31,59,81
38073,073,38,2016,5379,-52,3,-49,62,90
38073,073,38,2017,5301,-56,5,-51,61,87
38073,073,38,2018,5218,-49,0,-49,37,71
38073,073,38,2019,5217,29,0,29,53,83
38073,073,38,2020,5173,-16,0,-16,51,79
38075,075,38,2010,2484,3,1,4,10,1
38075,075,38,2011,2498,8,3,11,22,18
38075,075,38,2012,2556,56,0,56,31,32
38075,075,38,2013,2612,51,0,51,38,34
38075,075,38,2014,2572,-38,0,-38,29,31
38075,075,38,2015,2550,-24,0,-24,30,27
38075,075,38,2016,2525,-36,0,-36,39,29
38075,075,38,2017,2454,-66,0,-66,30,35
38075,075,38,2018,2349,-95,0,-95,22,31
38075,075,38,2019,2324,-17,0,-17,16,25
38075,075,38,2020,2283,-38,0,-38,21,24
38077,077,38,2010,16329,2,4,6,56,52
38077,077,38,2011,16269,-62,3,-59,143,143
38077,077,38,2012,16231,-76,-1,-77,146,107
38077,077,38,2013,16301,19,0,19,180,130
38077,077,38,2014,16363,19,-3,16,185,135
38077,077,38,2015,16306,-92,3,-89,193,160
38077,077,38,2016,16316,-48,3,-45,193,137
38077,077,38,2017,16323,-72,13,-59,208,142
38077,077,38,2018,16245,-121,2,-119,187,146
38077,077,38,2019,16187,-113,0,-113,195,140
38077,077,38,2020,16156,-70,0,-70,189,151
38079,079,38,2010,14009,6,3,9,83,21
38079,079,38,2011,14195,22,3,25,302,141
38079,079,38,2012,14406,41,1,42,297,125
38079,079,38,2013,14683,103,1,104,320,147
38079,079,38,2014,14738,-112,1,-111,304,138
38079,079,38,2015,14707,-180,0,-180,287,140
38079,079,38,2016,14732,-136,1,-135,282,122
38079,079,38,2017,14622,-209,1,-208,245,147
38079,079,38,2018,14396,-332,1,-331,241,137
38079,079,38,2019,14271,-203,0,-203,233,157
38079,079,38,2020,14165,-136,0,-136,218,187
38081,081,38,2010,3812,-24,0,-24,8,3
38081,081,38,2011,3791,-22,2,-20,32,32
38081,081,38,2012,3895,104,2,106,31,35
38081,081,38,2013,3882,-24,4,-20,42,36
38081,081,38,2014,3924,37,6,43,39,38
38081,081,38,2015,3871,-67,9,-58,43,39
38081,081,38,2016,3892,-3,9,6,44,29
38081,081,38,2017,3870,-51,18,-33,48,37
38081,081,38,2018,3872,-8,9,1,39,37
38081,081,38,2019,3950,50,8,58,47,27
38081,081,38,2020,3913,-53,6,-47,49,39
38083,083,38,2010,1316,-6,0,-6,4,4
38083,083,38,2011,1316,1,0,1,11,12
38083,083,38,2012,1284,-29,0,-29,12,14
38083,083,38,2013,1327,38,0,38,13,9
38083,083,38,2014,1334,10,0,10,7,11
38083,083,38,2015,1311,-22,0,-22,13,15
38083,083,38,2016,1344,25,0,25,15,6
38083,083,38,2017,1352,7,0,7,16,14
38083,083,38,2018,1336,-25,0,-25,16,7
38083,083,38,2019,1295,-45,0,-45,10,6
38083,083,38,2020,1275,-24,0,-24,12,8
38085,085,38,2010,4148,-14,0,-14,23,15
38085,085,38,2011,4237,31,1,32,95,38
38085,085,38,2012,4331,25,1,26,104,35
38085,085,38,2013,4442,64,0,64,104,58
38085,085,38,2014,4467,-28,0,-28,98,45
38085,085,38,2015,4385,-146,2,-144,106,45
38085,085,38,2016,4455,43,0,43,84,56
38085,085,38,2017,4427,-92,0,-92,94,30
38085,085,38,2018,4382,-81,0,-81,83,48
38085,085,38,2019,4259,-152,0,-152,74,43
38085,085,38,2020,4173,-84,0,-84,71,73
38087,087,38,2010,732,0,0,0,5,0
38087,087,38,2011,728,-11,0,-11,10,3
38087,087,38,2012,769,36,0,36,8,5
38087,087,38,2013,773,1,0,1,6,2
38087,087,38,2014,781,1,0,1,11,4
38087,087,38,2015,783,-2,0,-2,8,4
38087,087,38,2016,784,-2,0,-2,9,6
38087,087,38,2017,769,-18,1,-17,7,5
38087,087,38,2018,766,-13,0,-13,13,3
38087,087,38,2019,754,-14,0,-14,4,1
38087,087,38,2020,747,-10,0,-10,8,6
38089,089,38,2010,24359,98,20,118,73,35
38089,089,38,2011,25191,716,54,770,296,240
38089,089,38,2012,26917,1429,34,1463,410,211
38089,089,38,2013,28342,1143,40,1183,438,236
38089,089,38,2014,30345,1637,38,1675,515,242
38089,089,38,2015,31908,1140,92,1232,553,242
38089,089,38,2016,30937,-1357,58,-1299,564,244
38089,089,38,2017,30361,-1004,142,-862,491,214
38089,089,38,2018,30934,244,61,305,513,240
38089,089,38,2019,31483,211,33,244,544,239
38089,089,38,2020,32107,304,28,332,544,251
38091,091,38,2010,1993,10,0,10,7,0
38091,091,38,2011,1972,-20,0,-20,18,19
38091,091,38,2012,1953,-20,0,-20,20,19
38091,091,38,2013,1919,-35,0,-35,22,23
38091,091,38,2014,1914,-3,0,-3,16,18
38091,091,38,2015,1918,-1,0,-1,25,20
38091,091,38,2016,1916,-12,0,-12,30,18
38091,091,38,2017,1909,-10,0,-10,28,25
38091,091,38,2018,1903,-15,0,-15,21,12
38091,091,38,2019,1900,-9,0,-9,18,12
38091,091,38,2020,1890,-20,0,-20,20,10
38093,093,38,2010,21138,8,6,14,66,39
38093,093,38,2011,21027,-87,4,-83,218,246
38093,093,38,2012,20992,-22,8,-14,237,255
38093,093,38,2013,21105,111,11,122,229,237
38093,093,38,2014,21154,13,24,37,253,236
38093,093,38,2015,21090,-89,38,-51,224,237
38093,093,38,2016,21124,13,22,35,235,236
38093,093,38,2017,21179,53,41,94,215,253
38093,093,38,2018,20897,-280,19,-261,240,263
38093,093,38,2019,20695,-221,9,-212,226,214
38093,093,38,2020,20498,-178,5,-173,224,248
38095,095,38,2010,2243,0,0,0,2,4
38095,095,38,2011,2260,28,0,28,14,25
38095,095,38,2012,2290,26,0,26,30,28
38095,095,38,2013,2263,-11,0,-11,27,42
38095,095,38,2014,2274,9,0,9,31,30
38095,095,38,2015,2250,-22,4,-18,25,31
38095,095,38,2016,2249,-6,6,0,21,22
38095,095,38,2017,2247,-1,2,1,20,24
38095,095,38,2018,2184,-82,26,-56,26,34
38095,095,38,2019,2166,-21,8,-13,19,24
38095,095,38,2020,2108,-64,6,-58,23,22
38097,097,38,2010,8104,-14,1,-13,22,26
38097,097,38,2011,8068,-47,0,-47,88,77
38097,097,38,2012,8072,1,3,4,106,104
38097,097,38,2013,8191,103,3,106,91,81
38097,097,38,2014,8045,-149,0,-149,96,98
38097,097,38,2015,7991,-40,0,-40,92,106
38097,097,38,2016,8010,21,1,22,107,109
38097,097,38,2017,7996,-24,3,-21,99,91
38097,097,38,2018,7994,-2,4,2,78,81
38097,097,38,2019,8037,22,1,23,94,74
38097,097,38,2020,7959,-72,2,-70,89,96
38099,099,38,2010,11114,-23,1,-22,26,16
38099,099,38,2011,11024,-85,4,-81,125,133
38099,099,38,2012,11021,-8,11,3,121,124
38099,099,38,2013,11079,50,20,70,153,163
38099,099,38,2014,10907,-164,14,-150,133,158
38099,099,38,2015,10852,-81,23,-58,159,156
38099,099,38,2016,10813,-52,18,-34,150,154
38099,099,38,2017,10786,-52,21,-31,140,136
38099,099,38,2018,10602,-181,12,-169,136,150
38099,099,38,2019,10574,-19,1,-18,123,132
38099,099,38,2020,10437,-134,3,-131,125,132
38101,101,38,2010,62128,195,82,277,260,102
38101,101,38,2011,64386,1615,60,1675,1063,495
38101,101,38,2012,65595,131,396,527,1118,472
38101,101,38,2013,68028,1519,265,1784,1098,512
38101,101,38,2014,69587,569,213,782,1273,519
38101,101,38,2015,71409,592,397,989,1301,479
38101,101,38,2016,70164,-2331,297,-2034,1219,440
38101,101,38,2017,69226,-2080,397,-1683,1200,464
38101,101,38,2018,68504,-1457,114,-1343,1112,494
38101,101,38,2019,68449,-763,91,-672,1094,475
38101,101,38,2020,68466,-614,90,-524,1070,530
38103,103,38,2010,4192,2,1,3,10,28
38103,103,38,2011,4198,60,1,61,33,88
38103,103,38,2012,4235,54,4,58,44,68
38103,103,38,2013,4148,-49,3,-46,41,81
38103,103,38,2014,4123,-10,4,-6,36,55
38103,103,38,2015,4094,-16,2,-14,39,53
38103,103,38,2016,4052,-33,1,-32,51,62
38103,103,38,2017,3993,-35,2,-33,47,73
38103,103,38,2018,3895,-84,0,-84,50,64
38103,103,38,2019,3794,-78,0,-78,37,59
38103,103,38,2020,3709,-63,0,-63,37,58
38105,105,38,2010,22591,122,3,125,97,41
38105,105,38,2011,24417,1695,-7,1688,348,226
38105,105,38,2012,26755,2037,-12,2025,445,233
38105,105,38,2013,29623,2491,-3,2488,524,240
38105,105,38,2014,32166,2089,9,2098,596,238
38105,105,38,2015,35379,2627,44,2671,716,223
38105,105,38,2016,34286,-1610,58,-1552,690,243
38105,105,38,2017,33639,-1302,174,-1128,675,206
38105,105,38,2018,35698,1496,87,1583,706,235
38105,105,38,2019,37897,1599,37,1636,800,233
38105,105,38,2020,38700,180,27,207,845,252
39001,001,39,2010,28530,12,-1,11,93,102
39001,001,39,2011,28454,-121,-2,-123,351,304
39001,001,39,2012,28288,-175,4,-171,330,326
39001,001,39,2013,28085,-236,5,-231,365,338
39001,001,39,2014,28060,-20,14,-6,314,329
39001,001,39,2015,27919,-118,8,-110,303,332
39001,001,39,2016,27817,-99,9,-90,348,360
39001,001,39,2017,27747,-53,9,-44,329,354
39001,001,39,2018,27685,-93,8,-85,372,349
39001,001,39,2019,27640,-34,8,-26,333,351
39001,001,39,2020,27531,-75,8,-67,346,389
39003,003,39,2010,106342,-75,17,-58,337,220
39003,003,39,2011,105981,-664,61,-603,1317,1077
39003,003,39,2012,105251,-948,46,-902,1222,1065
39003,003,39,2013,105071,-360,32,-328,1289,1139
39003,003,39,2014,104886,-451,14,-437,1323,1063
39003,003,39,2015,104141,-923,32,-891,1250,1109
39003,003,39,2016,103691,-636,41,-595,1279,1134
39003,003,39,2017,103173,-622,40,-582,1214,1150
39003,003,39,2018,102747,-548,24,-524,1251,1154
39003,003,39,2019,102450,-436,31,-405,1247,1141
39003,003,39,2020,101980,-568,28,-540,1237,1168
39005,005,39,2010,53317,91,9,100,166,90
39005,005,39,2011,53255,-139,51,-88,597,569
39005,005,39,2012,53245,-164,91,-73,606,538
39005,005,39,2013,53163,-239,96,-143,630,575
39005,005,39,2014,53169,-217,100,-117,650,528
39005,005,39,2015,53317,-44,123,79,622,545
39005,005,39,2016,53487,86,106,192,573,593
39005,005,39,2017,53673,86,87,173,604,587
39005,005,39,2018,53727,-23,57,34,604,581
39005,005,39,2019,53418,-404,79,-325,600,585
39005,005,39,2020,53362,-103,69,-34,596,620
39007,007,39,2010,101411,-102,10,-92,283,275
39007,007,39,2011,101100,-365,52,-313,1156,1150
39007,007,39,2012,100274,-813,56,-757,1089,1167
39007,007,39,2013,99779,-498,71,-427,1122,1191
39007,007,39,2014,99064,-720,63,-657,1077,1141
39007,007,39,2015,98443,-603,84,-519,1112,1214
39007,007,39,2016,98172,-271,84,-187,1085,1163
39007,007,39,2017,97773,-417,77,-340,1156,1213
39007,007,39,2018,97536,-246,100,-146,1138,1227
39007,007,39,2019,97088,-331,9,-322,1103,1229
39007,007,39,2020,96513,-444,30,-414,1073,1234
39009,009,39,2010,65175,339,44,383,140,155
39009,009,39,2011,65092,-370,246,-124,558,520
39009,009,39,2012,64633,-875,279,-596,567,455
39009,009,39,2013,64628,-506,394,-112,540,445
39009,009,39,2014,64833,-207,314,107,562,459
39009,009,39,2015,65949,763,295,1058,544,500
39009,009,39,2016,66402,162,294,456,508,512
39009,009,39,2017,66587,-96,228,132,515,460
39009,009,39,2018,65673,-1104,165,-939,503,489
39009,009,39,2019,65582,-255,194,-61,472,506
39009,009,39,2020,65481,-198,157,-41,473,536
39011,011,39,2010,45914,-54,3,-51,130,100
39011,011,39,2011,45758,-297,27,-270,573,460
39011,011,39,2012,45787,-60,34,-26,510,451
39011,011,39,2013,45820,-22,42,20,534,519
39011,011,39,2014,45756,-133,34,-99,526,489
39011,011,39,2015,45754,-138,39,-99,565,466
39011,011,39,2016,45772,-50,21,-29,566,517
39011,011,39,2017,45756,-134,14,-120,582,477
39011,011,39,2018,45728,-115,8,-107,573,494
39011,011,39,2019,45610,-172,13,-159,541,500
39011,011,39,2020,45680,64,9,73,530,534
39013,013,39,2010,70337,-35,1,-34,202,226
39013,013,39,2011,70132,2,1,3,721,924
39013,013,39,2012,69728,-165,-2,-167,709,933
39013,013,39,2013,69593,93,-9,84,733,940
39013,013,39,2014,69403,-23,-9,-32,692,836
39013,013,39,2015,69018,-225,6,-219,706,865
39013,013,39,2016,68642,-154,16,-138,624,857
39013,013,39,2017,68074,-329,10,-319,650,900
39013,013,39,2018,67492,-206,3,-203,598,975
39013,013,39,2019,66979,-325,7,-318,652,846
39013,013,39,2020,65932,-784,7,-777,639,907
39015,015,39,2010,44868,8,0,8,135,102
39015,015,39,2011,44632,-256,-4,-260,509,485
39015,015,39,2012,44289,-416,-4,-420,522,451
39015,015,39,2013,44125,-170,-5,-175,504,492
39015,015,39,2014,43950,-189,1,-188,488,474
39015,015,39,2015,43717,-222,1,-221,485,496
39015,015,39,2016,43660,-25,6,-19,485,521
39015,015,39,2017,43558,-60,-2,-62,512,550
39015,015,39,2018,43623,153,-4,149,465,546
39015,015,39,2019,43473,-114,-3,-117,510,544
39015,015,39,2020,43414,-3,-3,-6,486,541
39017,017,39,2010,369111,310,158,468,1157,631
39017,017,39,2011,370164,-1122,686,-436,4543,3051
39017,017,39,2012,370628,-1634,660,-974,4470,3014
39017,017,39,2013,371497,-1757,966,-791,4699,3038
39017,017,39,2014,373877,381,761,1142,4417,3099
39017,017,39,2015,376173,171,928,1099,4536,3290
39017,017,39,2016,378527,282,793,1075,4579,3281
39017,017,39,2017,380751,669,665,1334,4387,3474
39017,017,39,2018,382114,-39,416,377,4532,3538
39017,017,39,2019,383603,-105,541,436,4490,3445
39017,017,39,2020,385648,902,447,1349,4426,3747
39019,019,39,2010,28859,-22,0,-22,79,42
39019,019,39,2011,28832,-42,0,-42,309,292
39019,019,39,2012,28551,-220,1,-219,243,308
39019,019,39,2013,28272,-279,7,-272,280,288
39019,019,39,2014,28144,-56,4,-52,265,339
39019,019,39,2015,27729,-344,1,-343,280,354
39019,019,39,2016,27630,-87,-1,-88,281,291
39019,019,39,2017,27329,-238,-1,-239,275,340
39019,019,39,2018,27134,-133,-1,-134,281,342
39019,019,39,2019,26984,-92,-1,-93,274,330
39019,019,39,2020,26897,-16,-1,-17,269,340
39021,021,39,2010,40078,-52,3,-49,95,66
39021,021,39,2011,39828,-293,24,-269,421,404
39021,021,39,2012,39579,-293,26,-267,391,375
39021,021,39,2013,39468,-166,13,-153,415,375
39021,021,39,2014,39089,-411,7,-404,386,369
39021,021,39,2015,38976,-81,9,-72,394,430
39021,021,39,2016,38760,-214,6,-208,412,421
39021,021,39,2017,38857,100,5,105,402,408
39021,021,39,2018,38799,-50,4,-46,437,447
39021,021,39,2019,38930,125,5,130,389,386
39021,021,39,2020,38960,65,4,69,388,429
39023,023,39,2010,138272,-140,26,-114,434,377
39023,023,39,2011,137823,-560,90,-470,1623,1601
39023,023,39,2012,137198,-555,56,-499,1592,1709
39023,023,39,2013,136682,-399,44,-355,1597,1745
39023,023,39,2014,136364,-273,34,-239,1555,1616
39023,023,39,2015,135810,-456,85,-371,1628,1802
39023,023,39,2016,134805,-861,90,-771,1587,1820
39023,023,39,2017,134636,45,76,121,1546,1827
39023,023,39,2018,134697,124,34,158,1641,1735
39023,023,39,2019,134315,-262,67,-195,1540,1727
39023,023,39,2020,133593,-530,62,-468,1530,1785
39025,025,39,2010,197613,26,34,60,619,416
39025,025,39,2011,198886,303,85,388,2443,1551
39025,025,39,2012,199526,-296,113,-183,2378,1530
39025,025,39,2013,200504,203,131,334,2327,1646
39025,025,39,2014,201516,312,83,395,2258,1603
39025,025,39,2015,202077,-195,164,-31,2350,1733
39025,025,39,2016,203332,501,201,702,2356,1793
39025,025,39,2017,204456,518,169,687,2266,1814
39025,025,39,2018,205803,799,73,872,2361,1880
39025,025,39,2019,206851,538,141,679,2252,1886
39025,025,39,2020,207449,179,115,294,2258,1968
39027,027,39,2010,41922,-157,4,-153,132,113
39027,027,39,2011,41919,-92,15,-77,486,414
39027,027,39,2012,41829,-156,15,-141,514,458
39027,027,39,2013,41879,-53,18,-35,521,435
39027,027,39,2014,41824,-141,11,-130,508,428
39027,027,39,2015,41864,-55,17,-38,526,442
39027,027,39,2016,41923,-53,22,-31,510,419
39027,027,39,2017,42035,47,29,76,500,460
39027,027,39,2018,42119,76,13,89,482,485
39027,027,39,2019,42002,-135,26,-109,433,441
39027,027,39,2020,41921,-61,25,-36,455,502
39029,029,39,2010,107889,-6,13,7,286,242
39029,029,39,2011,107437,-402,18,-384,1110,1175
39029,029,39,2012,106652,-765,22,-743,1106,1155
39029,029,39,2013,106007,-519,16,-503,1079,1219
39029,029,39,2014,105681,-208,23,-185,1106,1233
39029,029,39,2015,104788,-642,21,-621,1066,1338
39029,029,39,2016,103926,-741,49,-692,1101,1269
39029,029,39,2017,103198,-532,42,-490,1050,1287
39029,029,39,2018,102534,-428,32,-396,1033,1300
39029,029,39,2019,101794,-468,39,-429,975,1287
39029,029,39,2020,101118,-363,34,-329,976,1326
39031,031,39,2010,36938,-7,1,-6,116,69
39031,031,39,2011,36930,-49,3,-46,426,387
39031,031,39,2012,36821,-153,7,-146,440,400
39031,031,39,2013,36721,-153,14,-139,476,437
39031,031,39,2014,36530,-184,12,-172,427,447
39031,031,39,2015,36579,-52,3,-49,464,362
39031,031,39,2016,36651,-51,8,-43,500,383
39031,031,39,2017,36535,-195,6,-189,464,390
39031,031,39,2018,36607,60,6,66,458,450
39031,031,39,2019,36549,-58,3,-55,437,439
39031,031,39,2020,36449,-109,3,-106,448,442
39033,033,39,2010,43754,-48,0,-48,115,96
39033,033,39,2011,43310,-460,2,-458,505,492
39033,033,39,2012,42774,-454,4,-450,453,546
39033,033,39,2013,42715,-6,13,7,462,521
39033,033,39,2014,42406,-247,22,-225,472,553
39033,033,39,2015,42327,-46,32,-14,513,575
39033,033,39,2016,42096,-176,40,-136,469,563
39033,033,39,2017,41733,-276,32,-244,473,592
39033,033,39,2018,41454,-163,19,-144,466,600
39033,033,39,2019,41396,-7,32,25,460,543
39033,033,39,2020,41338,8,23,31,450,540
39035,035,39,2010,1278103,-3134,518,-2616,3801,3272
39035,035,39,2011,1270424,-11661,2706,-8955,15002,13764
39035,035,39,2012,1266271,-8109,2991,-5118,14858,13875
39035,035,39,2013,1265698,-5550,4011,-1539,14871,13792
39035,035,39,2014,1263498,-7583,3732,-3851,15135,13406
39035,035,39,2015,1259109,-9843,4024,-5819,14988,13545
39035,035,39,2016,1254324,-9614,3878,-5736,14647,13677
39035,035,39,2017,1247808,-10093,3091,-7002,14609,14107
39035,035,39,2018,1241788,-8816,2715,-6101,14315,14214
39035,035,39,2019,1235574,-8126,1779,-6347,13858,13721
39035,035,39,2020,1227883,-8799,1749,-7050,13702,14348
39037,037,39,2010,52964,-10,3,-7,157,150
39037,037,39,2011,52657,-357,2,-355,602,554
39037,037,39,2012,52524,-246,6,-240,625,520
39037,037,39,2013,52321,-217,13,-204,596,598
39037,037,39,2014,52203,-216,12,-204,656,566
39037,037,39,2015,52002,-188,18,-170,616,644
39037,037,39,2016,51653,-365,18,-347,603,603
39037,037,39,2017,51575,-105,17,-88,640,627
39037,037,39,2018,51323,-257,9,-248,639,643
39037,037,39,2019,51181,-163,14,-149,626,619
39037,037,39,2020,51205,45,13,58,612,646
39039,039,39,2010,39083,50,8,58,112,117
39039,039,39,2011,39015,-222,30,-192,500,375
39039,039,39,2012,38845,-287,41,-246,451,381
39039,039,39,2013,38587,-373,38,-335,441,368
39039,039,39,2014,38547,-109,35,-74,397,358
39039,039,39,2015,38349,-258,41,-217,435,417
39039,039,39,2016,38162,-250,27,-223,424,388
39039,039,39,2017,38158,-26,13,-13,417,406
39039,039,39,2018,38046,-146,3,-143,454,423
39039,039,39,2019,37978,-86,10,-76,412,405
39039,039,39,2020,37778,-178,12,-166,404,438
39041,041,39,2010,175114,542,73,615,555,249
39041,041,39,2011,178584,2044,248,2292,2094,923
39041,041,39,2012,181234,1146,309,1455,2109,904
39041,041,39,2013,185545,2730,358,3088,2178,992
39041,041,39,2014,189649,2493,326,2819,2249,992
39041,041,39,2015,193624,2337,505,2842,2158,1034
39041,041,39,2016,197442,2190,543,2733,2207,1117
39041,041,39,2017,201157,2353,391,2744,2106,1126
39041,041,39,2018,205347,3070,253,3323,2080,1212
39041,041,39,2019,209768,3138,318,3456,2164,1189
39041,041,39,2020,213554,2790,257,3047,2118,1372
39043,043,39,2010,76977,-26,9,-17,194,256
39043,043,39,2011,76691,-181,23,-158,761,888
39043,043,39,2012,76440,-135,49,-86,756,907
39043,043,39,2013,76071,-283,39,-244,814,935
39043,043,39,2014,75833,-214,34,-180,815,871
39043,043,39,2015,75388,-313,32,-281,806,968
39043,043,39,2016,75004,-216,19,-197,771,954
39043,043,39,2017,74778,-14,11,-3,793,1011
39043,043,39,2018,74413,-150,4,-146,779,994
39043,043,39,2019,74179,-139,7,-132,790,891
39043,043,39,2020,73719,-233,6,-227,758,991
39045,045,39,2010,146408,79,24,103,416,274
39045,045,39,2011,147180,188,95,283,1603,1109
39045,045,39,2012,147314,-555,162,-393,1658,1138
39045,045,39,2013,148820,754,216,970,1730,1187
39045,045,39,2014,150400,975,171,1146,1647,1190
39045,045,39,2015,151310,289,219,508,1670,1250
39045,045,39,2016,152829,870,231,1101,1699,1269
39045,045,39,2017,154718,1388,151,1539,1762,1401
39045,045,39,2018,156062,880,100,980,1808,1431
39045,045,39,2019,157703,1234,128,1362,1711,1426
39045,045,39,2020,159709,1724,100,1824,1720,1530
39047,047,39,2010,29016,-1,3,2,86,101
39047,047,39,2011,28870,-158,4,-154,355,348
39047,047,39,2012,28770,-141,8,-133,374,340
39047,047,39,2013,28690,-82,19,-63,364,377
39047,047,39,2014,28652,-28,14,-14,329,350
39047,047,39,2015,28617,-44,22,-22,347,358
39047,047,39,2016,28695,51,25,76,358,355
39047,047,39,2017,28669,45,21,66,326,417
39047,047,39,2018,28614,-2,10,8,311,372
39047,047,39,2019,28486,-152,19,-133,344,339
39047,047,39,2020,28579,102,13,115,321,344
39049,049,39,2010,1166218,-630,953,323,4506,1967
39049,049,39,2011,1180917,919,4504,5423,17856,8577
39049,049,39,2012,1199257,3465,5374,8839,18128,8565
39049,049,39,2013,1219186,2921,7326,10247,18610,8934
39049,049,39,2014,1238758,3313,6266,9579,18876,8870
39049,049,39,2015,1257891,2343,7508,9851,18874,9553
39049,049,39,2016,1275212,37,7657,7694,19048,9394
39049,049,39,2017,1296374,5959,6073,12032,18803,9719
39049,049,39,2018,1308599,-331,4110,3779,18647,10186
39049,049,39,2019,1318766,-3361,5304,1943,18242,10043
39049,049,39,2020,1324624,-5726,4178,-1548,18195,10851
39051,051,39,2010,42630,-76,8,-68,111,113
39051,051,39,2011,42363,-371,12,-359,494,403
39051,051,39,2012,42330,-112,6,-106,450,374
39051,051,39,2013,42199,-232,24,-208,498,426
39051,051,39,2014,42401,58,8,66,529,388
39051,051,39,2015,42299,-206,28,-178,492,416
39051,051,39,2016,42337,-77,32,-45,498,414
39051,051,39,2017,42274,-127,43,-84,480,459
39051,051,39,2018,42256,-48,12,-36,477,458
39051,051,39,2019,42175,-175,47,-128,469,422
39051,051,39,2020,41889,-328,36,-292,466,459
39053,053,39,2010,31066,113,2,115,114,110
39053,053,39,2011,31023,-69,18,-51,360,350
39053,053,39,2012,30881,-223,26,-197,388,340
39053,053,39,2013,30684,-218,28,-190,369,377
39053,053,39,2014,30467,-267,0,-267,406,357
39053,053,39,2015,30258,-229,45,-184,354,377
39053,053,39,2016,30213,-82,24,-58,402,387
39053,053,39,2017,30156,-44,26,-18,346,384
39053,053,39,2018,29956,-180,17,-163,373,409
39053,053,39,2019,29850,-84,22,-62,350,394
39053,053,39,2020,29802,-33,19,-14,349,384
39055,055,39,2010,93381,-44,11,-33,234,220
39055,055,39,2011,93287,-290,30,-260,916,751
39055,055,39,2012,93770,273,35,308,930,746
39055,055,39,2013,93847,-98,55,-43,903,783
39055,055,39,2014,93981,-69,52,-17,918,764
39055,055,39,2015,93899,-175,49,-126,905,856
39055,055,39,2016,93858,-154,48,-106,914,846
39055,055,39,2017,93891,-56,35,-21,934,876
39055,055,39,2018,93770,-163,24,-139,908,885
39055,055,39,2019,93494,-429,31,-398,956,832
39055,055,39,2020,93271,-238,27,-211,912,919
39057,057,39,2010,161599,-214,86,-128,427,284
39057,057,39,2011,163600,1239,292,1531,1723,1256
39057,057,39,2012,164403,-158,585,427,1759,1349
39057,057,39,2013,164004,-1520,662,-858,1794,1363
39057,057,39,2014,164796,-224,541,317,1838,1333
39057,057,39,2015,164421,-1380,666,-714,1801,1478
39057,057,39,2016,165494,87,528,615,1908,1441
39057,057,39,2017,166720,623,374,997,1739,1499
39057,057,39,2018,167643,516,211,727,1747,1540
39057,057,39,2019,169354,1274,305,1579,1706,1573
39057,057,39,2020,170122,474,258,732,1713,1683
39059,059,39,2010,40152,34,0,34,107,81
39059,059,39,2011,39915,-246,1,-245,463,455
39059,059,39,2012,39886,-51,9,-42,452,431
39059,059,39,2013,39716,-186,8,-178,457,446
39059,059,39,2014,39699,-6,8,2,460,472
39059,059,39,2015,39402,-300,10,-290,460,466
39059,059,39,2016,39237,-211,13,-198,485,450
39059,059,39,2017,39077,-116,12,-104,459,513
39059,059,39,2018,39011,-7,11,4,429,499
39059,059,39,2019,38876,-106,5,-101,436,470
39059,059,39,2020,38779,-28,7,-21,436,515
39061,061,39,2010,802295,-1307,323,-984,2663,1734
39061,061,39,2011,800746,-6358,1557,-4801,10918,7684
39061,061,39,2012,802564,-3371,1778,-1593,11071,7587
39061,061,39,2013,805408,-2959,2519,-440,10968,7621
39061,061,39,2014,807922,-2756,2217,-539,10937,7773
39061,061,39,2015,809902,-3492,2593,-899,11096,8157
39061,061,39,2016,811766,-3458,2480,-978,10819,7950
39061,061,39,2017,814693,-1519,1969,450,10651,8126
39061,061,39,2018,815853,-2557,1299,-1258,10737,8295
39061,061,39,2019,818653,-1750,1727,-23,10665,7850
39061,061,39,2020,817985,-4279,1377,-2902,10619,8412
39063,063,39,2010,74698,-164,21,-143,220,172
39063,063,39,2011,74926,34,40,74,874,714
39063,063,39,2012,75478,244,99,343,885,660
39063,063,39,2013,75612,-210,162,-48,925,735
39063,063,39,2014,75324,-725,151,-574,955,685
39063,063,39,2015,75726,0,217,217,940,744
39063,063,39,2016,75829,-192,195,3,884,781
39063,063,39,2017,75984,-158,148,-10,939,773
39063,063,39,2018,75913,-231,94,-137,894,828
39063,063,39,2019,75690,-438,127,-311,870,783
39063,063,39,2020,75407,-470,101,-369,848,762
39065,065,39,2010,32126,10,5,15,106,54
39065,065,39,2011,31805,-400,22,-378,372,317
39065,065,39,2012,31630,-255,19,-236,369,311
39065,065,39,2013,31743,29,22,51,402,336
39065,065,39,2014,31780,-68,22,-46,402,318
39065,065,39,2015,31615,-218,3,-215,358,308
39065,065,39,2016,31374,-277,8,-269,347,320
39065,065,39,2017,31338,-92,5,-87,382,331
39065,065,39,2018,31417,17,-2,15,388,324
39065,065,39,2019,31369,-118,2,-116,389,321
39065,065,39,2020,31469,77,3,80,368,349
39067,067,39,2010,15816,-13,0,-13,45,65
39067,067,39,2011,15784,8,3,11,152,196
39067,067,39,2012,15679,-61,2,-59,163,206
39067,067,39,2013,15598,-53,1,-52,160,186
39067,067,39,2014,15517,-43,1,-42,161,199
39067,067,39,2015,15396,-69,3,-66,175,229
39067,067,39,2016,15237,-107,3,-104,138,194
39067,067,39,2017,15203,-3,2,-1,159,191
39067,067,39,2018,15151,18,1,19,155,223
39067,067,39,2019,15053,-53,2,-51,135,183
39067,067,39,2020,15014,35,1,36,135,209
39069,069,39,2010,28170,-58,3,-55,89,81
39069,069,39,2011,27999,-213,-2,-215,324,282
39069,069,39,2012,27826,-240,10,-230,346,292
39069,069,39,2013,27831,-112,11,-101,356,250
39069,069,39,2014,27605,-259,0,-259,294,265
39069,069,39,2015,27490,-136,1,-135,313,292
39069,069,39,2016,27268,-198,2,-196,271,298
39069,069,39,2017,27189,-131,1,-130,323,271
39069,069,39,2018,27039,-146,-2,-148,317,319
39069,069,39,2019,26942,-134,2,-132,316,281
39069,069,39,2020,26904,-64,-1,-65,300,273
39071,071,39,2010,43619,-19,0,-19,133,97
39071,071,39,2011,43376,-307,-2,-309,546,480
39071,071,39,2012,42966,-484,6,-478,495,437
39071,071,39,2013,43200,191,18,209,543,513
39071,071,39,2014,43102,-219,13,-206,585,471
39071,071,39,2015,42973,-160,15,-145,516,498
39071,071,39,2016,43011,-33,10,-23,551,487
39071,071,39,2017,42931,-126,9,-117,548,512
39071,071,39,2018,43032,34,2,36,547,479
39071,071,39,2019,43123,38,8,46,559,514
39071,071,39,2020,43304,153,3,156,543,518
39073,073,39,2010,29483,70,1,71,82,42
39073,073,39,2011,29471,-21,6,-15,315,311
39073,073,39,2012,29310,-180,6,-174,307,299
39073,073,39,2013,28660,-680,3,-677,335,318
39073,073,39,2014,28749,83,3,86,316,308
39073,073,39,2015,28502,-274,7,-267,310,289
39073,073,39,2016,28403,-146,9,-137,316,277
39073,073,39,2017,28440,75,5,80,287,328
39073,073,39,2018,28353,-58,1,-57,322,350
39073,073,39,2019,28240,-73,5,-68,288,334
39073,073,39,2020,28095,-88,1,-87,291,349
39075,075,39,2010,42471,-55,2,-53,211,50
39075,075,39,2011,42795,-181,5,-176,784,284
39075,075,39,2012,43130,-173,0,-173,792,287
39075,075,39,2013,43607,-24,0,-24,806,298
39075,075,39,2014,43791,-300,0,-300,785,299
39075,075,39,2015,43885,-314,1,-313,736,329
39075,075,39,2016,43866,-432,6,-426,724,317
39075,075,39,2017,43908,-329,5,-324,702,337
39075,075,39,2018,43973,-339,1,-338,739,336
39075,075,39,2019,44021,-405,3,-402,773,324
39075,075,39,2020,44004,-460,1,-459,809,366
39077,077,39,2010,59566,-95,13,-82,172,150
39077,077,39,2011,59428,-403,50,-353,736,522
39077,077,39,2012,59220,-351,25,-326,713,600
39077,077,39,2013,58840,-584,44,-540,731,582
39077,077,39,2014,58626,-373,10,-363,753,605
39077,077,39,2015,58325,-465,15,-450,722,575
39077,077,39,2016,58386,-150,10,-140,772,570
39077,077,39,2017,58403,-133,9,-124,755,613
39077,077,39,2018,58316,-150,-3,-153,709,641
39077,077,39,2019,58269,-138,7,-131,700,616
39077,077,39,2020,57979,-325,7,-318,686,658
39079,079,39,2010,33249,34,1,35,128,132
39079,079,39,2011,33126,-134,-1,-135,399,388
39079,079,39,2012,32869,-265,-2,-267,391,384
39079,079,39,2013,32807,-151,27,-124,473,411
39079,079,39,2014,32772,-80,22,-58,434,405
39079,079,39,2015,32575,-246,32,-214,408,391
39079,079,39,2016,32565,-71,28,-43,444,410
39079,079,39,2017,32398,-139,18,-121,375,421
39079,079,39,2018,32370,-15,13,-2,439,464
39079,079,39,2019,32372,42,16,58,377,433
39079,079,39,2020,32493,148,16,164,376,419
39081,081,39,2010,69669,0,0,0,160,200
39081,081,39,2011,69046,-244,-3,-247,629,1002
39081,081,39,2012,68557,-149,-9,-158,668,991
39081,081,39,2013,68200,-74,3,-71,670,946
39081,081,39,2014,67916,-23,-1,-24,657,905
39081,081,39,2015,67546,-44,1,-43,708,1026
39081,081,39,2016,66993,-296,1,-295,649,905
39081,081,39,2017,66398,-260,-5,-265,648,973
39081,081,39,2018,65889,-237,-8,-245,659,922
39081,081,39,2019,65494,-141,-7,-148,666,912
39081,081,39,2020,64939,-219,-6,-225,659,990
39083,083,39,2010,61087,89,5,94,188,122
39083,083,39,2011,61290,134,7,141,680,616
39083,083,39,2012,60781,-637,9,-628,738,634
39083,083,39,2013,60882,-24,13,-11,741,622
39083,083,39,2014,61035,34,5,39,698,570
39083,083,39,2015,61045,-144,13,-131,746,600
39083,083,39,2016,60953,-212,14,-198,743,632
39083,083,39,2017,61345,309,11,320,731,657
39083,083,39,2018,61921,389,5,394,808,624
39083,083,39,2019,62239,209,10,219,712,612
39083,083,39,2020,62423,84,10,94,738,646
39085,085,39,2010,230010,-95,40,-55,577,542
39085,085,39,2011,229991,-131,132,1,2371,2385
39085,085,39,2012,229572,-450,198,-252,2205,2338
39085,085,39,2013,230085,368,356,724,2282,2449
39085,085,39,2014,229865,-543,285,-258,2255,2190
39085,085,39,2015,229843,-169,382,213,2301,2509
39085,085,39,2016,229499,-422,330,-92,2234,2473
39085,085,39,2017,230114,749,249,998,2230,2594
39085,085,39,2018,229856,-5,161,156,2183,2586
39085,085,39,2019,229739,55,155,210,2189,2518
39085,085,39,2020,229569,171,157,328,2185,2694
39087,087,39,2010,62428,-36,-2,-38,161,138
39087,087,39,2011,62432,-19,-16,-35,737,696
39087,087,39,2012,62177,-274,-21,-295,739,698
39087,087,39,2013,61908,-177,-10,-187,684,761
39087,087,39,2014,61599,-257,-12,-269,722,756
39087,087,39,2015,60990,-489,-11,-500,687,796
39087,087,39,2016,60817,-79,-3,-82,710,799
39087,087,39,2017,60176,-393,-8,-401,604,844
39087,087,39,2018,59864,-39,-10,-49,625,886
39087,087,39,2019,59556,-57,-10,-67,608,849
39087,087,39,2020,59091,-244,-4,-248,612,829
39089,089,39,2010,166725,89,13,102,495,360
39089,089,39,2011,167195,-89,67,-22,1952,1454
39089,089,39,2012,167636,-127,149,22,1959,1515
39089,089,39,2013,168532,329,149,478,1956,1506
39089,089,39,2014,169506,396,156,552,1959,1497
39089,089,39,2015,170721,741,168,909,1971,1646
39089,089,39,2016,172166,863,171,1034,2026,1606
39089,089,39,2017,173790,1168,141,1309,1968,1647
39089,089,39,2018,175816,1726,84,1810,1974,1755
39089,089,39,2019,177174,928,120,1048,1999,1688
39089,089,39,2020,178100,666,101,767,1980,1826
39091,091,39,2010,45743,-81,1,-80,123,149
39091,091,39,2011,45625,-264,9,-255,584,448
39091,091,39,2012,45412,-309,13,-296,515,432
39091,091,39,2013,45399,-128,31,-97,553,466
39091,091,39,2014,45477,-11,24,13,560,484
39091,091,39,2015,45255,-246,9,-237,548,530
39091,091,39,2016,45145,-176,19,-157,545,497
39091,091,39,2017,45217,83,11,94,490,508
39091,091,39,2018,45291,32,8,40,566,530
39091,091,39,2019,45594,213,11,224,556,476
39091,091,39,2020,45326,-273,7,-266,542,544
39093,093,39,2010,301479,-54,84,30,821,718
39093,093,39,2011,301899,-547,393,-154,3478,2897
39093,093,39,2012,301757,-1167,492,-675,3318,2785
39093,093,39,2013,303159,439,592,1031,3396,2972
39093,093,39,2014,304551,423,588,1011,3367,2918
39093,093,39,2015,305533,-25,615,590,3460,3032
39093,093,39,2016,306676,331,575,906,3304,3049
39093,093,39,2017,307498,329,477,806,3261,3224
39093,093,39,2018,309222,1259,502,1761,3246,3266
39093,093,39,2019,310100,689,199,888,3197,3204
39093,093,39,2020,312172,1937,252,2189,3204,3323
39095,095,39,2010,441447,-906,108,-798,1470,1047
39095,095,39,2011,439409,-3802,347,-3455,5601,4198
39095,095,39,2012,436846,-4445,434,-4011,5665,4298
39095,095,39,2013,436269,-2352,613,-1739,5633,4470
39095,095,39,2014,434736,-3490,499,-2991,5807,4373
39095,095,39,2015,433826,-2723,678,-2045,5662,4520
39095,095,39,2016,433113,-2454,676,-1778,5574,4501
39095,095,39,2017,431312,-3259,520,-2739,5460,4529
39095,095,39,2018,429990,-2400,319,-2081,5488,4723
39095,095,39,2019,428888,-2128,398,-1730,5317,4699
39095,095,39,2020,428294,-1379,339,-1040,5238,4808
39097,097,39,2010,43434,22,8,30,89,120
39097,097,39,2011,43120,-416,45,-371,430,376
39097,097,39,2012,42996,-236,54,-182,429,375
39097,097,39,2013,43263,245,55,300,405,432
39097,097,39,2014,43988,620,37,657,438,382
39097,097,39,2015,44149,91,52,143,423,401
39097,097,39,2016,43400,-789,51,-738,412,429
39097,097,39,2017,44077,635,53,688,424,437
39097,097,39,2018,44393,299,23,322,443,447
39097,097,39,2019,44812,326,50,376,440,399
39097,097,39,2020,44559,-297,38,-259,449,442
39099,099,39,2010,238315,-344,48,-296,606,776
39099,099,39,2011,237304,-556,219,-337,2340,3008
39099,099,39,2012,235689,-1136,236,-900,2330,3037
39099,099,39,2013,234431,-885,315,-570,2400,3077
39099,099,39,2014,233472,-706,326,-380,2419,2966
39099,099,39,2015,231988,-970,300,-670,2431,3231
39099,099,39,2016,230263,-1375,292,-1083,2381,3019
39099,099,39,2017,229438,-632,318,-314,2519,3020
39099,099,39,2018,228975,-246,406,160,2418,3033
39099,099,39,2019,227510,-848,40,-808,2361,3020
39099,099,39,2020,226075,-802,130,-672,2350,3116
39101,101,39,2010,66459,-52,6,-46,192,186
39101,101,39,2011,66614,-44,15,-29,807,623
39101,101,39,2012,66301,-398,2,-396,780,694
39101,101,39,2013,65996,-388,16,-372,781,715
39101,101,39,2014,65822,-246,11,-235,746,683
39101,101,39,2015,65470,-378,58,-320,763,794
39101,101,39,2016,65481,-32,76,44,724,753
39101,101,39,2017,65113,-389,49,-340,746,775
39101,101,39,2018,65426,318,46,364,739,785
39101,101,39,2019,65057,-379,34,-345,746,771
39101,101,39,2020,64820,-178,29,-149,722,808
39103,103,39,2010,172503,94,36,130,446,382
39103,103,39,2011,173514,393,100,493,1809,1284
39103,103,39,2012,173648,-293,95,-198,1755,1410
39103,103,39,2013,174672,693,103,796,1670,1412
39103,103,39,2014,175898,684,86,770,1819,1324
39103,103,39,2015,176185,-77,64,-13,1804,1492
39103,103,39,2016,177001,339,112,451,1797,1421
39103,103,39,2017,178339,1057,141,1198,1708,1553
39103,103,39,2018,179205,676,68,744,1742,1609
39103,103,39,2019,180121,672,134,806,1664,1548
39103,103,39,2020,180912,615,120,735,1664,1613
39105,105,39,2010,23732,-24,0,-24,63,72
39105,105,39,2011,23650,-84,-1,-85,260,257
39105,105,39,2012,23575,-66,-1,-67,252,259
39105,105,39,2013,23448,-106,2,-104,264,286
39105,105,39,2014,23285,-149,-1,-150,254,265
39105,105,39,2015,23192,-10,0,-10,214,294
39105,105,39,2016,23189,39,-2,37,247,286
39105,105,39,2017,23083,-34,-2,-36,241,310
39105,105,39,2018,23050,39,-2,37,260,328
39105,105,39,2019,22868,-91,-2,-93,206,296
39105,105,39,2020,22678,-100,-1,-101,201,290
39107,107,39,2010,40791,-55,1,-54,146,119
39107,107,39,2011,40720,-208,3,-205,517,383
39107,107,39,2012,40710,-115,12,-103,519,425
39107,107,39,2013,40623,-255,15,-240,564,414
39107,107,39,2014,40739,-53,15,-38,563,403
39107,107,39,2015,40735,-192,17,-175,575,404
39107,107,39,2016,40768,-177,22,-155,627,437
39107,107,39,2017,40889,-49,29,-20,575,432
39107,107,39,2018,40986,-190,16,-174,661,390
39107,107,39,2019,41255,-6,30,24,633,388
39107,107,39,2020,41274,-234,24,-210,637,408
39109,109,39,2010,102487,-111,17,-94,292,211
39109,109,39,2011,102742,64,58,122,1140,1004
39109,109,39,2012,102947,-7,71,64,1171,1010
39109,109,39,2013,103228,147,66,213,1097,1012
39109,109,39,2014,103876,400,94,494,1212,1036
39109,109,39,2015,104100,-31,96,65,1218,1044
39109,109,39,2016,104553,284,85,369,1193,1102
39109,109,39,2017,105215,550,71,621,1192,1144
39109,109,39,2018,106091,738,43,781,1218,1117
39109,109,39,2019,106995,847,60,907,1170,1169
39109,109,39,2020,107516,434,47,481,1192,1153
39111,111,39,2010,14609,-37,0,-37,37,23
39111,111,39,2011,14618,15,2,17,180,186
39111,111,39,2012,14509,-91,1,-90,140,159
39111,111,39,2013,14514,33,1,34,151,178
39111,111,39,2014,14368,-132,1,-131,154,171
39111,111,39,2015,14267,-79,-1,-80,165,186
39111,111,39,2016,14095,-127,0,-127,133,177
39111,111,39,2017,13946,-95,0,-95,116,170
39111,111,39,2018,13798,-81,0,-81,117,184
39111,111,39,2019,13708,-45,0,-45,136,179
39111,111,39,2020,13586,-54,0,-54,127,195
39113,113,39,2010,535620,-179,245,66,1718,1288
39113,113,39,2011,534638,-2695,847,-1848,6559,5687
39113,113,39,2012,534464,-2325,1034,-1291,6777,5623
39113,113,39,2013,534448,-2193,1366,-827,6710,5871
39113,113,39,2014,532708,-3592,1102,-2490,6627,5870
39113,113,39,2015,532059,-2461,1254,-1207,6647,6054
39113,113,39,2016,532274,-1635,1352,-283,6700,6175
39113,113,39,2017,531964,-1609,1105,-504,6650,6431
39113,113,39,2018,531954,-850,636,-214,6626,6397
39113,113,39,2019,532139,-965,1003,38,6431,6289
39113,113,39,2020,531610,-1270,791,-479,6367,6441
39115,115,39,2010,15033,-4,0,-4,49,54
39115,115,39,2011,15036,16,1,17,148,162
39115,115,39,2012,14929,-65,0,-65,137,177
39115,115,39,2013,14893,9,1,10,139,183
39115,115,39,2014,14731,-140,2,-138,135,161
39115,115,39,2015,14736,12,2,14,147,155
39115,115,39,2016,14746,26,2,28,162,180
39115,115,39,2017,14645,-42,2,-40,130,190
39115,115,39,2018,14585,-42,1,-41,160,180
39115,115,39,2019,14505,-41,2,-39,132,173
39115,115,39,2020,14305,-148,1,-147,125,177
39117,117,39,2010,34790,-33,1,-32,93,95
39117,117,39,2011,34813,-43,6,-37,368,308
39117,117,39,2012,34839,-91,6,-85,413,302
39117,117,39,2013,34851,-69,5,-64,394,316
39117,117,39,2014,34941,18,2,20,381,303
39117,117,39,2015,34954,-25,-2,-27,368,326
39117,117,39,2016,34928,-56,-4,-60,370,336
39117,117,39,2017,34928,-33,-3,-36,377,339
39117,117,39,2018,35133,141,-3,138,388,320
39117,117,39,2019,35342,162,-3,159,364,316
39117,117,39,2020,35411,47,-2,45,381,358
39119,119,39,2010,86213,44,7,51,280,192
39119,119,39,2011,86252,-151,36,-115,1064,907
39119,119,39,2012,85803,-568,42,-526,1015,943
39119,119,39,2013,85660,-236,79,-157,1025,1006
39119,119,39,2014,85918,120,71,191,1025,944
39119,119,39,2015,86213,173,94,267,1060,1020
39119,119,39,2016,85958,-307,55,-252,1000,1000
39119,119,39,2017,86099,102,39,141,1014,1007
39119,119,39,2018,86048,-63,26,-37,1040,1052
39119,119,39,2019,86042,-34,35,1,993,1000
39119,119,39,2020,86020,-2,25,23,970,1019
39121,121,39,2010,14660,-14,0,-14,38,18
39121,121,39,2011,14754,52,2,54,145,105
39121,121,39,2012,14676,-108,6,-102,157,133
39121,121,39,2013,14678,-4,2,-2,140,133
39121,121,39,2014,14532,-150,0,-150,134,132
39121,121,39,2015,14468,-72,-1,-73,145,134
39121,121,39,2016,14459,-15,1,-14,146,139
39121,121,39,2017,14406,-34,2,-32,121,141
39121,121,39,2018,14368,-47,1,-46,147,140
39121,121,39,2019,14451,81,2,83,140,139
39121,121,39,2020,14364,-72,2,-70,145,161
39123,123,39,2010,41359,-5,3,-2,75,142
39123,123,39,2011,41323,47,5,52,361,447
39123,123,39,2012,41246,4,7,11,364,446
39123,123,39,2013,41041,-12,2,-10,325,517
39123,123,39,2014,40906,20,-1,19,316,461
39123,123,39,2015,40761,-42,-1,-43,361,458
39123,123,39,2016,40531,-126,4,-122,367,473
39123,123,39,2017,40652,337,8,345,307,528
39123,123,39,2018,40819,332,8,340,346,517
39123,123,39,2019,40532,-85,4,-81,312,519
39123,123,39,2020,40253,-52,2,-50,318,545
39125,125,39,2010,19558,-46,2,-44,60,68
39125,125,39,2011,19369,-238,4,-234,234,190
39125,125,39,2012,19245,-150,5,-145,218,199
39125,125,39,2013,19138,-113,8,-105,200,204
39125,125,39,2014,18970,-264,5,-259,243,157
39125,125,39,2015,18953,-45,11,-34,212,193
39125,125,39,2016,18827,-129,4,-125,211,213
39125,125,39,2017,18816,-27,4,-23,216,203
39125,125,39,2018,18747,-100,0,-100,226,195
39125,125,39,2019,18672,-68,5,-63,213,224
39125,125,39,2020,18648,-22,4,-18,219,224
39127,127,39,2010,36037,-5,1,-4,109,102
39127,127,39,2011,36229,58,2,60,453,319
39127,127,39,2012,35983,-298,2,-296,403,357
39127,127,39,2013,36000,-107,7,-100,426,308
39127,127,39,2014,35926,-146,14,-132,429,370
39127,127,39,2015,35970,-27,6,-21,438,370
39127,127,39,2016,36015,-76,13,-63,444,335
39127,127,39,2017,35975,-96,14,-82,404,361
39127,127,39,2018,36046,-2,9,7,444,379
39127,127,39,2019,36127,42,11,53,385,356
39127,127,39,2020,36215,78,9,87,413,413
39129,129,39,2010,55737,-20,2,-18,172,98
39129,129,39,2011,55946,112,5,117,573,481
39129,129,39,2012,56235,200,14,214,586,504
39129,129,39,2013,56352,49,9,58,618,550
39129,129,39,2014,56703,221,12,233,594,470
39129,129,39,2015,56991,145,13,158,662,528
39129,129,39,2016,57513,526,27,553,566,598
39129,129,39,2017,57769,246,20,266,635,640
39129,129,39,2018,58099,385,12,397,583,649
39129,129,39,2019,58521,381,15,396,619,591
39129,129,39,2020,58658,163,14,177,602,643
39131,131,39,2010,28606,2,1,3,87,48
39131,131,39,2011,28471,-148,1,-147,351,340
39131,131,39,2012,28365,-102,6,-96,324,332
39131,131,39,2013,28266,-122,8,-114,363,346
39131,131,39,2014,28176,-132,1,-131,353,312
39131,131,39,2015,28115,-83,-1,-84,347,322
39131,131,39,2016,28101,-5,-1,-6,351,357
39131,131,39,2017,28084,14,-1,13,338,366
39131,131,39,2018,27908,-113,-1,-114,350,413
39131,131,39,2019,27784,-97,-1,-98,342,368
39131,131,39,2020,27695,-38,-1,-39,345,396
39133,133,39,2010,161397,-156,56,-100,410,337
39133,133,39,2011,161894,-17,312,295,1499,1294
39133,133,39,2012,161418,-856,359,-497,1382,1363
39133,133,39,2013,161746,-320,615,295,1422,1377
39133,133,39,2014,162520,101,575,676,1505,1374
39133,133,39,2015,162667,-521,663,142,1476,1464
39133,133,39,2016,162564,-620,565,-55,1431,1477
39133,133,39,2017,162441,-426,437,11,1388,1520
39133,133,39,2018,162367,-181,271,90,1383,1546
39133,133,39,2019,162426,-192,394,202,1343,1489
39133,133,39,2020,162583,61,313,374,1348,1571
39135,135,39,2010,42172,-58,6,-52,89,117
39135,135,39,2011,41989,-191,9,-182,455,456
39135,135,39,2012,41821,-166,26,-140,451,477
39135,135,39,2013,41685,-169,24,-145,441,432
39135,135,39,2014,41509,-164,21,-143,440,473
39135,135,39,2015,41313,-225,34,-191,445,449
39135,135,39,2016,41148,-125,31,-94,409,479
39135,135,39,2017,41119,24,24,48,449,523
39135,135,39,2018,41023,-74,19,-55,425,466
39135,135,39,2019,40848,-143,20,-123,455,506
39135,135,39,2020,40836,45,15,60,426,500
39137,137,39,2010,34476,-89,4,-85,119,59
39137,137,39,2011,34386,-272,16,-256,474,308
39137,137,39,2012,34207,-353,16,-337,432,281
39137,137,39,2013,34122,-214,14,-200,438,327
39137,137,39,2014,34194,-116,7,-109,470,291
39137,137,39,2015,34020,-341,8,-333,455,299
39137,137,39,2016,34004,-160,15,-145,424,294
39137,137,39,2017,33870,-275,21,-254,435,318
39137,137,39,2018,33809,-177,17,-160,430,331
39137,137,39,2019,33843,-97,21,-76,422,312
39137,137,39,2020,33654,-278,15,-263,424,350
39139,139,39,2010,124156,-305,3,-302,309,330
39139,139,39,2011,123151,-1097,26,-1071,1415,1351
39139,139,39,2012,122645,-627,26,-601,1412,1322
39139,139,39,2013,122339,-357,42,-315,1410,1393
39139,139,39,2014,122030,-449,46,-403,1420,1316
39139,139,39,2015,121720,-282,45,-237,1401,1462
39139,139,39,2016,121324,-502,56,-446,1426,1370
39139,139,39,2017,120500,-619,39,-580,1285,1530
39139,139,39,2018,121117,714,24,738,1361,1480
39139,139,39,2019,121384,324,30,354,1390,1476
39139,139,39,2020,120891,-412,28,-384,1385,1494
39141,141,39,2010,78102,13,7,20,183,170
39141,141,39,2011,77594,-480,29,-451,778,838
39141,141,39,2012,77359,-353,24,-329,909,814
39141,141,39,2013,77299,-64,28,-36,806,821
39141,141,39,2014,77116,-350,20,-330,904,750
39141,141,39,2015,77067,-12,22,10,809,860
39141,141,39,2016,76888,-159,11,-148,869,897
39141,141,39,2017,77299,374,5,379,855,824
39141,141,39,2018,76859,-406,2,-404,830,867
39141,141,39,2019,76613,-189,3,-186,828,889
39141,141,39,2020,76420,-77,3,-74,808,929
39143,143,39,2010,60886,-94,6,-88,162,135
39143,143,39,2011,60609,-369,17,-352,703,627
39143,143,39,2012,60467,-259,13,-246,711,609
39143,143,39,2013,60052,-446,4,-442,675,652
39143,143,39,2014,59830,-208,0,-208,623,634
39143,143,39,2015,59476,-380,15,-365,677,665
39143,143,39,2016,59311,-217,12,-205,689,647
39143,143,39,2017,59097,-154,21,-133,639,718
39143,143,39,2018,58726,-312,2,-310,633,694
39143,143,39,2019,58520,-188,19,-169,634,670
39143,143,39,2020,58351,-145,17,-128,625,668
39145,145,39,2010,79672,20,9,29,216,221
39145,145,39,2011,79425,-240,29,-211,873,906
39145,145,39,2012,78808,-619,32,-587,902,937
39145,145,39,2013,78333,-494,53,-441,915,953
39145,145,39,2014,77509,-800,34,-766,925,997
39145,145,39,2015,77024,-380,32,-348,873,1006
39145,145,39,2016,76451,-503,21,-482,864,955
39145,145,39,2017,76018,-278,15,-263,887,1055
39145,145,39,2018,75338,-461,10,-451,848,1078
39145,145,39,2019,75051,-79,12,-67,810,1031
39145,145,39,2020,74347,-462,10,-452,784,1037
39147,147,39,2010,56619,-122,10,-112,140,156
39147,147,39,2011,56526,-171,42,-129,601,565
39147,147,39,2012,56117,-418,49,-369,582,623
39147,147,39,2013,55860,-289,53,-236,582,605
39147,147,39,2014,55819,-70,53,-17,557,573
39147,147,39,2015,55672,-264,84,-180,599,566
39147,147,39,2016,55517,-281,86,-195,611,571
39147,147,39,2017,55322,-182,68,-114,568,647
39147,147,39,2018,55256,-99,47,-52,611,624
39147,147,39,2019,55220,-61,52,-9,573,601
39147,147,39,2020,54938,-296,42,-254,584,611
39149,149,39,2010,49347,-146,8,-138,135,113
39149,149,39,2011,49256,-327,45,-282,625,435
39149,149,39,2012,49158,-394,56,-338,629,397
39149,149,39,2013,49202,-262,105,-157,642,439
39149,149,39,2014,49001,-413,67,-346,564,425
39149,149,39,2015,49036,-264,81,-183,645,427
39149,149,39,2016,48760,-479,64,-415,600,461
39149,149,39,2017,48731,-204,50,-154,623,498
39149,149,39,2018,48632,-260,28,-232,613,480
39149,149,39,2019,48592,-224,46,-178,614,476
39149,149,39,2020,48337,-414,36,-378,610,487
39151,151,39,2010,375348,-326,54,-272,1060,973
39151,151,39,2011,374512,-934,138,-796,4075,4103
39151,151,39,2012,374914,178,176,354,4080,3950
39151,151,39,2013,375152,213,227,440,4044,4174
39151,151,39,2014,375608,40,105,145,4323,3934
39151,151,39,2015,374798,-979,184,-795,4235,4216
39151,151,39,2016,373553,-1463,156,-1307,4224,4153
39151,151,39,2017,372120,-1225,126,-1099,4111,4435
39151,151,39,2018,371410,-302,40,-262,4083,4519
39151,151,39,2019,370723,-553,112,-441,4033,4281
39151,151,39,2020,369772,-649,97,-552,4040,4443
39153,153,39,2010,541659,-572,174,-398,1570,1271
39153,153,39,2011,541368,-1846,860,-986,6068,5362
39153,153,39,2012,540806,-1881,899,-982,6115,5644
39153,153,39,2013,542032,-457,1247,790,6122,5611
39153,153,39,2014,542572,-1197,1099,-98,6200,5474
39153,153,39,2015,541940,-1977,1298,-679,6089,6001
39153,153,39,2016,541226,-2253,1263,-990,6112,5820
39153,153,39,2017,541695,-458,1042,584,5919,6007
39153,153,39,2018,541451,-986,734,-252,5961,5943
39153,153,39,2019,540814,-1435,826,-609,5849,5891
39153,153,39,2020,538866,-2188,721,-1467,5804,6298
39155,155,39,2010,209838,-346,6,-340,497,646
39155,155,39,2011,208866,-655,10,-645,2117,2441
39155,155,39,2012,207245,-1150,25,-1125,2051,2549
39155,155,39,2013,206405,-450,24,-426,2152,2540
39155,155,39,2014,205071,-997,19,-978,2085,2425
39155,155,39,2015,203442,-1142,23,-1119,2103,2612
39155,155,39,2016,201854,-1194,29,-1165,2104,2523
39155,155,39,2017,200424,-846,27,-819,2112,2718
39155,155,39,2018,198574,-1264,13,-1251,2082,2683
39155,155,39,2019,198069,-51,18,-33,2078,2549
39155,155,39,2020,196800,-720,17,-703,2078,2644
39157,157,39,2010,92545,-65,12,-53,279,263
39157,157,39,2011,92491,-270,85,-185,1079,945
39157,157,39,2012,92426,-268,61,-207,1128,977
39157,157,39,2013,92625,45,71,116,1129,1030
39157,157,39,2014,92682,-85,81,-4,1085,1013
39157,157,39,2015,92782,-156,91,-65,1191,1017
39157,157,39,2016,92602,-391,109,-282,1177,1072
39157,157,39,2017,92377,-383,84,-299,1156,1081
39157,157,39,2018,92075,-426,86,-340,1203,1164
39157,157,39,2019,91993,-165,48,-117,1125,1091
39157,157,39,2020,91776,-279,53,-226,1125,1118
39159,159,39,2010,52462,19,5,24,161,54
39159,159,39,2011,53101,332,35,367,599,327
39159,159,39,2012,52798,-665,52,-613,600,319
39159,159,39,2013,53440,302,91,393,606,353
39159,159,39,2014,53782,24,89,113,594,354
39159,159,39,2015,54394,240,94,334,659,376
39159,159,39,2016,55601,814,112,926,653,375
39159,159,39,2017,56842,872,79,951,670,379
39159,159,39,2018,57836,674,47,721,686,409
39159,159,39,2019,59054,860,68,928,707,416
39159,159,39,2020,60021,623,46,669,714,416
39161,161,39,2010,28679,-68,2,-66,74,90
39161,161,39,2011,28628,-107,8,-99,312,264
39161,161,39,2012,28642,-22,10,-12,318,291
39161,161,39,2013,28357,-294,6,-288,330,329
39161,161,39,2014,28343,-29,8,-21,349,339
39161,161,39,2015,28330,3,3,6,315,331
39161,161,39,2016,28210,-146,15,-131,361,350
39161,161,39,2017,28290,33,14,47,363,327
39161,161,39,2018,28176,-118,17,-101,327,340
39161,161,39,2019,28231,-16,3,-13,351,282
39161,161,39,2020,28159,-104,8,-96,340,315
39163,163,39,2010,13405,-20,0,-20,40,44
39163,163,39,2011,13380,-36,-1,-37,140,128
39163,163,39,2012,13223,-165,0,-165,130,124
39163,163,39,2013,13305,80,0,80,154,152
39163,163,39,2014,13210,-92,0,-92,152,157
39163,163,39,2015,13083,-143,0,-143,149,134
39163,163,39,2016,13015,-64,0,-64,146,149
39163,163,39,2017,13080,75,0,75,141,150
39163,163,39,2018,13132,54,0,54,153,155
39163,163,39,2019,13028,-90,0,-90,134,148
39163,163,39,2020,12972,3,0,3,125,184
39165,165,39,2010,213445,286,74,360,649,357
39165,165,39,2011,215377,524,319,843,2485,1388
39165,165,39,2012,217293,636,412,1048,2407,1494
39165,165,39,2013,219298,551,596,1147,2455,1567
39165,165,39,2014,221429,900,499,1399,2357,1580
39165,165,39,2015,224018,1382,539,1921,2344,1654
39165,165,39,2016,226858,1413,648,2061,2435,1646
39165,165,39,2017,229292,1448,547,1995,2306,1846
39165,165,39,2018,232539,2378,353,2731,2407,1879
39165,165,39,2019,235601,2075,450,2525,2360,1819
39165,165,39,2020,238412,2106,365,2471,2360,2019
39167,167,39,2010,61714,-71,4,-67,147,149
39167,167,39,2011,61617,10,6,16,623,733
39167,167,39,2012,61472,-46,11,-35,616,717
39167,167,39,2013,61401,-23,28,5,645,711
39167,167,39,2014,61204,-146,29,-117,613,686
39167,167,39,2015,61075,21,47,68,574,764
39167,167,39,2016,60673,-290,44,-246,610,762
39167,167,39,2017,60557,12,35,47,616,775
39167,167,39,2018,60183,-211,20,-191,587,770
39167,167,39,2019,60018,-45,32,-13,593,741
39167,167,39,2020,59652,-206,27,-179,592,782
39169,169,39,2010,114409,-163,9,-154,326,294
39169,169,39,2011,114670,-244,91,-153,1458,1038
39169,169,39,2012,115058,-259,118,-141,1559,1021
39169,169,39,2013,115438,-257,168,-89,1571,1092
39169,169,39,2014,115957,-119,118,-1,1553,1017
39169,169,39,2015,116262,-282,122,-160,1592,1117
39169,169,39,2016,116657,-164,118,-46,1543,1098
39169,169,39,2017,116227,-901,82,-819,1549,1165
39169,169,39,2018,115911,-648,46,-602,1485,1198
39169,169,39,2019,115824,-416,77,-339,1459,1210
39169,169,39,2020,115694,-365,54,-311,1428,1249
39171,171,39,2010,37510,-124,2,-122,101,126
39171,171,39,2011,37587,-28,1,-27,448,343
39171,171,39,2012,37531,-146,0,-146,445,356
39171,171,39,2013,37446,-127,-1,-128,428,385
39171,171,39,2014,37222,-246,2,-244,431,410
39171,171,39,2015,37036,-199,-1,-200,415,401
39171,171,39,2016,36964,-109,-3,-112,429,389
39171,171,39,2017,36754,-163,13,-150,412,469
39171,171,39,2018,36753,51,9,60,405,466
39171,171,39,2019,36765,-33,11,-22,433,399
39171,171,39,2020,36565,-219,12,-207,419,410
39173,173,39,2010,125956,293,40,333,319,207
39173,173,39,2011,127150,762,152,914,1298,1018
39173,173,39,2012,128471,732,182,914,1375,972
39173,173,39,2013,129073,4,240,244,1364,995
39173,173,39,2014,129410,-217,219,2,1409,1069
39173,173,39,2015,129375,-505,214,-291,1387,1132
39173,173,39,2016,129888,76,230,306,1373,1161
39173,173,39,2017,130593,302,187,489,1374,1153
39173,173,39,2018,130627,-225,114,-111,1344,1200
39173,173,39,2019,131089,203,154,357,1266,1162
39173,173,39,2020,131113,-197,133,-64,1265,1182
39175,175,39,2010,22587,-23,0,-23,66,71
39175,175,39,2011,22643,25,-1,24,242,209
39175,175,39,2012,22544,-136,-4,-140,263,223
39175,175,39,2013,22463,-142,2,-140,302,244
39175,175,39,2014,22287,-184,15,-169,238,247
39175,175,39,2015,22181,-101,11,-90,251,266
39175,175,39,2016,22070,-118,8,-110,246,246
39175,175,39,2017,22057,-10,8,-2,253,263
39175,175,39,2018,21901,-129,12,-117,219,258
39175,175,39,2019,21796,-77,-2,-79,227,253
39175,175,39,2020,21711,-47,2,-45,223,263
40001,001,40,2010,22760,19,0,19,100,28
40001,001,40,2011,22668,-214,0,-214,346,225
40001,001,40,2012,22466,-291,4,-287,334,255
40001,001,40,2013,22463,-131,2,-129,351,225
40001,001,40,2014,22392,-153,4,-149,318,241
40001,001,40,2015,22266,-183,9,-174,315,266
40001,001,40,2016,22301,-23,4,-19,309,253
40001,001,40,2017,22122,-242,1,-241,343,280
40001,001,40,2018,22251,76,2,78,320,269
40001,001,40,2019,22224,-54,2,-52,299,274
40001,001,40,2020,21955,-276,1,-275,298,291
40003,003,40,2010,5627,5,-1,4,14,28
40003,003,40,2011,5645,43,-1,42,50,75
40003,003,40,2012,5665,30,-1,29,58,68
40003,003,40,2013,5852,201,-2,199,65,81
40003,003,40,2014,5817,-20,0,-20,59,74
40003,003,40,2015,5912,73,9,82,68,55
40003,003,40,2016,5926,-11,12,1,63,49
40003,003,40,2017,5905,-23,9,-14,49,56
40003,003,40,2018,5742,-160,8,-152,56,67
40003,003,40,2019,5664,-80,8,-72,46,52
40003,003,40,2020,5718,56,5,61,49,55
40005,005,40,2010,14214,20,2,22,48,22
40005,005,40,2011,14171,-82,12,-70,173,147
40005,005,40,2012,14031,-171,4,-167,162,137
40005,005,40,2013,13903,-114,8,-106,150,174
40005,005,40,2014,13924,0,6,6,163,145
40005,005,40,2015,13888,-27,14,-13,170,192
40005,005,40,2016,13882,35,0,35,149,189
40005,005,40,2017,13771,-81,0,-81,154,183
40005,005,40,2018,13771,-8,0,-8,168,160
40005,005,40,2019,13738,-47,-1,-48,159,144
40005,005,40,2020,13912,162,-1,161,154,139
40007,007,40,2010,5631,9,0,9,9,23
40007,007,40,2011,5635,-27,-1,-28,78,45
40007,007,40,2012,5592,-53,2,-51,56,50
40007,007,40,2013,5566,-55,2,-53,71,46
40007,007,40,2014,5535,-65,11,-54,68,47
40007,007,40,2015,5460,-93,12,-81,57,52
40007,007,40,2016,5437,-42,17,-25,54,52
40007,007,40,2017,5363,-91,11,-80,59,54
40007,007,40,2018,5313,-49,11,-38,52,64
40007,007,40,2019,5308,-20,9,-11,50,44
40007,007,40,2020,5207,-104,8,-96,49,54
40009,009,40,2010,22056,-132,4,-128,95,36
40009,009,40,2011,22311,125,3,128,347,220
40009,009,40,2012,23078,645,-3,642,348,248
40009,009,40,2013,23482,258,-3,255,392,248
40009,009,40,2014,23611,-21,7,-14,396,248
40009,009,40,2015,23564,-154,8,-146,342,243
40009,009,40,2016,22467,-1240,8,-1232,359,231
40009,009,40,2017,21793,-693,-3,-696,284,264
40009,009,40,2018,21738,-122,-2,-124,310,241
40009,009,40,2019,21834,63,-4,59,283,244
40009,009,40,2020,21468,-375,-3,-378,295,280
40011,011,40,2010,9911,-2337,5,-2332,41,14
40011,011,40,2011,9689,-256,21,-235,138,125
40011,011,40,2012,9811,96,19,115,132,125
40011,011,40,2013,9792,-68,5,-63,173,128
40011,011,40,2014,9845,21,7,28,162,134
40011,011,40,2015,9772,-120,17,-103,164,137
40011,011,40,2016,9649,-213,62,-151,137,108
40011,011,40,2017,9560,-112,43,-69,126,147
40011,011,40,2018,9490,-66,26,-40,110,141
40011,011,40,2019,9457,-82,22,-60,138,109
40011,011,40,2020,9447,-45,20,-25,129,114
40013,013,40,2010,42579,102,4,106,134,84
40013,013,40,2011,43128,404,20,424,593,469
40013,013,40,2012,43471,117,40,157,638,445
40013,013,40,2013,44149,593,8,601,569,503
40013,013,40,2014,44525,274,31,305,597,524
40013,013,40,2015,45080,435,48,483,569,498
40013,013,40,2016,45679,475,48,523,595,518
40013,013,40,2017,46571,780,27,807,604,522
40013,013,40,2018,47290,664,27,691,590,562
40013,013,40,2019,48089,727,17,744,588,535
40013,013,40,2020,48998,900,17,917,597,601
40015,015,40,2010,29711,34,0,34,116,43
40015,015,40,2011,29614,-201,-3,-204,460,353
40015,015,40,2012,29741,86,15,101,396,362
40015,015,40,2013,29590,-213,16,-197,402,357
40015,015,40,2014,29448,-206,26,-180,402,362
40015,015,40,2015,29439,-94,58,-36,380,354
40015,015,40,2016,29696,71,126,197,429,368
40015,015,40,2017,29420,-409,82,-327,425,374
40015,015,40,2018,29166,-302,65,-237,370,388
40015,015,40,2019,28927,-297,50,-247,392,384
40015,015,40,2020,28684,-265,41,-224,368,386
40017,017,40,2010,116360,524,19,543,382,164
40017,017,40,2011,119414,2233,94,2327,1571,857
40017,017,40,2012,122526,2236,64,2300,1592,842
40017,017,40,2013,125992,2517,91,2608,1720,918
40017,017,40,2014,129384,2453,82,2535,1687,889
40017,017,40,2015,133241,2892,144,3036,1731,944
40017,017,40,2016,136508,2314,141,2455,1778,971
40017,017,40,2017,140146,2751,90,2841,1750,966
40017,017,40,2018,144570,3632,100,3732,1799,1110
40017,017,40,2019,148635,3229,52,3281,1908,1118
40017,017,40,2020,153192,3855,60,3915,1891,1228
40019,019,40,2010,47810,29,14,43,155,111
40019,019,40,2011,48067,236,33,269,619,632
40019,019,40,2012,48028,-81,17,-64,624,589
40019,019,40,2013,48474,405,15,420,664,642
40019,019,40,2014,48600,47,25,72,691,625
40019,019,40,2015,48587,-138,45,-93,717,631
40019,019,40,2016,48501,-250,59,-191,709,602
40019,019,40,2017,48373,-223,56,-167,630,592
40019,019,40,2018,48345,-114,65,-49,639,616
40019,019,40,2019,48328,-114,41,-73,656,601
40019,019,40,2020,48353,35,33,68,654,700
40021,021,40,2010,47126,89,4,93,150,110
40021,021,40,2011,47707,395,13,408,633,459
40021,021,40,2012,47997,83,18,101,646,454
40021,021,40,2013,47880,-183,18,-165,594,545
40021,021,40,2014,48253,214,48,262,612,496
40021,021,40,2015,48392,83,76,159,526,540
40021,021,40,2016,48868,233,83,316,638,476
40021,021,40,2017,48956,-21,63,42,551,504
40021,021,40,2018,48692,-315,66,-249,546,558
40021,021,40,2019,48819,-20,50,30,612,517
40021,021,40,2020,49019,124,35,159,581,543
40023,023,40,2010,15234,16,1,17,56,38
40023,023,40,2011,15280,24,3,27,216,195
40023,023,40,2012,15177,-80,3,-77,190,216
40023,023,40,2013,15053,-114,2,-112,209,222
40023,023,40,2014,15114,127,0,127,166,232
40023,023,40,2015,14987,-97,0,-97,206,234
40023,023,40,2016,14874,-70,0,-70,205,246
40023,023,40,2017,14807,-52,0,-52,210,224
40023,023,40,2018,14666,-142,0,-142,209,209
40023,023,40,2019,14642,-31,0,-31,197,190
40023,023,40,2020,14646,45,0,45,197,238
40025,025,40,2010,2472,-13,1,-12,13,5
40025,025,40,2011,2477,1,2,3,40,38
40025,025,40,2012,2398,-79,0,-79,25,26
40025,025,40,2013,2327,-64,0,-64,35,44
40025,025,40,2014,2294,-31,1,-30,26,29
40025,025,40,2015,2225,-73,2,-71,34,34
40025,025,40,2016,2181,-26,2,-24,17,37
40025,025,40,2017,2155,-21,2,-19,26,32
40025,025,40,2018,2165,-1,2,1,30,21
40025,025,40,2019,2148,-33,2,-31,25,11
40025,025,40,2020,2145,-15,1,-14,28,17
40027,027,40,2010,257094,577,121,698,766,391
40027,027,40,2011,262098,3100,678,3778,3003,1797
40027,027,40,2012,266224,2197,669,2866,3015,1778
40027,027,40,2013,269966,1836,670,2506,3123,1905
40027,027,40,2014,269874,-1889,668,-1221,2984,1864
40027,027,40,2015,274041,2257,893,3150,2933,1921
40027,027,40,2016,278062,2502,491,2993,3004,1978
40027,027,40,2017,279723,424,265,689,2912,1926
40027,027,40,2018,281559,730,330,1060,2840,2056
40027,027,40,2019,284537,2138,224,2362,2784,2171
40027,027,40,2020,287066,1875,188,2063,2800,2346
40029,029,40,2010,5911,-12,0,-12,13,18
40029,029,40,2011,5926,40,1,41,67,93
40029,029,40,2012,5899,-18,0,-18,60,69
40029,029,40,2013,5756,-147,0,-147,65,64
40029,029,40,2014,5722,-14,0,-14,62,81
40029,029,40,2015,5600,-102,0,-102,67,89
40029,029,40,2016,5643,59,1,60,78,94
40029,029,40,2017,5623,-4,1,-3,75,93
40029,029,40,2018,5519,-88,1,-87,69,85
40029,029,40,2019,5511,-23,1,-22,78,64
40029,029,40,2020,5587,84,0,84,75,83
40031,031,40,2010,125401,762,166,928,488,180
40031,031,40,2011,126115,-897,406,-491,2140,936
40031,031,40,2012,126428,-1618,898,-720,1973,967
40031,031,40,2013,124648,-3322,462,-2860,1992,1000
40031,031,40,2014,124622,-1201,303,-898,1873,999
40031,031,40,2015,123689,-2358,503,-1855,1914,1021
40031,031,40,2016,121554,-3052,210,-2842,1785,1093
40031,031,40,2017,121994,-327,110,-217,1734,1070
40031,031,40,2018,121001,-1709,49,-1660,1725,1061
40031,031,40,2019,121224,-382,57,-325,1661,1118
40031,031,40,2020,121099,-650,67,-583,1643,1189
40033,033,40,2010,6167,3,0,3,13,34
40033,033,40,2011,6179,4,3,7,71,67
40033,033,40,2012,6158,-17,5,-12,79,86
40033,033,40,2013,6164,-1,0,-1,72,65
40033,033,40,2014,6133,-24,-1,-25,75,80
40033,033,40,2015,6008,-103,0,-103,66,90
40033,033,40,2016,5924,-49,0,-49,46,81
40033,033,40,2017,5866,-53,0,-53,75,80
40033,033,40,2018,5798,-53,0,-53,63,79
40033,033,40,2019,5650,-134,0,-134,57,70
40033,033,40,2020,5676,75,0,75,51,98
40035,035,40,2010,15057,27,1,28,47,38
40035,035,40,2011,14983,-26,4,-22,175,226
40035,035,40,2012,14762,-180,4,-176,161,213
40035,035,40,2013,14696,-25,5,-20,160,204
40035,035,40,2014,14634,-68,5,-63,181,179
40035,035,40,2015,14706,119,4,123,161,213
40035,035,40,2016,14467,-188,5,-183,161,217
40035,035,40,2017,14328,-63,1,-62,141,218
40035,035,40,2018,14273,33,2,35,131,221
40035,035,40,2019,14110,-101,1,-100,146,208
40035,035,40,2020,14194,175,0,175,141,231
40037,037,40,2010,70243,185,1,186,220,156
40037,037,40,2011,70649,281,23,304,884,779
40037,037,40,2012,70761,51,37,88,839,799
40037,037,40,2013,70576,-238,37,-201,862,841
40037,037,40,2014,70559,-101,54,-47,868,830
40037,037,40,2015,70798,181,87,268,878,898
40037,037,40,2016,71161,324,47,371,876,878
40037,037,40,2017,71822,675,27,702,858,897
40037,037,40,2018,71693,-141,26,-115,823,836
40037,037,40,2019,71362,-199,19,-180,769,920
40037,037,40,2020,71485,312,19,331,776,985
40039,039,40,2010,27583,-11,8,-3,103,56
40039,039,40,2011,27800,28,39,67,452,301
40039,039,40,2012,28593,536,35,571,472,268
40039,039,40,2013,29318,521,26,547,457,291
40039,039,40,2014,29517,-68,67,-1,490,287
40039,039,40,2015,29568,-147,84,-63,442,327
40039,039,40,2016,29224,-593,103,-490,440,297
40039,039,40,2017,28928,-459,27,-432,429,295
40039,039,40,2018,28930,-107,24,-83,403,319
40039,039,40,2019,28913,-129,12,-117,388,289
40039,039,40,2020,28648,-377,8,-369,394,289
40041,041,40,2010,41564,80,6,86,112,135
40041,041,40,2011,41664,163,41,204,401,501
40041,041,40,2012,41733,167,17,184,425,537
40041,041,40,2013,41717,86,17,103,440,555
40041,041,40,2014,41792,171,14,185,396,499
40041,041,40,2015,41738,91,11,102,416,569
40041,041,40,2016,41967,354,7,361,410,540
40041,041,40,2017,42692,814,1,815,467,561
40041,041,40,2018,42897,357,1,358,450,602
40041,041,40,2019,43011,330,-2,328,401,615
40041,041,40,2020,43136,351,0,351,410,635
40043,043,40,2010,4809,8,0,8,15,23
40043,043,40,2011,4785,-15,2,-13,54,65
40043,043,40,2012,4815,32,1,33,65,68
40043,043,40,2013,4855,40,5,45,62,66
40043,043,40,2014,4965,97,11,108,69,67
40043,043,40,2015,4986,28,14,42,55,76
40043,043,40,2016,4895,-98,14,-84,66,74
40043,043,40,2017,4891,-9,15,6,56,65
40043,043,40,2018,4930,28,12,40,68,68
40043,043,40,2019,4896,-35,10,-25,52,60
40043,043,40,2020,4815,-63,6,-57,55,79
40045,045,40,2010,4158,0,2,2,11,7
40045,045,40,2011,4041,-96,1,-95,38,60
40045,045,40,2012,4080,48,2,50,40,50
40045,045,40,2013,4133,48,4,52,44,45
40045,045,40,2014,4117,0,4,4,42,63
40045,045,40,2015,4218,115,10,125,41,65
40045,045,40,2016,4083,-139,2,-137,54,53
40045,045,40,2017,3961,-111,5,-106,43,60
40045,045,40,2018,3942,3,6,9,43,69
40045,045,40,2019,3865,-82,5,-77,48,48
40045,045,40,2020,3830,-36,3,-33,47,50
40047,047,40,2010,60771,41,53,94,246,146
40047,047,40,2011,60768,-517,288,-229,933,709
40047,047,40,2012,61365,68,265,333,919,641
40047,047,40,2013,62368,611,157,768,946,716
40047,047,40,2014,62801,22,121,143,995,697
40047,047,40,2015,63246,-26,136,110,1031,688
40047,047,40,2016,62585,-1207,281,-926,974,711
40047,047,40,2017,61720,-1265,219,-1046,908,730
40047,047,40,2018,61270,-871,224,-647,888,694
40047,047,40,2019,61332,-312,175,-137,829,630
40047,047,40,2020,60869,-744,142,-602,818,676
40049,049,40,2010,27576,-20,5,-15,111,88
40049,049,40,2011,27463,-34,9,-25,342,428
40049,049,40,2012,27342,-122,28,-94,376,404
40049,049,40,2013,27426,53,38,91,372,379
40049,049,40,2014,27613,144,40,184,366,361
40049,049,40,2015,27913,183,55,238,407,343
40049,049,40,2016,27944,-57,55,-2,368,333
40049,049,40,2017,27875,-116,47,-69,347,346
40049,049,40,2018,27747,-137,39,-98,356,386
40049,049,40,2019,27687,-36,31,-5,313,369
40049,049,40,2020,27691,13,25,38,327,360
40051,051,40,2010,52434,17,9,26,146,155
40051,051,40,2011,52746,178,53,231,612,529
40051,051,40,2012,53025,178,53,231,596,538
40051,051,40,2013,53638,435,70,505,634,530
40051,051,40,2014,53883,187,47,234,584,563
40051,051,40,2015,54563,539,36,575,621,516
40051,051,40,2016,54677,36,26,62,600,544
40051,051,40,2017,54819,77,23,100,612,566
40051,051,40,2018,55411,595,19,614,556,576
40051,051,40,2019,55764,310,16,326,574,546
40051,051,40,2020,55906,158,12,170,550,581
40053,053,40,2010,4536,18,0,18,10,24
40053,053,40,2011,4562,34,1,35,53,62
40053,053,40,2012,4532,-23,0,-23,48,56
40053,053,40,2013,4517,6,0,6,58,78
40053,053,40,2014,4469,-36,0,-36,48,62
40053,053,40,2015,4497,24,0,24,62,57
40053,053,40,2016,4454,-38,0,-38,55,60
40053,053,40,2017,4376,-56,0,-56,43,64
40053,053,40,2018,4315,-51,1,-50,52,63
40053,053,40,2019,4328,7,1,8,51,46
40053,053,40,2020,4372,40,0,40,51,47
40055,055,40,2010,6211,-20,0,-20,23,31
40055,055,40,2011,6144,-46,-2,-48,57,76
40055,055,40,2012,6054,-66,-2,-68,53,78
40055,055,40,2013,6139,85,0,85,80,81
40055,055,40,2014,6121,-19,-1,-20,79,75
40055,055,40,2015,6031,-71,-2,-73,71,89
40055,055,40,2016,5958,-76,-2,-78,71,66
40055,055,40,2017,5794,-139,-1,-140,59,83
40055,055,40,2018,5797,40,-2,38,46,81
40055,055,40,2019,5698,-90,-2,-92,47,53
40055,055,40,2020,5704,18,-1,17,49,60
40057,057,40,2010,2922,10,0,10,12,23
40057,057,40,2011,2936,2,3,5,41,30
40057,057,40,2012,2916,-46,5,-41,38,19
40057,057,40,2013,2894,-36,6,-30,43,36
40057,057,40,2014,2804,-91,4,-87,35,40
40057,057,40,2015,2782,-37,7,-30,30,22
40057,057,40,2016,2712,-72,5,-67,29,32
40057,057,40,2017,2715,-4,2,-2,33,28
40057,057,40,2018,2688,-23,2,-21,38,44
40057,057,40,2019,2645,-39,2,-37,23,28
40057,057,40,2020,2557,-84,2,-82,25,31
40059,059,40,2010,3695,-4,1,-3,19,2
40059,059,40,2011,3713,-8,18,10,44,36
40059,059,40,2012,3711,-25,27,2,45,49
40059,059,40,2013,3869,115,29,144,59,46
40059,059,40,2014,3894,-45,45,0,66,42
40059,059,40,2015,3825,-117,28,-89,56,38
40059,059,40,2016,3787,-89,49,-40,46,45
40059,059,40,2017,3799,-20,25,5,41,34
40059,059,40,2018,3746,-76,23,-53,42,41
40059,059,40,2019,3707,-39,19,-20,39,58
40059,059,40,2020,3611,-69,14,-55,36,77
40061,061,40,2010,12779,-17,6,-11,39,23
40061,061,40,2011,12759,-13,15,2,151,173
40061,061,40,2012,12819,20,7,27,163,127
40061,061,40,2013,12916,109,10,119,159,180
40061,061,40,2014,12828,-113,10,-103,179,165
40061,061,40,2015,12749,-112,6,-106,167,142
40061,061,40,2016,12706,-60,18,-42,156,154
40061,061,40,2017,12735,96,8,104,126,202
40061,061,40,2018,12675,-25,8,-17,133,174
40061,061,40,2019,12670,9,7,16,115,136
40061,061,40,2020,12652,0,6,6,119,144
40063,063,40,2010,14027,23,-1,22,35,30
40063,063,40,2011,13751,-252,2,-250,144,170
40063,063,40,2012,13658,-61,6,-55,152,189
40063,063,40,2013,13638,75,2,77,140,235
40063,063,40,2014,13680,75,6,81,133,171
40063,063,40,2015,13589,-45,4,-41,157,206
40063,063,40,2016,13417,-141,6,-135,162,200
40063,063,40,2017,13266,-102,4,-98,158,211
40063,063,40,2018,13277,38,4,42,164,192
40063,063,40,2019,13240,-18,1,-17,152,172
40063,063,40,2020,13126,-89,1,-88,151,176
40065,065,40,2010,26485,-44,25,-19,102,44
40065,065,40,2011,26422,-278,43,-235,429,258
40065,065,40,2012,26226,-524,119,-405,467,273
40065,065,40,2013,26141,-332,70,-262,447,274
40065,065,40,2014,25834,-568,97,-471,410,258
40065,065,40,2015,25464,-636,128,-508,406,274
40065,065,40,2016,25488,-245,90,-155,442,265
40065,065,40,2017,25121,-506,28,-478,370,260
40065,065,40,2018,24695,-538,7,-531,375,269
40065,065,40,2019,24431,-434,17,-417,379,224
40065,065,40,2020,24305,-281,19,-262,358,222
40067,067,40,2010,6436,-23,0,-23,12,24
40067,067,40,2011,6449,45,1,46,71,105
40067,067,40,2012,6336,-100,2,-98,82,99
40067,067,40,2013,6354,35,1,36,82,99
40067,067,40,2014,6288,-37,3,-34,72,107
40067,067,40,2015,6259,-17,2,-15,78,91
40067,067,40,2016,6239,4,0,4,62,86
40067,067,40,2017,6158,-57,0,-57,79,102
40067,067,40,2018,6088,-28,0,-28,55,97
40067,067,40,2019,5988,-88,0,-88,65,77
40067,067,40,2020,5949,-13,0,-13,59,85
40069,069,40,2010,11003,32,2,34,36,26
40069,069,40,2011,11075,102,12,114,111,152
40069,069,40,2012,10972,-106,5,-101,134,138
40069,069,40,2013,10997,7,4,11,130,115
40069,069,40,2014,11110,90,-1,89,157,135
40069,069,40,2015,10977,-126,2,-124,124,132
40069,069,40,2016,11125,165,3,168,108,125
40069,069,40,2017,11133,21,2,23,127,143
40069,069,40,2018,11003,-114,1,-113,150,166
40069,069,40,2019,11055,76,1,77,125,150
40069,069,40,2020,10824,-170,1,-169,125,185
40071,071,40,2010,46428,-192,0,-192,153,106
40071,071,40,2011,45851,-607,14,-593,623,608
40071,071,40,2012,45692,-247,8,-239,646,564
40071,071,40,2013,45554,-179,0,-179,636,591
40071,071,40,2014,45475,-142,12,-130,636,576
40071,071,40,2015,45261,-217,15,-202,595,606
40071,071,40,2016,44937,-387,21,-366,625,582
40071,071,40,2017,44445,-518,8,-510,611,594
40071,071,40,2018,44047,-374,10,-364,568,602
40071,071,40,2019,43668,-314,4,-310,509,578
40071,071,40,2020,43274,-335,2,-333,517,577
40073,073,40,2010,15076,9,-1,8,54,20
40073,073,40,2011,15171,52,1,53,196,154
40073,073,40,2012,15036,-168,2,-166,179,153
40073,073,40,2013,15309,215,-4,211,202,140
40073,073,40,2014,15513,138,11,149,217,162
40073,073,40,2015,15595,0,11,11,229,155
40073,073,40,2016,15661,-61,79,18,194,146
40073,073,40,2017,15773,43,54,97,184,169
40073,073,40,2018,15916,81,38,119,182,156
40073,073,40,2019,15899,-89,30,-59,187,144
40073,073,40,2020,15806,-166,28,-138,186,142
40075,075,40,2010,9442,-14,2,-12,24,15
40075,075,40,2011,9426,17,8,25,99,141
40075,075,40,2012,9359,-72,8,-64,129,133
40075,075,40,2013,9347,25,2,27,120,157
40075,075,40,2014,9286,-55,2,-53,122,128
40075,075,40,2015,9120,-132,2,-130,116,154
40075,075,40,2016,9034,-69,1,-68,121,139
40075,075,40,2017,8850,-146,1,-145,99,140
40075,075,40,2018,8728,-100,1,-99,116,139
40075,075,40,2019,8725,-2,1,-1,119,120
40075,075,40,2020,8741,13,1,14,110,108
40077,077,40,2010,11158,-19,0,-19,34,13
40077,077,40,2011,11181,-7,0,-7,150,119
40077,077,40,2012,11009,-181,2,-179,122,122
40077,077,40,2013,10796,-211,5,-206,102,112
40077,077,40,2014,10779,5,3,8,114,138
40077,077,40,2015,10622,-145,10,-135,126,149
40077,077,40,2016,10553,-52,2,-50,141,160
40077,077,40,2017,10312,-190,2,-188,115,168
40077,077,40,2018,10155,-123,3,-120,115,153
40077,077,40,2019,10044,-121,3,-118,139,132
40077,077,40,2020,10132,87,2,89,121,121
40079,079,40,2010,50527,80,9,89,173,115
40079,079,40,2011,50505,-130,39,-91,686,614
40079,079,40,2012,50346,-290,58,-232,670,600
40079,079,40,2013,50309,-157,59,-98,696,628
40079,079,40,2014,50225,-239,83,-156,657,582
40079,079,40,2015,50030,-268,65,-203,630,620
40079,079,40,2016,50154,92,46,138,625,635
40079,079,40,2017,50022,-112,40,-72,587,646
40079,079,40,2018,50080,122,34,156,606,700
40079,079,40,2019,49804,-245,29,-216,621,682
40079,079,40,2020,49935,241,25,266,596,732
40081,081,40,2010,34355,34,1,35,99,51
40081,081,40,2011,34263,-91,0,-91,374,375
40081,081,40,2012,34169,-99,2,-97,386,382
40081,081,40,2013,34247,56,1,57,399,372
40081,081,40,2014,34539,299,4,303,395,406
40081,081,40,2015,34937,324,8,332,428,360
40081,081,40,2016,34907,-48,3,-45,429,411
40081,081,40,2017,34967,121,5,126,360,424
40081,081,40,2018,34824,-92,6,-86,357,413
40081,081,40,2019,34939,118,3,121,365,370
40081,081,40,2020,35045,129,2,131,358,382
40083,083,40,2010,42045,163,8,171,123,101
40083,083,40,2011,42568,398,6,404,473,355
40083,083,40,2012,43035,332,-7,325,452,307
40083,083,40,2013,43828,674,6,680,474,370
40083,083,40,2014,44681,690,11,701,473,335
40083,083,40,2015,45355,485,20,505,559,391
40083,083,40,2016,46032,474,17,491,538,352
40083,083,40,2017,46806,618,13,631,521,379
40083,083,40,2018,47304,351,14,365,515,379
40083,083,40,2019,48084,658,2,660,496,377
40083,083,40,2020,48777,622,7,629,504,437
40085,085,40,2010,9411,14,2,16,26,47
40085,085,40,2011,9385,-63,10,-53,141,113
40085,085,40,2012,9572,139,7,146,127,88
40085,085,40,2013,9701,95,3,98,146,116
40085,085,40,2014,9740,40,3,43,112,116
40085,085,40,2015,9815,73,11,84,105,113
40085,085,40,2016,10034,168,23,191,138,110
40085,085,40,2017,10088,47,17,64,109,119
40085,085,40,2018,10109,21,13,34,121,134
40085,085,40,2019,10177,57,9,66,125,123
40085,085,40,2020,10230,65,7,72,121,139
40087,087,40,2010,34737,162,2,164,111,54
40087,087,40,2011,35199,335,24,359,422,318
40087,087,40,2012,35583,306,18,324,390,333
40087,087,40,2013,36459,739,13,752,423,315
40087,087,40,2014,37248,671,13,684,433,341
40087,087,40,2015,37981,651,14,665,409,346
40087,087,40,2016,38625,519,11,530,467,354
40087,087,40,2017,39310,633,9,642,434,389
40087,087,40,2018,39855,563,6,569,411,434
40087,087,40,2019,40466,573,2,575,423,384
40087,087,40,2020,41348,872,5,877,419,408
40089,089,40,2010,33204,11,-1,10,115,71
40089,089,40,2011,33312,2,7,9,480,379
40089,089,40,2012,33350,-44,4,-40,477,395
40089,089,40,2013,33232,-205,4,-201,496,413
40089,089,40,2014,33192,-121,29,-92,486,430
40089,089,40,2015,33174,-104,68,-36,450,429
40089,089,40,2016,33099,-224,97,-127,475,423
40089,089,40,2017,33024,-126,71,-55,454,471
40089,089,40,2018,32921,-234,86,-148,462,418
40089,089,40,2019,32748,-275,73,-202,430,400
40089,089,40,2020,32772,35,45,80,432,490
40091,091,40,2010,20267,52,0,52,47,79
40091,091,40,2011,20264,158,3,161,206,370
40091,091,40,2012,20193,51,1,52,190,309
40091,091,40,2013,20107,-1,6,5,214,300
40091,091,40,2014,19958,-52,4,-48,238,336
40091,091,40,2015,19811,-46,2,-44,202,300
40091,091,40,2016,19761,-5,0,-5,228,273
40091,091,40,2017,19693,53,-1,52,211,330
40091,091,40,2018,19702,156,-1,155,183,328
40091,091,40,2019,19595,24,-1,23,176,303
40091,091,40,2020,19635,201,-1,200,177,335
40093,093,40,2010,7519,-23,-1,-24,29,12
40093,093,40,2011,7643,111,4,115,90,82
40093,093,40,2012,7705,22,11,33,115,86
40093,093,40,2013,7715,-15,5,-10,114,92
40093,093,40,2014,7791,45,8,53,104,80
40093,093,40,2015,7774,-43,17,-26,106,95
40093,093,40,2016,7760,-28,18,-10,100,104
40093,093,40,2017,7694,-81,12,-69,111,109
40093,093,40,2018,7609,-72,13,-59,97,123
40093,093,40,2019,7630,-20,11,-9,114,84
40093,093,40,2020,7579,-96,9,-87,110,74
40095,095,40,2010,15838,27,5,32,32,64
40095,095,40,2011,15952,86,26,112,192,190
40095,095,40,2012,16021,54,12,66,205,200
40095,095,40,2013,16064,12,5,17,200,174
40095,095,40,2014,16160,104,17,121,178,202
40095,095,40,2015,16267,138,10,148,180,219
40095,095,40,2016,16265,-36,26,-10,210,201
40095,095,40,2017,16371,125,7,132,173,201
40095,095,40,2018,16746,354,5,359,216,200
40095,095,40,2019,16946,195,2,197,186,182
40095,095,40,2020,17114,146,5,151,203,185
40097,097,40,2010,41314,-4,-1,-5,128,72
40097,097,40,2011,41327,10,4,14,491,491
40097,097,40,2012,41161,-133,5,-128,494,531
40097,097,40,2013,40975,-239,7,-232,513,462
40097,097,40,2014,40934,-132,10,-122,529,443
40097,097,40,2015,40901,4,19,23,475,526
40097,097,40,2016,41031,124,9,133,469,470
40097,097,40,2017,40994,29,6,35,460,529
40097,097,40,2018,41173,211,6,217,488,526
40097,097,40,2019,41136,-30,3,-27,484,493
40097,097,40,2020,41152,147,4,151,458,594
40099,099,40,2010,13526,31,0,31,39,33
40099,099,40,2011,13598,117,0,117,150,194
40099,099,40,2012,13621,54,1,55,148,182
40099,099,40,2013,13682,86,-1,85,162,184
40099,099,40,2014,13763,85,10,95,162,176
40099,099,40,2015,13859,109,17,126,160,191
40099,099,40,2016,13922,63,26,89,168,194
40099,099,40,2017,13927,21,14,35,151,180
40099,099,40,2018,13977,96,9,105,155,209
40099,099,40,2019,14081,134,8,142,153,191
40099,099,40,2020,13955,-77,5,-72,163,217
40101,101,40,2010,71121,42,9,51,238,154
40101,101,40,2011,70769,-400,49,-351,956,957
40101,101,40,2012,70538,-389,32,-357,991,864
40101,101,40,2013,70193,-385,10,-375,936,907
40101,101,40,2014,69751,-466,14,-452,928,917
40101,101,40,2015,69349,-381,32,-349,944,995
40101,101,40,2016,69028,-208,42,-166,861,1012
40101,101,40,2017,69089,29,27,56,865,857
40101,101,40,2018,68431,-552,29,-523,862,999
40101,101,40,2019,68097,-268,18,-250,814,899
40101,101,40,2020,67610,-375,17,-358,795,924
40103,103,40,2010,11565,-11,0,-11,47,35
40103,103,40,2011,11584,5,0,5,142,128
40103,103,40,2012,11537,-39,0,-39,126,131
40103,103,40,2013,11427,-119,0,-119,142,134
40103,103,40,2014,11555,127,2,129,134,133
40103,103,40,2015,11560,6,4,10,121,127
40103,103,40,2016,11420,-134,3,-131,125,133
40103,103,40,2017,11311,-72,1,-71,126,165
40103,103,40,2018,11304,5,2,7,131,144
40103,103,40,2019,11168,-114,0,-114,116,138
40103,103,40,2020,11113,-35,1,-34,109,130
40105,105,40,2010,10524,-15,0,-15,28,24
40105,105,40,2011,10622,105,1,106,120,128
40105,105,40,2012,10607,4,0,4,104,120
40105,105,40,2013,10555,-18,2,-16,133,168
40105,105,40,2014,10503,-22,2,-20,106,136
40105,105,40,2015,10517,48,1,49,123,158
40105,105,40,2016,10405,-94,3,-91,112,131
40105,105,40,2017,10322,-72,2,-70,135,148
40105,105,40,2018,10289,-5,3,-2,124,154
40105,105,40,2019,10123,-186,2,-184,143,125
40105,105,40,2020,10076,-21,1,-20,131,158
40107,107,40,2010,12231,15,1,16,47,23
40107,107,40,2011,12333,59,13,72,210,179
40107,107,40,2012,12334,-6,2,-4,179,174
40107,107,40,2013,12298,-30,5,-25,153,161
40107,107,40,2014,12170,-85,9,-76,149,199
40107,107,40,2015,12110,-28,12,-16,142,184
40107,107,40,2016,12089,-16,6,-10,146,157
40107,107,40,2017,12077,31,1,32,127,171
40107,107,40,2018,12046,17,1,18,158,208
40107,107,40,2019,11956,-83,1,-82,145,151
40107,107,40,2020,11765,-165,1,-164,144,171
40109,109,40,2010,720779,497,429,926,2997,1519
40109,109,40,2011,730890,2669,2336,5005,11910,6802
40109,109,40,2012,743477,4659,2423,7082,11930,6525
40109,109,40,2013,756286,5181,2015,7196,12394,6875
40109,109,40,2014,766928,3191,2186,5377,12337,7062
40109,109,40,2015,777406,1837,3056,4893,12555,6934
40109,109,40,2016,784684,-523,2391,1868,12410,6957
40109,109,40,2017,786126,-4319,1333,-2986,11615,7161
40109,109,40,2018,790926,-523,1286,763,11421,7359
40109,109,40,2019,797563,1689,857,2546,11256,7189
40109,109,40,2020,804041,2237,692,2929,11194,7683
40111,111,40,2010,40082,40,1,41,133,150
40111,111,40,2011,39787,-306,12,-294,509,511
40111,111,40,2012,39555,-266,5,-261,526,496
40111,111,40,2013,39404,-119,4,-115,503,533
40111,111,40,2014,39086,-366,3,-363,513,471
40111,111,40,2015,39072,16,3,19,505,534
40111,111,40,2016,39061,43,4,47,451,507
40111,111,40,2017,38831,-149,3,-146,480,565
40111,111,40,2018,38223,-483,3,-480,431,557
40111,111,40,2019,38417,260,1,261,421,488
40111,111,40,2020,38234,-25,2,-23,415,576
40113,113,40,2010,47487,-25,14,-11,112,72
40113,113,40,2011,47775,210,28,238,522,472
40113,113,40,2012,47454,-265,16,-249,400,474
40113,113,40,2013,47387,-61,3,-58,425,431
40113,113,40,2014,47490,101,7,108,449,445
40113,113,40,2015,47333,-137,8,-129,446,472
40113,113,40,2016,47364,40,16,56,441,462
40113,113,40,2017,47348,9,10,19,420,453
40113,113,40,2018,47074,-223,9,-214,436,495
40113,113,40,2019,46942,-55,5,-50,440,522
40113,113,40,2020,46642,-143,6,-137,432,597
40115,115,40,2010,31860,-18,2,-16,107,75
40115,115,40,2011,31876,-23,26,3,450,438
40115,115,40,2012,32196,300,20,320,461,464
40115,115,40,2013,32188,-84,12,-72,485,419
40115,115,40,2014,31955,-272,15,-257,435,413
40115,115,40,2015,31890,-101,19,-82,486,468
40115,115,40,2016,31617,-234,19,-215,414,470
40115,115,40,2017,31407,-153,13,-140,408,479
40115,115,40,2018,31332,-35,17,-18,400,456
40115,115,40,2019,31180,-131,13,-118,414,447
40115,115,40,2020,30879,-173,12,-161,393,531
40117,117,40,2010,16588,7,2,9,52,40
40117,117,40,2011,16731,162,6,168,190,215
40117,117,40,2012,16443,-259,4,-255,184,220
40117,117,40,2013,16453,29,6,35,190,213
40117,117,40,2014,16350,-111,9,-102,211,216
40117,117,40,2015,16436,78,5,83,200,197
40117,117,40,2016,16461,57,7,64,193,230
40117,117,40,2017,16417,-49,7,-42,186,188
40117,117,40,2018,16372,-56,6,-50,220,214
40117,117,40,2019,16379,33,4,37,176,207
40117,117,40,2020,16381,16,5,21,185,202
40119,119,40,2010,77420,-85,55,-30,207,102
40119,119,40,2011,78253,-144,570,426,936,529
40119,119,40,2012,78754,-166,365,199,874,569
40119,119,40,2013,79744,164,446,610,935,542
40119,119,40,2014,80583,16,482,498,893,539
40119,119,40,2015,81443,-288,772,484,946,567
40119,119,40,2016,81924,-291,432,141,905,565
40119,119,40,2017,81998,-509,325,-184,846,593
40119,119,40,2018,82198,-435,397,-38,848,613
40119,119,40,2019,81683,-1022,292,-730,829,617
40119,119,40,2020,81755,-307,226,-81,813,664
40121,121,40,2010,45799,-17,6,-11,121,132
40121,121,40,2011,45721,-11,13,2,517,594
40121,121,40,2012,45542,-112,-3,-115,535,593
40121,121,40,2013,45267,-219,1,-218,549,603
40121,121,40,2014,44853,-338,10,-328,548,632
40121,121,40,2015,44725,25,6,31,487,641
40121,121,40,2016,44397,-263,18,-245,550,631
40121,121,40,2017,44182,-140,11,-129,502,587
40121,121,40,2018,43842,-210,12,-198,512,653
40121,121,40,2019,43673,-129,6,-123,547,594
40121,121,40,2020,43679,109,6,115,522,632
40123,123,40,2010,37594,30,5,35,139,65
40123,123,40,2011,37751,26,33,59,568,467
40123,123,40,2012,38064,133,35,168,552,406
40123,123,40,2013,38162,-49,53,4,513,411
40123,123,40,2014,38292,-78,49,-29,565,400
40123,123,40,2015,38343,-87,66,-21,515,439
40123,123,40,2016,38499,42,41,83,536,461
40123,123,40,2017,38348,-268,26,-242,532,441
40123,123,40,2018,38328,-102,31,-71,515,464
40123,123,40,2019,38352,10,24,34,494,505
40123,123,40,2020,38397,69,16,85,498,541
40125,125,40,2010,69653,117,4,121,242,158
40125,125,40,2011,70071,160,41,201,987,768
40125,125,40,2012,70524,307,25,332,898,772
40125,125,40,2013,70921,207,37,244,922,760
40125,125,40,2014,71561,477,27,504,928,790
40125,125,40,2015,71510,-130,39,-91,920,874
40125,125,40,2016,72051,450,45,495,891,844
40125,125,40,2017,72232,182,30,212,879,907
40125,125,40,2018,72568,312,35,347,877,886
40125,125,40,2019,72703,125,24,149,838,853
40125,125,40,2020,72998,307,19,326,849,883
40127,127,40,2010,11593,7,0,7,29,20
40127,127,40,2011,11415,-121,6,-115,125,188
40127,127,40,2012,11254,-142,9,-133,124,154
40127,127,40,2013,11203,-12,4,-8,121,162
40127,127,40,2014,11111,-61,5,-56,147,184
40127,127,40,2015,11155,54,8,62,157,176
40127,127,40,2016,11047,-88,0,-88,136,155
40127,127,40,2017,11089,97,0,97,114,168
40127,127,40,2018,11139,78,0,78,114,141
40127,127,40,2019,11030,-62,0,-62,108,156
40127,127,40,2020,10970,13,0,13,101,172
40129,129,40,2010,3647,1,0,1,17,18
40129,129,40,2011,3762,94,4,98,53,37
40129,129,40,2012,3770,-1,-1,-2,49,39
40129,129,40,2013,3737,-51,0,-51,43,25
40129,129,40,2014,3767,19,0,19,48,39
40129,129,40,2015,3782,4,0,4,53,41
40129,129,40,2016,3683,-127,0,-127,56,28
40129,129,40,2017,3673,-11,0,-11,51,49
40129,129,40,2018,3657,-23,0,-23,37,31
40129,129,40,2019,3593,-73,0,-73,36,25
40129,129,40,2020,3570,-30,0,-30,34,28
40131,131,40,2010,87016,46,14,60,240,183
40131,131,40,2011,87567,310,45,355,914,715
40131,131,40,2012,88117,303,30,333,987,752
40131,131,40,2013,88752,459,34,493,964,814
40131,131,40,2014,89394,389,46,435,1055,828
40131,131,40,2015,90113,610,51,661,992,929
40131,131,40,2016,91061,702,68,770,1044,863
40131,131,40,2017,91472,287,50,337,993,913
40131,131,40,2018,91957,354,38,392,1053,953
40131,131,40,2019,92616,555,36,591,1012,943
40131,131,40,2020,93155,381,30,411,1046,921
40133,133,40,2010,25487,-20,1,-19,82,55
40133,133,40,2011,25443,-74,3,-71,345,318
40133,133,40,2012,25388,-20,3,-17,318,354
40133,133,40,2013,25445,38,3,41,366,345
40133,133,40,2014,25361,-52,9,-43,319,357
40133,133,40,2015,25410,121,7,128,308,384
40133,133,40,2016,25157,-280,9,-271,348,330
40133,133,40,2017,24864,-291,7,-284,344,353
40133,133,40,2018,24529,-289,8,-281,306,361
40133,133,40,2019,24321,-206,5,-201,313,318
40133,133,40,2020,24248,-38,8,-30,305,349
40135,135,40,2010,42513,32,0,32,132,79
40135,135,40,2011,42428,-167,8,-159,559,485
40135,135,40,2012,42064,-453,14,-439,558,492
40135,135,40,2013,41838,-231,23,-208,509,525
40135,135,40,2014,41879,59,25,84,511,544
40135,135,40,2015,41811,-127,47,-80,526,510
40135,135,40,2016,41887,95,26,121,500,541
40135,135,40,2017,41762,-66,19,-47,488,564
40135,135,40,2018,41651,-144,16,-128,552,535
40135,135,40,2019,41599,1,12,13,551,616
40135,135,40,2020,41538,-20,10,-10,546,599
40137,137,40,2010,45105,29,5,34,141,115
40137,137,40,2011,45115,19,13,32,531,551
40137,137,40,2012,44901,-232,33,-199,544,557
40137,137,40,2013,45000,138,16,154,523,570
40137,137,40,2014,44590,-466,30,-436,601,578
40137,137,40,2015,44604,49,41,90,534,604
40137,137,40,2016,44044,-608,44,-564,550,547
40137,137,40,2017,43374,-647,31,-616,486,543
40137,137,40,2018,43231,-68,27,-41,496,598
40137,137,40,2019,43258,35,19,54,528,555
40137,137,40,2020,43100,-99,17,-82,512,589
40139,139,40,2010,20800,86,28,114,90,50
40139,139,40,2011,21257,79,169,248,355,147
40139,139,40,2012,21598,35,72,107,382,147
40139,139,40,2013,22052,157,62,219,366,136
40139,139,40,2014,21741,-613,66,-547,387,166
40139,139,40,2015,21452,-587,107,-480,381,198
40139,139,40,2016,21242,-568,191,-377,363,199
40139,139,40,2017,21052,-541,132,-409,389,172
40139,139,40,2018,20659,-704,136,-568,359,188
40139,139,40,2019,20216,-758,97,-661,358,140
40139,139,40,2020,19997,-500,79,-421,335,130
40141,141,40,2010,7983,-8,4,-4,23,26
40141,141,40,2011,8001,1,3,4,119,104
40141,141,40,2012,7826,-189,1,-188,101,96
40141,141,40,2013,7726,-114,5,-109,104,95
40141,141,40,2014,7668,-67,15,-52,96,104
40141,141,40,2015,7565,-111,16,-95,89,97
40141,141,40,2016,7520,-72,38,-34,83,94
40141,141,40,2017,7399,-124,25,-99,79,100
40141,141,40,2018,7325,-65,12,-53,82,103
40141,141,40,2019,7260,-77,11,-66,74,73
40141,141,40,2020,7229,-33,11,-22,73,81
40143,143,40,2010,605024,346,212,558,2327,1267
40143,143,40,2011,609323,-845,1529,684,9171,5531
40143,143,40,2012,615376,966,1182,2148,9337,5332
40143,143,40,2013,623978,3907,1224,5131,9199,5738
40143,143,40,2014,631241,2118,1587,3705,9290,5658
40143,143,40,2015,640851,3493,2278,5771,9658,5806
40143,143,40,2016,646328,-342,2001,1659,9606,5757
40143,143,40,2017,646874,-4253,1181,-3072,9503,5881
40143,143,40,2018,648496,-2472,1252,-1220,8994,6153
40143,143,40,2019,652166,259,758,1017,8837,6203
40143,143,40,2020,657589,2504,666,3170,8841,6617
40145,145,40,2010,73428,201,2,203,231,99
40145,145,40,2011,74041,345,13,358,860,604
40145,145,40,2012,74988,638,23,661,864,582
40145,145,40,2013,75660,370,19,389,931,641
40145,145,40,2014,75664,-223,40,-183,869,666
40145,145,40,2015,76753,768,62,830,867,610
40145,145,40,2016,77688,616,65,681,865,609
40145,145,40,2017,79021,1055,36,1091,895,654
40145,145,40,2018,80218,931,32,963,878,646
40145,145,40,2019,81466,1089,19,1108,874,729
40145,145,40,2020,82925,1387,32,1419,891,845
40147,147,40,2010,51071,41,14,55,157,114
40147,147,40,2011,51378,126,105,231,653,576
40147,147,40,2012,51655,158,97,255,618,587
40147,147,40,2013,51684,-56,86,30,609,605
40147,147,40,2014,52044,243,109,352,618,601
40147,147,40,2015,52144,-51,141,90,690,674
40147,147,40,2016,52099,-215,130,-85,654,613
40147,147,40,2017,52107,-81,98,17,652,657
40147,147,40,2018,51881,-216,100,-116,566,677
40147,147,40,2019,51665,-247,74,-173,610,653
40147,147,40,2020,52222,604,66,670,575,683
40149,149,40,2010,11544,-6,1,-5,40,47
40149,149,40,2011,11550,-4,1,-3,150,140
40149,149,40,2012,11586,41,0,41,137,141
40149,149,40,2013,11706,102,1,103,148,132
40149,149,40,2014,11567,-179,4,-175,163,130
40149,149,40,2015,11697,81,5,86,181,138
40149,149,40,2016,11428,-283,4,-279,150,142
40149,149,40,2017,11061,-346,3,-343,139,164
40149,149,40,2018,11064,-15,4,-11,145,130
40149,149,40,2019,10943,-78,3,-75,117,162
40149,149,40,2020,10830,-87,3,-84,122,151
40151,151,40,2010,8904,16,0,16,26,16
40151,151,40,2011,8791,-132,4,-128,110,97
40151,151,40,2012,8853,53,4,57,106,103
40151,151,40,2013,9003,141,9,150,100,107
40151,151,40,2014,9253,234,11,245,108,107
40151,151,40,2015,9306,10,13,23,128,98
40151,151,40,2016,9152,-174,8,-166,98,87
40151,151,40,2017,9069,-111,4,-107,112,87
40151,151,40,2018,8872,-184,5,-179,93,112
40151,151,40,2019,8790,-93,4,-89,99,93
40151,151,40,2020,8687,-94,4,-90,93,105
40153,153,40,2010,19996,-139,3,-136,63,25
40153,153,40,2011,20111,-4,15,11,292,187
40153,153,40,2012,20677,405,18,423,317,186
40153,153,40,2013,21248,382,21,403,340,183
40153,153,40,2014,21544,132,34,166,308,175
40153,153,40,2015,21619,-108,55,-53,315,185
40153,153,40,2016,20991,-798,48,-750,304,186
40153,153,40,2017,20540,-536,27,-509,273,217
40153,153,40,2018,20277,-339,24,-315,252,202
40153,153,40,2019,20138,-181,18,-163,256,231
40153,153,40,2020,19812,-306,16,-290,254,288
41001,001,41,2010,16116,-22,0,-22,44,42
41001,001,41,2011,16069,-16,7,-9,172,210
41001,001,41,2012,16001,-54,9,-45,183,202
41001,001,41,2013,16027,45,10,55,164,192
41001,001,41,2014,16030,29,9,38,174,206
41001,001,41,2015,15899,-83,12,-71,157,215
41001,001,41,2016,15971,135,12,147,141,216
41001,001,41,2017,16049,113,9,122,163,207
41001,001,41,2018,16024,15,6,21,158,201
41001,001,41,2019,16123,149,3,152,162,213
41001,001,41,2020,16284,230,5,235,160,231
41003,003,41,2010,85577,-207,99,-108,194,100
41003,003,41,2011,86281,-124,614,490,762,549
41003,003,41,2012,86708,-159,434,275,733,570
41003,003,41,2013,86228,-1029,352,-677,715,546
41003,003,41,2014,87296,381,521,902,720,551
41003,003,41,2015,88443,510,498,1008,718,575
41003,003,41,2016,90053,495,958,1453,758,599
41003,003,41,2017,91923,1163,557,1720,743,599
41003,003,41,2018,92511,162,314,476,671,554
41003,003,41,2019,93114,277,238,515,686,600
41003,003,41,2020,93239,-111,204,93,678,650
41005,005,41,2010,376799,424,123,547,1015,721
41005,005,41,2011,379640,1533,585,2118,3809,3074
41005,005,41,2012,383159,2468,147,2615,3883,2953
41005,005,41,2013,387571,3499,66,3565,4034,3205
41005,005,41,2014,393544,4806,260,5066,3962,3119
41005,005,41,2015,399852,5444,138,5582,4119,3424
41005,005,41,2016,407055,5636,723,6359,4262,3423
41005,005,41,2017,412982,4861,434,5295,4181,3546
41005,005,41,2018,415586,1841,167,2008,4028,3416
41005,005,41,2019,418199,2062,87,2149,3904,3436
41005,005,41,2020,421596,3339,75,3414,3864,3871
41007,007,41,2010,37097,8,13,21,118,73
41007,007,41,2011,37241,34,51,85,418,358
41007,007,41,2012,37435,78,53,131,430,365
41007,007,41,2013,37143,-295,13,-282,416,428
41007,007,41,2014,37491,293,20,313,415,382
41007,007,41,2015,37848,339,13,352,425,420
41007,007,41,2016,38732,819,27,846,411,378
41007,007,41,2017,39185,445,24,469,411,428
41007,007,41,2018,39730,589,5,594,360,410
41007,007,41,2019,40208,474,7,481,384,386
41007,007,41,2020,40423,271,6,277,373,435
41009,009,41,2010,49353,-59,10,-49,125,75
41009,009,41,2011,49408,-92,38,-54,499,389
41009,009,41,2012,49220,-210,3,-207,444,429
41009,009,41,2013,49271,-71,4,-67,481,364
41009,009,41,2014,49513,164,16,180,507,440
41009,009,41,2015,49671,72,16,88,535,459
41009,009,41,2016,50939,1177,12,1189,542,469
41009,009,41,2017,51749,776,9,785,490,468
41009,009,41,2018,52408,619,-7,612,505,459
41009,009,41,2019,52614,230,-8,222,464,480
41009,009,41,2020,52876,333,-1,332,466,533
41011,011,41,2010,63010,34,1,35,168,240
41011,011,41,2011,62789,-45,53,8,607,833
41011,011,41,2012,62697,148,56,204,586,881
41011,011,41,2013,62409,-134,38,-96,650,831
41011,011,41,2014,62403,180,45,225,638,860
41011,011,41,2015,62696,586,6,592,609,906
41011,011,41,2016,63386,936,0,936,641,890
41011,011,41,2017,63764,714,4,718,593,932
41011,011,41,2018,64338,969,-4,965,587,982
41011,011,41,2019,64677,670,-7,663,582,905
41011,011,41,2020,64711,471,-5,466,570,999
41013,013,41,2010,20882,-117,1,-116,54,40
41013,013,41,2011,20640,-167,9,-158,156,240
41013,013,41,2012,20610,21,0,21,163,208
41013,013,41,2013,20702,136,2,138,190,238
41013,013,41,2014,20965,296,-4,292,194,230
41013,013,41,2015,21465,552,-8,544,224,275
41013,013,41,2016,22310,877,-10,867,221,248
41013,013,41,2017,23072,778,-9,769,261,272
41013,013,41,2018,23789,755,-9,746,254,286
41013,013,41,2019,24388,628,-9,619,234,253
41013,013,41,2020,25105,757,-5,752,237,266
41015,015,41,2010,22378,37,3,40,51,77
41015,015,41,2011,22497,287,-7,280,181,342
41015,015,41,2012,22272,-44,-16,-60,191,350
41015,015,41,2013,22252,181,-15,166,179,370
41015,015,41,2014,22167,141,-16,125,177,386
41015,015,41,2015,22329,386,-19,367,175,386
41015,015,41,2016,22629,548,-13,535,165,402
41015,015,41,2017,22681,289,-13,276,182,408
41015,015,41,2018,22850,344,-16,328,168,328
41015,015,41,2019,22981,352,-16,336,172,376
41015,015,41,2020,23305,572,-11,561,169,403
41017,017,41,2010,157744,-16,0,-16,421,371
41017,017,41,2011,159683,1455,-11,1444,1708,1216
41017,017,41,2012,161408,1390,-35,1355,1666,1307
41017,017,41,2013,165385,3543,-9,3534,1700,1332
41017,017,41,2014,169631,3693,24,3717,1750,1340
41017,017,41,2015,174392,4295,-12,4283,1813,1401
41017,017,41,2016,180819,6017,86,6103,1737,1451
41017,017,41,2017,186971,5818,18,5836,1813,1541
41017,017,41,2018,191770,4463,-43,4420,1853,1500
41017,017,41,2019,197417,5427,-61,5366,1798,1511
41017,017,41,2020,201769,4235,-52,4183,1866,1674
41019,019,41,2010,107637,60,11,71,266,369
41019,019,41,2011,107257,-78,36,-42,1072,1402
41019,019,41,2012,106955,41,0,41,1080,1403
41019,019,41,2013,106645,-101,4,-97,1114,1309
41019,019,41,2014,106769,476,33,509,1063,1428
41019,019,41,2015,107260,783,0,783,1117,1405
41019,019,41,2016,108244,1292,74,1366,1079,1461
41019,019,41,2017,109378,1515,36,1551,1098,1516
41019,019,41,2018,110164,1229,-1,1228,1061,1497
41019,019,41,2019,110926,1273,-9,1264,1049,1547
41019,019,41,2020,111364,994,-6,988,1048,1592
41021,021,41,2010,1880,3,0,3,6,0
41021,021,41,2011,1950,69,0,69,18,18
41021,021,41,2012,1949,5,1,6,17,24
41021,021,41,2013,1940,-12,1,-11,23,20
41021,021,41,2014,1927,-18,0,-18,18,15
41021,021,41,2015,1866,-58,1,-57,18,22
41021,021,41,2016,1852,-2,1,-1,14,26
41021,021,41,2017,1860,4,1,5,18,16
41021,021,41,2018,1883,32,1,33,12,21
41021,021,41,2019,1911,29,1,30,18,19
41021,021,41,2020,1975,71,0,71,14,21
41023,023,41,2010,7465,18,0,18,19,16
41023,023,41,2011,7409,-42,2,-40,65,82
41023,023,41,2012,7325,-59,0,-59,61,86
41023,023,41,2013,7271,-31,0,-31,61,84
41023,023,41,2014,7191,-64,0,-64,57,75
41023,023,41,2015,7209,31,-2,29,70,81
41023,023,41,2016,7167,-4,-1,-5,57,93
41023,023,41,2017,7190,40,-2,38,63,76
41023,023,41,2018,7169,24,-2,22,58,102
41023,023,41,2019,7166,33,-2,31,62,95
41023,023,41,2020,7180,46,-2,44,59,89
41025,025,41,2010,7403,-16,0,-16,30,33
41025,025,41,2011,7363,-20,-2,-22,78,95
41025,025,41,2012,7256,-130,5,-125,79,65
41025,025,41,2013,7167,-85,6,-79,74,86
41025,025,41,2014,7133,-51,14,-37,78,77
41025,025,41,2015,7154,23,4,27,94,99
41025,025,41,2016,7252,109,5,114,80,95
41025,025,41,2017,7270,16,6,22,75,78
41025,025,41,2018,7278,4,5,9,73,74
41025,025,41,2019,7375,110,5,115,66,84
41025,025,41,2020,7373,16,3,19,63,83
41027,027,41,2010,22447,45,8,53,67,19
41027,027,41,2011,22439,-147,18,-129,289,168
41027,027,41,2012,22545,49,-37,12,285,189
41027,027,41,2013,22574,-60,-30,-90,292,169
41027,027,41,2014,22671,19,14,33,270,203
41027,027,41,2015,22925,150,-10,140,297,184
41027,027,41,2016,23090,24,11,35,294,162
41027,027,41,2017,23405,209,53,262,248,194
41027,027,41,2018,23228,-231,2,-229,256,205
41027,027,41,2019,23347,41,-2,39,247,167
41027,027,41,2020,23280,-137,-2,-139,250,179
41029,029,41,2010,203357,121,21,142,574,541
41029,029,41,2011,204798,1072,153,1225,2408,2188
41029,029,41,2012,205939,1168,-60,1108,2254,2212
41029,029,41,2013,207313,1425,-75,1350,2283,2255
41029,029,41,2014,209351,1984,0,1984,2345,2314
41029,029,41,2015,211587,2229,-29,2200,2319,2291
41029,029,41,2016,214600,2868,111,2979,2341,2313
41029,029,41,2017,217030,2466,114,2580,2297,2450
41029,029,41,2018,219616,2810,-15,2795,2211,2425
41029,029,41,2019,220815,1405,-34,1371,2203,2369
41029,029,41,2020,221844,1426,-30,1396,2159,2524
41031,031,41,2010,21662,-83,4,-79,69,55
41031,031,41,2011,21752,-35,18,-17,312,204
41031,031,41,2012,21835,-27,7,-20,288,180
41031,031,41,2013,21869,-45,2,-43,278,199
41031,031,41,2014,22200,268,-9,259,280,213
41031,031,41,2015,22540,271,-8,263,290,218
41031,031,41,2016,23022,433,-16,417,281,217
41031,031,41,2017,23629,542,-12,530,279,203
41031,031,41,2018,24085,414,-13,401,249,197
41031,031,41,2019,24647,460,-13,447,324,208
41031,031,41,2020,24856,184,-10,174,310,274
41033,033,41,2010,82880,171,7,178,216,232
41033,033,41,2011,82722,272,7,279,781,1211
41033,033,41,2012,82789,472,-19,453,778,1158
41033,033,41,2013,83175,755,-16,739,821,1179
41033,033,41,2014,83435,583,-7,576,863,1181
41033,033,41,2015,84606,1465,12,1477,881,1199
41033,033,41,2016,85599,1292,45,1337,846,1191
41033,033,41,2017,86732,1499,19,1518,881,1269
41033,033,41,2018,87418,1042,-8,1034,866,1215
41033,033,41,2019,87679,739,-17,722,797,1253
41033,033,41,2020,88053,885,-16,869,803,1293
41035,035,41,2010,66323,-85,7,-78,226,205
41035,035,41,2011,66322,-148,34,-114,812,695
41035,035,41,2012,65936,-429,14,-415,794,758
41035,035,41,2013,65719,-309,18,-291,777,697
41035,035,41,2014,65333,-422,9,-413,772,744
41035,035,41,2015,65742,333,15,348,818,752
41035,035,41,2016,66287,457,16,473,842,767
41035,035,41,2017,66853,612,18,630,775,842
41035,035,41,2018,67810,1011,-12,999,783,826
41035,035,41,2019,68343,644,-19,625,758,849
41035,035,41,2020,68739,530,-10,520,771,894
41037,037,41,2010,7875,-9,0,-9,16,16
41037,037,41,2011,7908,47,1,48,67,83
41037,037,41,2012,7789,-114,1,-113,68,76
41037,037,41,2013,7800,17,-2,15,80,82
41037,037,41,2014,7828,29,6,35,83,89
41037,037,41,2015,7789,-25,1,-24,84,98
41037,037,41,2016,7837,78,4,82,75,108
41037,037,41,2017,7892,61,4,65,74,83
41037,037,41,2018,7861,14,3,17,52,101
41037,037,41,2019,7939,99,1,100,72,93
41037,037,41,2020,7949,46,0,46,71,107
41039,039,41,2010,351948,-120,185,65,950,729
41039,039,41,2011,354119,674,1162,1836,3470,3123
41039,039,41,2012,355217,539,562,1101,3480,3410
41039,039,41,2013,355654,62,300,362,3452,3310
41039,039,41,2014,358273,1732,667,2399,3642,3384
41039,039,41,2015,362257,3297,487,3784,3710,3527
41039,039,41,2016,369201,5844,1065,6909,3519,3508
41039,039,41,2017,375689,6048,570,6618,3488,3649
41039,039,41,2018,378807,3161,259,3420,3361,3667
41039,039,41,2019,382064,3554,168,3722,3364,3829
41039,039,41,2020,382986,1470,137,1607,3314,4016
41041,041,41,2010,45997,24,6,30,112,174
41041,041,41,2011,45877,-11,44,33,437,589
41041,041,41,2012,46180,418,15,433,418,568
41041,041,41,2013,46351,255,32,287,439,559
41041,041,41,2014,46383,101,49,150,448,563
41041,041,41,2015,47046,760,17,777,424,546
41041,041,41,2016,47855,938,8,946,451,590
41041,041,41,2017,48794,1123,14,1137,405,611
41041,041,41,2018,49320,770,6,776,388,642
41041,041,41,2019,50125,1050,-6,1044,381,618
41041,041,41,2020,50583,769,-3,766,386,690
41043,043,41,2010,116887,73,18,91,385,260
41043,043,41,2011,118175,891,73,964,1451,1129
41043,043,41,2012,118293,-160,-16,-176,1446,1125
41043,043,41,2013,118439,-43,-27,-70,1377,1140
41043,043,41,2014,119095,421,10,431,1452,1218
41043,043,41,2015,120303,1023,14,1037,1470,1297
41043,043,41,2016,122871,2248,96,2344,1543,1328
41043,043,41,2017,125098,1979,48,2027,1485,1291
41043,043,41,2018,127455,2161,5,2166,1486,1307
41043,043,41,2019,129598,2029,-3,2026,1481,1362
41043,043,41,2020,131054,1437,-4,1433,1498,1472
41045,045,41,2010,31349,-56,4,-52,137,54
41045,045,41,2011,30964,-505,-5,-510,442,319
41045,045,41,2012,30755,-288,-30,-318,402,295
41045,045,41,2013,30642,-266,-25,-291,455,281
41045,045,41,2014,30354,-390,-7,-397,429,328
41045,045,41,2015,30228,-180,-17,-197,388,315
41045,045,41,2016,30397,-3,9,6,462,298
41045,045,41,2017,30449,-78,33,-45,415,316
41045,045,41,2018,30633,102,-3,99,393,306
41045,045,41,2019,30698,-53,-4,-57,398,278
41045,045,41,2020,30983,166,6,172,383,269
41047,047,41,2010,315948,-16,84,68,1202,626
41047,047,41,2011,318053,-460,648,188,4462,2533
41047,047,41,2012,319865,33,104,137,4329,2573
41047,047,41,2013,321491,76,-12,64,4303,2681
41047,047,41,2014,324473,1121,141,1262,4338,2573
41047,047,41,2015,329106,3053,3,3056,4406,2844
41047,047,41,2016,335592,4282,507,4789,4482,2798
41047,047,41,2017,340846,3205,503,3708,4423,2883
41047,047,41,2018,345512,3065,125,3190,4372,2907
41047,047,41,2019,347557,675,31,706,4129,2798
41047,047,41,2020,349204,625,46,671,4119,3161
41049,049,41,2010,11207,6,14,20,38,26
41049,049,41,2011,11226,-142,48,-94,183,72
41049,049,41,2012,11226,-80,0,-80,155,76
41049,049,41,2013,11197,-76,-11,-87,141,85
41049,049,41,2014,11095,-181,7,-174,149,84
41049,049,41,2015,11130,-59,-5,-64,165,66
41049,049,41,2016,11246,-4,28,24,176,84
41049,049,41,2017,11225,-153,49,-104,156,72
41049,049,41,2018,11349,17,23,40,159,74
41049,049,41,2019,11607,146,23,169,171,83
41049,049,41,2020,11700,11,16,27,167,101
41051,051,41,2010,737320,336,584,920,2494,1285
41051,051,41,2011,749926,4416,3975,8391,9587,5422
41051,051,41,2012,760505,4302,2067,6369,9407,5391
41051,051,41,2013,766977,816,1954,2770,9324,5646
41051,051,41,2014,779002,4677,3209,7886,9537,5555
41051,051,41,2015,790723,5221,2650,7871,9463,5711
41051,051,41,2016,803630,4409,4982,9391,9075,5610
41051,051,41,2017,808192,-1239,2931,1692,8766,5877
41051,051,41,2018,809448,-2875,1546,-1329,8327,5703
41051,051,41,2019,812439,-146,1106,960,7993,5967
41051,051,41,2020,815637,742,872,1614,8081,6509
41053,053,41,2010,75540,96,16,112,218,189
41053,053,41,2011,75942,69,71,140,870,604
41053,053,41,2012,76227,-7,33,26,907,635
41053,053,41,2013,76568,105,45,150,855,656
41053,053,41,2014,77702,796,109,905,875,649
41053,053,41,2015,79012,1115,80,1195,812,705
41053,053,41,2016,81496,2077,140,2217,953,692
41053,053,41,2017,83707,1884,112,1996,894,686
41053,053,41,2018,84854,1022,41,1063,836,753
41053,053,41,2019,85851,802,20,822,869,691
41053,053,41,2020,87744,1818,22,1840,846,783
41055,055,41,2010,1779,10,0,10,3,1
41055,055,41,2011,1750,-37,2,-35,20,13
41055,055,41,2012,1748,-3,0,-3,19,18
41055,055,41,2013,1728,-21,1,-20,12,11
41055,055,41,2014,1715,-9,1,-8,14,20
41055,055,41,2015,1691,-21,0,-21,21,24
41055,055,41,2016,1712,19,1,20,16,15
41055,055,41,2017,1740,33,1,34,21,26
41055,055,41,2018,1702,-32,0,-32,12,18
41055,055,41,2019,1790,79,0,79,22,12
41055,055,41,2020,1801,1,0,1,23,15
41057,057,41,2010,25243,20,5,25,55,79
41057,057,41,2011,25393,143,37,180,254,285
41057,057,41,2012,25276,-92,8,-84,251,279
41057,057,41,2013,25332,68,10,78,262,286
41057,057,41,2014,25314,16,1,17,234,266
41057,057,41,2015,25554,295,-4,291,241,293
41057,057,41,2016,26116,608,-10,598,262,301
41057,057,41,2017,26511,496,-9,487,245,341
41057,057,41,2018,26710,292,-16,276,234,310
41057,057,41,2019,27132,489,-16,473,235,283
41057,057,41,2020,27442,390,-7,383,248,318
41059,059,41,2010,76093,47,-8,39,301,128
41059,059,41,2011,76810,296,5,301,1088,669
41059,059,41,2012,77011,-215,-60,-275,1086,592
41059,059,41,2013,76892,-561,-58,-619,1110,613
41059,059,41,2014,76711,-665,22,-643,1086,632
41059,059,41,2015,76491,-541,-27,-568,1014,666
41059,059,41,2016,76700,-181,54,-127,1004,666
41059,059,41,2017,77069,17,107,124,952,703
41059,059,41,2018,77332,-35,9,-26,953,662
41059,059,41,2019,77744,122,-3,119,953,660
41059,059,41,2020,77752,-243,3,-240,956,711
41061,061,41,2010,25725,1,7,8,73,89
41061,061,41,2011,25906,92,45,137,294,251
41061,061,41,2012,25801,-172,7,-165,317,255
41061,061,41,2013,25531,-339,11,-328,312,261
41061,061,41,2014,25645,44,17,61,287,231
41061,061,41,2015,25720,39,21,60,296,276
41061,061,41,2016,26082,307,35,342,309,288
41061,061,41,2017,26410,263,33,296,310,275
41061,061,41,2018,26733,292,22,314,279,269
41061,061,41,2019,26733,9,19,28,265,292
41061,061,41,2020,26551,-112,13,-99,260,344
41063,063,41,2010,7012,17,1,18,15,29
41063,063,41,2011,6979,-11,3,-8,59,83
41063,063,41,2012,6800,-142,1,-141,48,89
41063,063,41,2013,6769,0,1,1,60,91
41063,063,41,2014,6778,27,0,27,71,88
41063,063,41,2015,6810,58,0,58,52,79
41063,063,41,2016,6912,118,0,118,63,80
41063,063,41,2017,7018,136,1,137,64,96
41063,063,41,2018,7043,58,1,59,57,91
41063,063,41,2019,7169,141,0,141,63,77
41063,063,41,2020,7181,28,0,28,64,79
41065,065,41,2010,25282,29,7,36,81,44
41065,065,41,2011,25217,-58,30,-28,271,308
41065,065,41,2012,25375,173,-11,162,299,303
41065,065,41,2013,25329,-46,12,-34,297,304
41065,065,41,2014,25276,-41,2,-39,314,325
41065,065,41,2015,25469,213,5,218,304,329
41065,065,41,2016,25791,314,12,326,331,335
41065,065,41,2017,26296,495,11,506,328,333
41065,065,41,2018,26346,91,-7,84,299,334
41065,065,41,2019,26532,203,-9,194,284,292
41065,065,41,2020,26403,-108,-4,-112,282,298
41067,067,41,2010,531652,167,463,630,1869,663
41067,067,41,2011,541041,2251,2888,5139,7104,2860
41067,067,41,2012,548651,2040,1425,3465,7245,3066
41067,067,41,2013,555443,1642,1069,2711,7187,3076
41067,067,41,2014,562552,1300,1987,3287,7088,3182
41067,067,41,2015,572955,4888,1746,6634,7046,3321
41067,067,41,2016,585358,4603,4079,8682,7030,3331
41067,067,41,2017,591969,618,2624,3242,6876,3493
41067,067,41,2018,597030,775,1257,2032,6476,3447
41067,067,41,2019,600933,37,868,905,6478,3502
41067,067,41,2020,603514,-732,718,-14,6426,3878
41069,069,41,2010,1449,8,0,8,4,5
41069,069,41,2011,1418,-19,0,-19,9,20
41069,069,41,2012,1411,12,0,12,9,28
41069,069,41,2013,1380,-26,0,-26,8,15
41069,069,41,2014,1351,-25,0,-25,12,16
41069,069,41,2015,1327,-6,0,-6,8,26
41069,069,41,2016,1325,-4,-1,-5,15,12
41069,069,41,2017,1353,35,0,35,11,20
41069,069,41,2018,1356,12,0,12,12,20
41069,069,41,2019,1348,-1,0,-1,10,16
41069,069,41,2020,1387,47,0,47,8,17
41071,071,41,2010,99298,37,16,53,261,217
41071,071,41,2011,99708,-13,108,95,1176,859
41071,071,41,2012,99933,-71,8,-63,1120,828
41071,071,41,2013,99926,-294,35,-259,1074,815
41071,071,41,2014,100850,553,90,643,1129,838
41071,071,41,2015,101447,453,18,471,1086,954
41071,071,41,2016,104143,2368,31,2399,1177,891
41071,071,41,2017,105313,1043,18,1061,1128,1022
41071,071,41,2018,106390,1071,-49,1022,1076,1020
41071,071,41,2019,106927,411,-67,344,1094,900
41071,071,41,2020,107664,661,-50,611,1078,956
42001,001,42,2010,101472,-13,9,-4,267,201
42001,001,42,2011,101476,-144,24,-120,1048,922
42001,001,42,2012,101265,-282,36,-246,962,917
42001,001,42,2013,101156,-197,27,-170,1096,1026
42001,001,42,2014,101376,71,67,138,1067,968
42001,001,42,2015,101847,386,101,487,1031,1033
42001,001,42,2016,101952,-2,186,184,975,1050
42001,001,42,2017,102629,638,42,680,1007,1004
42001,001,42,2018,103035,470,82,552,989,1129
42001,001,42,2019,102776,-100,6,-94,910,1076
42001,001,42,2020,102742,157,14,171,899,1106
42003,003,42,2010,1223973,44,576,620,3357,3155
42003,003,42,2011,1228437,2260,2921,5181,13164,13854
42003,003,42,2012,1231129,670,2666,3336,13104,13544
42003,003,42,2013,1233999,366,3355,3721,13163,13856
42003,003,42,2014,1233417,-4029,3839,-190,13063,13248
42003,003,42,2015,1229342,-6346,3338,-3008,13175,14168
42003,003,42,2016,1226893,-6108,3765,-2343,13316,13381
42003,003,42,2017,1220423,-8091,2876,-5215,13046,14285
42003,003,42,2018,1217508,-4112,2448,-1664,12825,14027
42003,003,42,2019,1215716,-2732,1632,-1100,12944,13644
42003,003,42,2020,1211358,-3839,1303,-2536,12681,14553
42005,005,42,2010,69029,-38,3,-35,182,220
42005,005,42,2011,68661,-246,4,-242,688,811
42005,005,42,2012,68223,-264,4,-260,689,861
42005,005,42,2013,68015,-78,3,-75,721,844
42005,005,42,2014,67631,-201,5,-196,637,818
42005,005,42,2015,66913,-482,5,-477,615,854
42005,005,42,2016,66464,-265,1,-264,611,796
42005,005,42,2017,66042,-166,1,-165,629,881
42005,005,42,2018,65411,-363,1,-362,592,862
42005,005,42,2019,64699,-405,0,-405,559,865
42005,005,42,2020,64162,-154,1,-153,562,947
42007,007,42,2010,170630,95,1,96,440,418
42007,007,42,2011,170330,-34,35,1,1697,1990
42007,007,42,2012,170091,198,33,231,1662,2091
42007,007,42,2013,169770,161,35,196,1737,2226
42007,007,42,2014,169033,-325,32,-293,1675,2085
42007,007,42,2015,168311,-207,28,-179,1662,2184
42007,007,42,2016,166926,-1058,68,-990,1752,2144
42007,007,42,2017,165779,-604,36,-568,1591,2165
42007,007,42,2018,164669,-476,44,-432,1571,2243
42007,007,42,2019,163956,-153,10,-143,1568,2138
42007,007,42,2020,162575,-723,16,-707,1539,2215
42009,009,42,2010,49697,-30,0,-30,113,155
42009,009,42,2011,49626,-2,0,-2,486,553
42009,009,42,2012,49592,-8,4,-4,465,486
42009,009,42,2013,49317,-222,7,-215,508,567
42009,009,42,2014,49131,-86,10,-76,478,580
42009,009,42,2015,48748,-291,7,-284,459,556
42009,009,42,2016,48592,-31,15,-16,466,602
42009,009,42,2017,48359,-95,8,-87,475,618
42009,009,42,2018,48090,-167,7,-160,486,594
42009,009,42,2019,47913,-102,3,-99,463,540
42009,009,42,2020,47817,41,3,44,458,598
42011,011,42,2010,412041,-93,227,134,1245,861
42011,011,42,2011,413027,-1505,1248,-257,4927,3675
42011,011,42,2012,413552,-1676,998,-678,4894,3675
42011,011,42,2013,413975,-1815,1220,-595,4865,3842
42011,011,42,2014,414632,-2117,1636,-481,4860,3711
42011,011,42,2015,415218,-1919,1627,-292,4834,3943
42011,011,42,2016,415911,-2109,2025,-84,4787,4003
42011,011,42,2017,417601,-675,1748,1073,4684,4054
42011,011,42,2018,420407,-102,2219,2117,4730,4025
42011,011,42,2019,420375,-1208,472,-736,4582,3887
42011,011,42,2020,421017,-508,776,268,4564,4204
42013,013,42,2010,127049,-9,11,2,337,394
42013,013,42,2011,126990,175,31,206,1341,1599
42013,013,42,2012,126569,-245,26,-219,1319,1500
42013,013,42,2013,125869,-335,25,-310,1320,1697
42013,013,42,2014,125309,-314,28,-286,1303,1556
42013,013,42,2015,124637,-401,39,-362,1330,1633
42013,013,42,2016,123779,-584,35,-549,1338,1641
42013,013,42,2017,123173,-171,29,-142,1203,1660
42013,013,42,2018,122567,-307,28,-279,1219,1543
42013,013,42,2019,121942,-197,16,-181,1176,1620
42013,013,42,2020,121007,-381,19,-362,1164,1740
42015,015,42,2010,62731,-1,3,2,195,158
42015,015,42,2011,63111,334,12,346,751,716
42015,015,42,2012,63005,-229,22,-207,727,624
42015,015,42,2013,62519,-584,24,-560,762,697
42015,015,42,2014,61957,-725,28,-697,756,634
42015,015,42,2015,61656,-304,30,-274,711,734
42015,015,42,2016,61103,-573,46,-527,688,714
42015,015,42,2017,60996,-142,29,-113,690,681
42015,015,42,2018,60858,-108,24,-84,648,698
42015,015,42,2019,60429,-386,18,-368,664,724
42015,015,42,2020,60221,-92,18,-74,652,787
42017,017,42,2010,625572,-323,215,-108,1498,1212
42017,017,42,2011,626164,-570,775,205,5845,5446
42017,017,42,2012,625603,-1579,633,-946,5781,5367
42017,017,42,2013,625325,-1027,765,-262,5735,5719
42017,017,42,2014,625618,-710,978,268,5787,5686
42017,017,42,2015,625670,-609,890,281,5739,5923
42017,017,42,2016,626369,-522,1168,646,5924,5845
42017,017,42,2017,627302,617,767,1384,5782,6191
42017,017,42,2018,628183,670,684,1354,5833,6273
42017,017,42,2019,628497,553,309,862,5667,6207
42017,017,42,2020,627987,260,244,504,5615,6632
42019,019,42,2010,184085,105,25,130,500,377
42019,019,42,2011,184766,703,77,780,1779,1873
42019,019,42,2012,185016,229,69,298,1831,1836
42019,019,42,2013,185185,227,105,332,1796,1935
42019,019,42,2014,185874,703,115,818,1824,1924
42019,019,42,2015,186046,238,93,331,1813,1952
42019,019,42,2016,186427,238,188,426,1835,1869
42019,019,42,2017,187083,893,131,1024,1758,2114
42019,019,42,2018,188031,1058,135,1193,1750,1988
42019,019,42,2019,188313,432,55,487,1813,2018
42019,019,42,2020,189135,1111,59,1170,1783,2133
42021,021,42,2010,143458,-106,12,-94,366,492
42021,021,42,2011,142590,-394,51,-343,1360,1880
42021,021,42,2012,141563,-687,51,-636,1382,1765
42021,021,42,2013,138858,-2350,69,-2281,1367,1862
42021,021,42,2014,137587,-928,57,-871,1355,1758
42021,021,42,2015,136083,-960,42,-918,1343,1931
42021,021,42,2016,134517,-1140,66,-1074,1363,1854
42021,021,42,2017,133035,-902,43,-859,1322,1945
42021,021,42,2018,131478,-1003,44,-959,1264,1864
42021,021,42,2019,130107,-770,19,-751,1157,1775
42021,021,42,2020,128672,-787,19,-768,1171,1837
42023,023,42,2010,5080,-7,0,-7,19,18
42023,023,42,2011,5012,-41,1,-40,45,72
42023,023,42,2012,4974,-18,2,-16,45,67
42023,023,42,2013,4927,-28,3,-25,48,69
42023,023,42,2014,4829,-109,8,-101,45,46
42023,023,42,2015,4773,-57,8,-49,49,55
42023,023,42,2016,4702,-59,5,-54,41,57
42023,023,42,2017,4611,-72,6,-66,41,67
42023,023,42,2018,4494,-88,6,-82,38,73
42023,023,42,2019,4425,-37,4,-33,36,72
42023,023,42,2020,4330,-55,2,-53,33,76
42025,025,42,2010,65247,9,-5,4,155,147
42025,025,42,2011,65084,106,-6,100,600,860
42025,025,42,2012,64799,-62,-3,-65,568,777
42025,025,42,2013,64545,-65,5,-60,628,814
42025,025,42,2014,64264,-93,21,-72,559,756
42025,025,42,2015,63766,-232,14,-218,575,850
42025,025,42,2016,63561,-53,40,-13,621,809
42025,025,42,2017,63885,523,39,562,571,808
42025,025,42,2018,64169,532,48,580,570,865
42025,025,42,2019,64125,176,6,182,548,774
42025,025,42,2020,64081,258,13,271,542,857
42027,027,42,2010,154242,-61,168,107,365,224
42027,027,42,2011,155107,-345,960,615,1193,944
42027,027,42,2012,155905,-471,919,448,1286,928
42027,027,42,2013,158342,971,1111,2082,1243,920
42027,027,42,2014,159798,-97,1280,1183,1205,903
42027,027,42,2015,160641,-627,1156,529,1273,956
42027,027,42,2016,162287,15,1332,1347,1250,947
42027,027,42,2017,162549,-1020,1035,15,1220,982
42027,027,42,2018,162895,-659,879,220,1162,1043
42027,027,42,2019,162095,-1550,648,-902,1153,1059
42027,027,42,2020,161496,-1043,508,-535,1137,1208
42029,029,42,2010,499935,57,256,313,1444,908
42029,029,42,2011,503488,558,1055,1613,5596,3636
42029,029,42,2012,506049,-219,876,657,5607,3627
42029,029,42,2013,509101,417,961,1378,5469,3722
42029,029,42,2014,512776,438,1473,1911,5579,3717
42029,029,42,2015,515098,-882,1401,519,5729,3898
42029,029,42,2016,516768,-1674,1877,203,5333,3856
42029,029,42,2017,519057,-14,1080,1066,5309,4060
42029,029,42,2018,522256,979,1059,2038,5317,4126
42029,029,42,2019,525059,1022,514,1536,5430,4160
42029,029,42,2020,526759,431,446,877,5359,4549
42031,031,42,2010,39926,-48,4,-44,98,114
42031,031,42,2011,39904,-38,25,-13,413,421
42031,031,42,2012,39472,-436,27,-409,388,427
42031,031,42,2013,39087,-419,34,-385,416,424
42031,031,42,2014,38923,-172,21,-151,422,432
42031,031,42,2015,38889,-46,22,-24,407,413
42031,031,42,2016,38607,-299,22,-277,409,415
42031,031,42,2017,39020,425,16,441,390,422
42031,031,42,2018,38735,-275,15,-260,378,403
42031,031,42,2019,38498,-159,12,-147,374,464
42031,031,42,2020,38305,-85,9,-76,363,481
42033,033,42,2010,81543,3,8,11,213,279
42033,033,42,2011,81438,19,41,60,750,912
42033,033,42,2012,81407,128,60,188,694,896
42033,033,42,2013,81444,134,57,191,790,937
42033,033,42,2014,81018,-291,68,-223,717,911
42033,033,42,2015,80735,-209,69,-140,783,921
42033,033,42,2016,80190,-457,76,-381,731,894
42033,033,42,2017,79803,-182,68,-114,732,1001
42033,033,42,2018,79542,-47,55,8,735,1002
42033,033,42,2019,79183,-158,41,-117,709,953
42033,033,42,2020,78612,-281,35,-246,681,1008
42035,035,42,2010,39262,-1,3,2,133,116
42035,035,42,2011,39511,194,21,215,395,361
42035,035,42,2012,39739,183,9,192,443,410
42035,035,42,2013,39835,28,24,52,439,388
42035,035,42,2014,39490,-375,13,-362,433,422
42035,035,42,2015,39402,-151,12,-139,446,392
42035,035,42,2016,39009,-418,14,-404,405,397
42035,035,42,2017,38830,-155,10,-145,377,410
42035,035,42,2018,38647,-184,11,-173,424,430
42035,035,42,2019,38302,-343,5,-338,413,421
42035,035,42,2020,37957,-335,3,-332,411,424
42037,037,42,2010,67355,15,13,28,187,145
42037,037,42,2011,67085,-258,51,-207,619,682
42037,037,42,2012,67045,13,28,41,612,678
42037,037,42,2013,67203,177,31,208,596,642
42037,037,42,2014,67135,-35,32,-3,636,685
42037,037,42,2015,66704,-315,12,-303,601,726
42037,037,42,2016,66171,-435,31,-404,569,700
42037,037,42,2017,65638,-377,20,-357,536,711
42037,037,42,2018,65278,-183,16,-167,552,744
42037,037,42,2019,65020,-73,12,-61,516,714
42037,037,42,2020,64842,62,11,73,521,774
42039,039,42,2010,88614,-112,4,-108,257,282
42039,039,42,2011,88176,-324,4,-320,901,1018
42039,039,42,2012,87745,-468,13,-455,925,898
42039,039,42,2013,87532,-171,32,-139,974,1037
42039,039,42,2014,87180,-269,39,-230,866,981
42039,039,42,2015,86540,-556,25,-531,986,1092
42039,039,42,2016,86353,-199,31,-168,967,982
42039,039,42,2017,85790,-449,18,-431,909,1040
42039,039,42,2018,85111,-668,10,-658,942,964
42039,039,42,2019,84421,-575,7,-568,898,1018
42039,039,42,2020,83697,-575,9,-566,885,1043
42041,041,42,2010,235903,262,152,414,634,529
42041,041,42,2011,237151,348,535,883,2546,2171
42041,041,42,2012,239315,1355,586,1941,2468,2229
42041,041,42,2013,241153,1099,636,1735,2465,2347
42041,041,42,2014,243400,1199,678,1877,2541,2135
42041,041,42,2015,245891,1614,656,2270,2536,2303
42041,041,42,2016,247633,609,748,1357,2674,2271
42041,041,42,2017,249328,947,627,1574,2595,2460
42041,041,42,2018,251486,1468,564,2032,2644,2510
42041,041,42,2019,253133,1113,305,1418,2600,2365
42041,041,42,2020,255857,2367,282,2649,2592,2510
42043,043,42,2010,268289,-293,185,-108,857,573
42043,043,42,2011,269278,-841,851,10,3486,2501
42043,043,42,2012,270058,-1056,868,-188,3398,2406
42043,043,42,2013,271500,-524,1004,480,3469,2470
42043,043,42,2014,272312,-1352,1193,-159,3403,2417
42043,043,42,2015,273195,-1168,1104,-64,3420,2455
42043,043,42,2016,274305,-1074,1264,190,3434,2509
42043,043,42,2017,275796,-393,1112,719,3417,2634
42043,043,42,2018,276951,-916,1157,241,3426,2508
42043,043,42,2019,278427,217,503,720,3388,2636
42043,043,42,2020,279874,313,538,851,3381,2798
42045,045,42,2010,559009,-484,401,-83,1692,1353
42045,045,42,2011,559338,-2741,1670,-1071,6902,5501
42045,045,42,2012,560865,-1314,1415,101,6795,5311
42045,045,42,2013,561635,-1705,1589,-116,6622,5692
42045,045,42,2014,562868,-1944,1781,-163,6794,5348
42045,045,42,2015,563434,-2513,1735,-778,6821,5450
42045,045,42,2016,563860,-2782,2033,-749,6544,5366
42045,045,42,2017,564015,-2369,1663,-706,6447,5584
42045,045,42,2018,565506,-1094,1535,441,6588,5530
42045,045,42,2019,566506,-928,891,-37,6481,5452
42045,045,42,2020,566753,-1071,763,-308,6418,5884
42047,047,42,2010,31862,-54,0,-54,90,121
42047,047,42,2011,31798,25,0,25,312,399
42047,047,42,2012,31619,-98,1,-97,311,393
42047,047,42,2013,31462,-101,2,-99,312,367
42047,047,42,2014,31187,-224,2,-222,338,392
42047,047,42,2015,30898,-177,3,-174,284,399
42047,047,42,2016,30516,-287,3,-284,299,397
42047,047,42,2017,30274,-147,1,-146,293,389
42047,047,42,2018,30096,-38,0,-38,262,399
42047,047,42,2019,29894,-102,0,-102,263,363
42047,047,42,2020,29607,-164,1,-163,261,386
42049,049,42,2010,280809,-114,78,-36,832,545
42049,049,42,2011,281244,-531,510,-21,3269,2804
42049,049,42,2012,281416,-1081,856,-225,3239,2823
42049,049,42,2013,280905,-1334,566,-768,3152,2889
42049,049,42,2014,279660,-2179,544,-1635,3184,2819
42049,049,42,2015,278452,-1942,500,-1442,3166,2933
42049,049,42,2016,276639,-3080,898,-2182,3218,2857
42049,049,42,2017,273855,-3475,736,-2739,2988,3050
42049,049,42,2018,271780,-2762,689,-2073,2870,2881
42049,049,42,2019,269529,-2526,413,-2113,2737,2877
42049,049,42,2020,268426,-1137,357,-780,2681,3012
42051,051,42,2010,136431,-20,4,-16,352,475
42051,051,42,2011,136008,4,25,29,1384,1826
42051,051,42,2012,135283,-293,5,-288,1337,1755
42051,051,42,2013,134610,-309,85,-224,1368,1800
42051,051,42,2014,134009,-311,86,-225,1384,1739
42051,051,42,2015,133272,-433,104,-329,1407,1804
42051,051,42,2016,132371,-583,58,-525,1384,1755
42051,051,42,2017,131340,-515,50,-465,1321,1881
42051,051,42,2018,130452,-412,60,-352,1304,1838
42051,051,42,2019,129422,-540,11,-529,1279,1783
42051,051,42,2020,128126,-664,22,-642,1284,1938
42053,053,42,2010,7704,1,0,1,7,10
42053,053,42,2011,7672,23,3,26,39,97
42053,053,42,2012,7587,-36,3,-33,38,91
42053,053,42,2013,7532,-9,3,-6,38,87
42053,053,42,2014,7459,-27,3,-24,36,85
42053,053,42,2015,7386,-29,4,-25,44,92
42053,053,42,2016,7334,-6,6,0,22,75
42053,053,42,2017,7328,50,8,58,29,93
42053,053,42,2018,7294,22,12,34,17,86
42053,053,42,2019,7030,-212,0,-212,19,72
42053,053,42,2020,6965,-1,3,2,15,82
42055,055,42,2010,149925,76,41,117,495,294
42055,055,42,2011,150949,376,187,563,1862,1395
42055,055,42,2012,151518,-135,182,47,1938,1387
42055,055,42,2013,152005,3,164,167,1785,1434
42055,055,42,2014,152685,48,189,237,1887,1407
42055,055,42,2015,153131,16,173,189,1857,1577
42055,055,42,2016,153938,158,344,502,1862,1546
42055,055,42,2017,154731,280,289,569,1826,1592
42055,055,42,2018,154943,-148,324,176,1733,1692
42055,055,42,2019,155522,289,150,439,1740,1600
42055,055,42,2020,155637,3,152,155,1717,1763
42057,057,42,2010,14861,4,0,4,33,18
42057,057,42,2011,14738,-104,2,-102,129,150
42057,057,42,2012,14701,-45,3,-42,132,123
42057,057,42,2013,14622,-56,5,-51,135,163
42057,057,42,2014,14536,-76,0,-76,137,146
42057,057,42,2015,14510,23,1,24,117,165
42057,057,42,2016,14502,33,1,34,141,183
42057,057,42,2017,14469,-18,1,-17,140,155
42057,057,42,2018,14486,45,0,45,144,170
42057,057,42,2019,14502,11,0,11,148,141
42057,057,42,2020,14501,16,0,16,144,162
42059,059,42,2010,38616,-31,1,-30,102,145
42059,059,42,2011,38377,-216,5,-211,404,431
42059,059,42,2012,38048,-279,-2,-281,404,452
42059,059,42,2013,37880,-139,6,-133,405,439
42059,059,42,2014,37781,-97,3,-94,403,402
42059,059,42,2015,37431,-315,2,-313,402,442
42059,059,42,2016,37222,-144,1,-143,380,445
42059,059,42,2017,36875,-332,1,-331,410,428
42059,059,42,2018,36639,-110,2,-108,346,472
42059,059,42,2019,36062,-482,-1,-483,329,424
42059,059,42,2020,35621,-300,1,-299,320,461
42061,061,42,2010,45999,9,3,12,107,117
42061,061,42,2011,46013,14,9,23,416,423
42061,061,42,2012,45948,-46,22,-24,414,447
42061,061,42,2013,45847,-74,30,-44,419,469
42061,061,42,2014,45749,-85,29,-56,392,426
42061,061,42,2015,45514,-230,43,-187,404,451
42061,061,42,2016,45411,-90,54,-36,410,475
42061,061,42,2017,45447,123,38,161,369,492
42061,061,42,2018,45385,14,33,47,385,493
42061,061,42,2019,44894,-406,27,-379,418,529
42061,061,42,2020,44590,-160,18,-142,408,572
42063,063,42,2010,88864,-30,14,-16,240,233
42063,063,42,2011,88639,-244,79,-165,841,899
42063,063,42,2012,88243,-398,74,-324,816,881
42063,063,42,2013,88178,-146,98,-48,869,879
42063,063,42,2014,87459,-802,99,-703,865,891
42063,063,42,2015,86800,-605,82,-523,794,932
42063,063,42,2016,85243,-1625,90,-1535,833,866
42063,063,42,2017,84809,-249,73,-176,761,1017
42063,063,42,2018,84578,-174,69,-105,809,933
42063,063,42,2019,84022,-483,37,-446,791,903
42063,063,42,2020,83664,-224,37,-187,788,961
42065,065,42,2010,45163,41,1,42,124,186
42065,065,42,2011,44917,-197,9,-188,499,556
42065,065,42,2012,44805,-74,5,-69,538,573
42065,065,42,2013,44879,106,6,112,540,569
42065,065,42,2014,44575,-285,5,-280,515,539
42065,065,42,2015,44350,-161,3,-158,516,580
42065,065,42,2016,44041,-237,2,-235,479,552
42065,065,42,2017,43829,-122,3,-119,490,581
42065,065,42,2018,43573,-169,1,-168,478,564
42065,065,42,2019,43299,-163,1,-162,451,563
42065,065,42,2020,43108,-96,0,-96,459,554
42067,067,42,2010,24625,-4,2,-2,73,81
42067,067,42,2011,24711,2,37,39,282,233
42067,067,42,2012,24609,-157,20,-137,269,234
42067,067,42,2013,24478,-192,24,-168,287,252
42067,067,42,2014,24484,-27,32,5,253,249
42067,067,42,2015,24442,-109,39,-70,300,269
42067,067,42,2016,24554,79,35,114,278,278
42067,067,42,2017,24628,11,38,49,280,253
42067,067,42,2018,24722,-6,49,43,284,233
42067,067,42,2019,24760,-6,8,2,286,249
42067,067,42,2020,24619,-164,12,-152,282,271
42069,069,42,2010,214523,56,106,162,570,605
42069,069,42,2011,214400,-103,473,370,2191,2674
42069,069,42,2012,214232,-181,522,341,2252,2711
42069,069,42,2013,213797,-485,680,195,2185,2794
42069,069,42,2014,212922,-1228,800,-428,2191,2643
42069,069,42,2015,211974,-1169,755,-414,2205,2737
42069,069,42,2016,211108,-1292,867,-425,2212,2650
42069,069,42,2017,210603,-840,808,-32,2207,2677
42069,069,42,2018,210301,-367,869,502,1974,2772
42069,069,42,2019,209808,-265,327,62,2051,2606
42069,069,42,2020,208989,-473,373,-100,1987,2711
42071,071,42,2010,520325,19,231,250,1742,1044
42071,071,42,2011,523996,-42,1217,1175,7022,4504
42071,071,42,2012,526949,-594,1124,530,7048,4548
42071,071,42,2013,530109,-63,1324,1261,6908,4928
42071,071,42,2014,533414,-381,1433,1052,7016,4676
42071,071,42,2015,535960,-975,1446,471,7187,5060
42071,071,42,2016,538303,-1246,1503,257,7154,5049
42071,071,42,2017,541352,-113,1294,1181,7048,5154
42071,071,42,2018,543960,-731,1455,724,7117,5220
42071,071,42,2019,545441,-782,512,-270,6887,5141
42071,071,42,2020,546192,-1165,590,-575,6879,5565
42073,073,42,2010,91016,-107,7,-100,208,242
42073,073,42,2011,90526,-284,24,-260,857,1084
42073,073,42,2012,89895,-490,25,-465,898,1069
42073,073,42,2013,89274,-300,22,-278,864,1203
42073,073,42,2014,88668,-409,34,-375,886,1107
42073,073,42,2015,88154,-252,27,-225,928,1209
42073,073,42,2016,87379,-542,44,-498,920,1197
42073,073,42,2017,86608,-425,33,-392,865,1242
42073,073,42,2018,86164,-205,35,-170,957,1228
42073,073,42,2019,85504,-422,18,-404,835,1090
42073,073,42,2020,85083,-119,15,-104,840,1158
42075,075,42,2010,133667,36,56,92,381,382
42075,075,42,2011,134530,156,398,554,1735,1419
42075,075,42,2012,135531,285,521,806,1619,1395
42075,075,42,2013,135803,-546,569,23,1706,1453
42075,075,42,2014,136538,-99,595,496,1659,1398
42075,075,42,2015,137492,197,545,742,1627,1396
42075,075,42,2016,138481,260,597,857,1613,1472
42075,075,42,2017,139473,414,572,986,1564,1549
42075,075,42,2018,141116,783,767,1550,1633,1534
42075,075,42,2019,141318,138,109,247,1514,1559
42075,075,42,2020,141663,197,232,429,1541,1628
42077,077,42,2010,350008,75,310,385,1009,845
42077,077,42,2011,353317,843,1569,2412,4150,3241
42077,077,42,2012,354673,-1017,1588,571,4082,3264
42077,077,42,2013,355273,-1879,1859,-20,4067,3449
42077,077,42,2014,357591,-571,2057,1486,4139,3260
42077,077,42,2015,359689,-473,2018,1545,4112,3529
42077,077,42,2016,362357,-626,2432,1806,4181,3305
42077,077,42,2017,365772,272,2319,2591,4258,3412
42077,077,42,2018,368452,-936,2748,1812,4375,3504
42077,077,42,2019,369308,-841,797,-44,4322,3431
42077,077,42,2020,370802,-288,1033,745,4307,3571
42079,079,42,2010,321017,79,139,218,830,902
42079,079,42,2011,321073,368,669,1037,3103,4067
42079,079,42,2012,321232,298,536,834,3211,3806
42079,079,42,2013,319737,-1153,767,-386,3092,4180
42079,079,42,2014,319269,-599,1022,423,3181,4027
42079,079,42,2015,318203,-1138,1037,-101,3213,4158
42079,079,42,2016,317192,-1360,1136,-224,3103,3883
42079,079,42,2017,318031,514,1119,1633,3271,4038
42079,079,42,2018,318093,-169,1164,995,3291,4209
42079,079,42,2019,317438,-630,648,18,3344,4018
42079,079,42,2020,316982,-109,582,473,3269,4204
42081,081,42,2010,116215,24,14,38,345,249
42081,081,42,2011,116747,532,63,595,1244,1306
42081,081,42,2012,117237,375,51,426,1292,1216
42081,081,42,2013,116626,-733,62,-671,1314,1255
42081,081,42,2014,116331,-373,71,-302,1246,1239
42081,081,42,2015,115644,-771,95,-676,1270,1278
42081,081,42,2016,114958,-793,160,-633,1207,1258
42081,081,42,2017,114146,-788,112,-676,1148,1284
42081,081,42,2018,114175,-19,119,100,1237,1305
42081,081,42,2019,113581,-513,65,-448,1180,1325
42081,081,42,2020,113209,-183,57,-126,1169,1418
42083,083,42,2010,43347,-75,1,-74,117,158
42083,083,42,2011,43143,-135,17,-118,442,529
42083,083,42,2012,43151,61,13,74,459,516
42083,083,42,2013,42819,-279,18,-261,449,521
42083,083,42,2014,42663,-86,15,-71,447,523
42083,083,42,2015,42424,-146,12,-134,443,544
42083,083,42,2016,41701,-652,19,-633,384,475
42083,083,42,2017,41427,-192,28,-164,381,490
42083,083,42,2018,41012,-252,26,-226,376,567
42083,083,42,2019,40631,-221,15,-206,357,532
42083,083,42,2020,40333,-126,12,-114,354,540
42085,085,42,2010,116607,-49,4,-45,301,298
42085,085,42,2011,116169,-208,23,-185,1134,1383
42085,085,42,2012,115660,-282,32,-250,1093,1339
42085,085,42,2013,115162,-214,46,-168,1081,1405
42085,085,42,2014,114724,-252,70,-182,1113,1358
42085,085,42,2015,113684,-778,60,-718,1119,1441
42085,085,42,2016,112651,-842,70,-772,1155,1413
42085,085,42,2017,111526,-834,39,-795,1144,1477
42085,085,42,2018,110575,-578,32,-546,1075,1479
42085,085,42,2019,109296,-876,18,-858,1061,1482
42085,085,42,2020,108545,-301,16,-285,1053,1520
42087,087,42,2010,46638,-13,3,-10,144,166
42087,087,42,2011,46745,42,21,63,564,516
42087,087,42,2012,46755,-91,22,-69,565,483
42087,087,42,2013,46636,-204,20,-184,588,520
42087,087,42,2014,46498,-182,26,-156,563,540
42087,087,42,2015,46435,-92,15,-77,593,573
42087,087,42,2016,46289,-180,1,-179,558,522
42087,087,42,2017,46270,-15,1,-14,568,568
42087,087,42,2018,46181,-136,-2,-138,610,559
42087,087,42,2019,46090,-127,-2,-129,609,571
42087,087,42,2020,46064,-67,1,-66,603,564
42089,089,42,2010,169852,-9,42,33,333,337
42089,089,42,2011,169921,-304,242,-62,1383,1251
42089,089,42,2012,168675,-1551,219,-1332,1327,1280
42089,089,42,2013,167435,-1541,265,-1276,1353,1353
42089,089,42,2014,167387,-452,396,-56,1381,1365
42089,089,42,2015,166602,-1062,294,-768,1395,1412
42089,089,42,2016,166324,-552,340,-212,1437,1502
42089,089,42,2017,168033,1362,313,1675,1511,1467
42089,089,42,2018,169524,1171,319,1490,1532,1519
42089,089,42,2019,170083,505,126,631,1523,1588
42089,089,42,2020,170154,186,135,321,1521,1775
42091,091,42,2010,800881,148,457,605,2275,1729
42091,091,42,2011,805333,363,2172,2535,9158,7202
42091,091,42,2012,808782,-186,1888,1702,8950,7043
42091,091,42,2013,812750,291,2287,2578,8997,7479
42091,091,42,2014,815966,-1289,2603,1314,9228,7220
42091,091,42,2015,817432,-1990,2291,301,8804,7579
42091,091,42,2016,820106,-1442,2713,1271,8864,7429
42091,091,42,2017,824533,1482,1989,3471,8719,7699
42091,091,42,2018,826995,36,1731,1767,8627,7902
42091,091,42,2019,830397,1610,1066,2676,8491,7759
42091,091,42,2020,833869,2549,855,3404,8467,8416
42093,093,42,2010,18298,18,11,29,50,37
42093,093,42,2011,18363,-35,76,41,224,199
42093,093,42,2012,18429,26,53,79,212,221
42093,093,42,2013,18398,-76,24,-52,250,228
42093,093,42,2014,18418,8,31,39,208,223
42093,093,42,2015,18297,-152,31,-121,232,231
42093,093,42,2016,18241,-69,35,-34,205,227
42093,093,42,2017,18255,8,28,36,227,247
42093,093,42,2018,18172,-78,22,-56,204,230
42093,093,42,2019,18181,27,14,41,193,225
42093,093,42,2020,18042,-98,11,-87,191,241
42095,095,42,2010,297941,113,146,259,725,703
42095,095,42,2011,298305,-275,605,330,2861,2820
42095,095,42,2012,299099,101,532,633,2921,2695
42095,095,42,2013,299066,-577,586,9,2861,2874
42095,095,42,2014,299748,91,685,776,2851,2890
42095,095,42,2015,300264,149,660,809,2784,3040
42095,095,42,2016,301629,685,842,1527,2854,2996
42095,095,42,2017,303178,1085,750,1835,2747,3010
42095,095,42,2018,304949,1216,848,2064,2865,3136
42095,095,42,2019,305515,545,233,778,2903,3114
42095,095,42,2020,305892,369,317,686,2894,3214
42097,097,42,2010,94287,-109,10,-99,234,310
42097,097,42,2011,94392,269,56,325,1019,1235
42097,097,42,2012,94413,230,46,276,909,1153
42097,097,42,2013,93884,-326,44,-282,981,1220
42097,097,42,2014,93604,-103,5,-98,931,1092
42097,097,42,2015,92895,-493,14,-479,972,1196
42097,097,42,2016,92336,-398,27,-371,968,1154
42097,097,42,2017,91766,-295,40,-255,899,1210
42097,097,42,2018,91124,-430,61,-369,924,1195
42097,097,42,2019,90684,-186,-2,-188,898,1148
42097,097,42,2020,90258,-152,14,-138,882,1174
42099,099,42,2010,45920,-21,2,-19,119,104
42099,099,42,2011,45924,-189,11,-178,599,417
42099,099,42,2012,45807,-217,5,-212,538,439
42099,099,42,2013,45650,-293,10,-283,567,441
42099,099,42,2014,45661,-113,11,-102,541,424
42099,099,42,2015,45849,101,16,117,557,480
42099,099,42,2016,45937,1,20,21,525,457
42099,099,42,2017,46043,33,12,45,530,465
42099,099,42,2018,46147,63,17,80,513,487
42099,099,42,2019,46326,126,3,129,495,443
42099,099,42,2020,46212,-116,5,-111,493,499
42101,101,42,2010,1528303,-1226,1576,350,5582,3457
42101,101,42,2011,1540615,-5097,8456,3359,23301,14311
42101,101,42,2012,1552087,-4833,7721,2888,23194,14305
42101,101,42,2013,1558713,-10777,8586,-2191,23018,14104
42101,101,42,2014,1565949,-11877,9920,-1957,23151,13862
42101,101,42,2015,1571679,-11774,8946,-2828,22700,14079
42101,101,42,2016,1576604,-13128,10314,-2814,21703,13925
42101,101,42,2017,1581699,-10697,9085,-1612,21347,14545
42101,101,42,2018,1586422,-11302,9198,-2104,21124,14216
42101,101,42,2019,1584439,-11540,4368,-7172,20452,15231
42101,101,42,2020,1578487,-13894,4153,-9741,20478,16685
42103,103,42,2010,57382,12,6,18,79,65
42103,103,42,2011,57104,-279,52,-227,294,345
42103,103,42,2012,56334,-717,46,-671,315,431
42103,103,42,2013,56126,-147,61,-86,294,419
42103,103,42,2014,55717,-376,68,-308,300,402
42103,103,42,2015,55410,-286,60,-226,367,451
42103,103,42,2016,55040,-310,32,-278,406,498
42103,103,42,2017,55492,542,29,571,405,521
42103,103,42,2018,55868,437,35,472,435,528
42103,103,42,2019,55826,124,3,127,402,569
42103,103,42,2020,56072,390,10,400,418,569
42105,105,42,2010,17451,18,0,18,50,59
42105,105,42,2011,17448,-6,1,-5,191,187
42105,105,42,2012,17556,108,1,109,195,198
42105,105,42,2013,17446,-120,3,-117,220,212
42105,105,42,2014,17183,-253,5,-248,188,208
42105,105,42,2015,17078,-100,3,-97,192,199
42105,105,42,2016,16953,-82,7,-75,178,228
42105,105,42,2017,16839,-96,5,-91,175,196
42105,105,42,2018,16626,-158,5,-153,178,237
42105,105,42,2019,16545,-41,4,-37,150,194
42105,105,42,2020,16453,-23,3,-20,158,230
42107,107,42,2010,148280,54,14,68,366,417
42107,107,42,2011,147536,-314,74,-240,1440,1939
42107,107,42,2012,147131,53,66,119,1459,1951
42107,107,42,2013,146674,103,52,155,1426,2014
42107,107,42,2014,145405,-863,64,-799,1437,1912
42107,107,42,2015,144136,-729,49,-680,1401,1988
42107,107,42,2016,143492,-94,32,-62,1356,1928
42107,107,42,2017,142550,-263,21,-242,1359,2052
42107,107,42,2018,141758,-153,32,-121,1310,1976
42107,107,42,2019,141166,-36,-2,-38,1255,1808
42107,107,42,2020,140709,158,4,162,1261,1882
42109,109,42,2010,39709,4,3,7,99,111
42109,109,42,2011,39785,-19,23,4,401,327
42109,109,42,2012,39886,15,29,44,395,329
42109,109,42,2013,40133,159,34,193,422,368
42109,109,42,2014,40246,81,26,107,383,366
42109,109,42,2015,40530,151,13,164,443,320
42109,109,42,2016,40457,-213,18,-195,462,339
42109,109,42,2017,40621,54,9,63,466,362
42109,109,42,2018,40474,-170,9,-161,394,380
42109,109,42,2019,40393,-163,4,-159,440,361
42109,109,42,2020,40317,-76,7,-69,409,416
42111,111,42,2010,77763,-9,2,-7,215,171
42111,111,42,2011,77287,-124,19,-105,635,1002
42111,111,42,2012,77028,-104,25,-79,695,862
42111,111,42,2013,76607,-93,41,-52,670,1028
42111,111,42,2014,76167,-200,50,-150,702,983
42111,111,42,2015,75404,-432,34,-398,643,1005
42111,111,42,2016,74890,-268,34,-234,696,973
42111,111,42,2017,74273,-298,33,-265,693,1044
42111,111,42,2018,73951,-118,33,-85,713,948
42111,111,42,2019,73442,-299,16,-283,715,940
42111,111,42,2020,72916,-246,14,-232,705,999
42113,113,42,2010,6410,3,0,3,16,40
42113,113,42,2011,6417,68,8,76,54,123
42113,113,42,2012,6405,27,5,32,67,109
42113,113,42,2013,6303,-43,7,-36,39,107
42113,113,42,2014,6280,25,7,32,60,115
42113,113,42,2015,6266,27,4,31,50,94
42113,113,42,2016,6123,-89,2,-87,45,101
42113,113,42,2017,6136,51,2,53,50,90
42113,113,42,2018,6057,-36,3,-33,45,92
42113,113,42,2019,5959,-32,-1,-33,36,100
42113,113,42,2020,5913,25,0,25,39,110
42115,115,42,2010,43333,5,0,5,107,90
42115,115,42,2011,43222,10,6,16,354,479
42115,115,42,2012,42923,-253,6,-247,395,446
42115,115,42,2013,42399,-418,-1,-419,345,452
42115,115,42,2014,42089,-265,3,-262,395,444
42115,115,42,2015,41778,-252,2,-250,377,437
42115,115,42,2016,41268,-434,10,-424,380,467
42115,115,42,2017,40939,-185,4,-181,361,507
42115,115,42,2018,40565,-284,4,-280,376,471
42115,115,42,2019,40241,-172,2,-170,379,532
42115,115,42,2020,40006,-112,2,-110,376,501
42117,117,42,2010,42002,40,2,42,115,83
42117,117,42,2011,42278,298,10,308,448,480
42117,117,42,2012,42486,176,5,181,411,381
42117,117,42,2013,42252,-228,6,-222,452,462
42117,117,42,2014,41940,-288,10,-278,429,465
42117,117,42,2015,41562,-408,9,-399,455,438
42117,117,42,2016,41295,-269,16,-253,426,439
42117,117,42,2017,40729,-500,14,-486,399,482
42117,117,42,2018,40725,65,11,76,406,484
42117,117,42,2019,40665,17,7,24,396,478
42117,117,42,2020,40381,-148,4,-144,379,520
42119,119,42,2010,45005,17,9,26,93,76
42119,119,42,2011,45130,68,40,108,425,406
42119,119,42,2012,45195,14,42,56,375,360
42119,119,42,2013,44773,-529,47,-482,418,375
42119,119,42,2014,45017,151,80,231,386,364
42119,119,42,2015,45573,434,47,481,419,350
42119,119,42,2016,45527,-116,57,-59,404,391
42119,119,42,2017,44744,-852,55,-797,386,382
42119,119,42,2018,45090,263,72,335,406,396
42119,119,42,2019,44498,-631,2,-629,409,374
42119,119,42,2020,44294,-159,15,-144,401,463
42121,121,42,2010,54972,-41,1,-40,158,129
42121,121,42,2011,54679,-164,5,-159,561,694
42121,121,42,2012,54185,-371,1,-370,529,653
42121,121,42,2013,53814,-299,1,-298,578,650
42121,121,42,2014,53351,-373,3,-370,540,633
42121,121,42,2015,52962,-260,5,-255,525,657
42121,121,42,2016,52487,-378,5,-373,535,635
42121,121,42,2017,51800,-543,7,-536,512,663
42121,121,42,2018,51283,-324,7,-317,450,650
42121,121,42,2019,50875,-261,3,-258,491,640
42121,121,42,2020,50328,-274,4,-270,447,723
42123,123,42,2010,41770,-15,0,-15,99,120
42123,123,42,2011,41512,-206,17,-189,399,468
42123,123,42,2012,41268,-130,12,-118,389,511
42123,123,42,2013,40963,-181,11,-170,397,531
42123,123,42,2014,40667,-198,11,-187,383,489
42123,123,42,2015,40346,-237,15,-222,409,508
42123,123,42,2016,40039,-235,11,-224,398,480
42123,123,42,2017,39682,-212,6,-206,388,539
42123,123,42,2018,39528,-69,5,-64,406,493
42123,123,42,2019,39171,-253,4,-249,435,544
42123,123,42,2020,38911,-98,3,-95,400,562
42125,125,42,2010,207944,141,14,155,497,536
42125,125,42,2011,208089,634,83,717,1931,2496
42125,125,42,2012,208350,597,114,711,2054,2464
42125,125,42,2013,208117,279,118,397,1983,2586
42125,125,42,2014,208050,291,154,445,2035,2499
42125,125,42,2015,207824,293,119,412,1992,2598
42125,125,42,2016,207469,84,107,191,1983,2515
42125,125,42,2017,207152,347,65,412,1944,2657
42125,125,42,2018,207114,474,59,533,1995,2558
42125,125,42,2019,206866,224,30,254,2011,2509
42125,125,42,2020,206803,568,33,601,2026,2691
42127,127,42,2010,52840,32,0,32,113,143
42127,127,42,2011,52732,71,5,76,411,593
42127,127,42,2012,52244,-317,1,-316,420,598
42127,127,42,2013,52204,187,7,194,411,644
42127,127,42,2014,52064,40,7,47,424,596
42127,127,42,2015,51828,-55,8,-47,424,607
42127,127,42,2016,51350,-308,6,-302,424,599
42127,127,42,2017,51193,97,2,99,402,654
42127,127,42,2018,51364,402,2,404,386,618
42127,127,42,2019,51271,118,1,119,386,597
42127,127,42,2020,51163,181,1,182,374,664
42129,129,42,2010,365029,170,15,185,824,994
42129,129,42,2011,364450,580,75,655,3187,4404
42129,129,42,2012,362825,-497,90,-407,3153,4317
42129,129,42,2013,360720,-921,80,-841,3181,4432
42129,129,42,2014,358931,-537,116,-421,3163,4473
42129,129,42,2015,357006,-561,102,-459,3194,4623
42129,129,42,2016,354763,-962,132,-830,3070,4465
42129,129,42,2017,352152,-893,86,-807,2931,4720
42129,129,42,2018,350600,-142,83,-59,3052,4526
42129,129,42,2019,348941,25,43,68,2844,4563
42129,129,42,2020,347087,45,43,88,2801,4744
42131,131,42,2010,28250,-28,0,-28,80,92
42131,131,42,2011,28319,24,18,42,298,271
42131,131,42,2012,28391,53,13,66,300,288
42131,131,42,2013,28144,-241,11,-230,288,308
42131,131,42,2014,28176,10,7,17,298,278
42131,131,42,2015,27822,-338,5,-333,289,311
42131,131,42,2016,27557,-214,7,-207,257,315
42131,131,42,2017,27409,-97,5,-92,266,321
42131,131,42,2018,27070,-251,4,-247,267,359
42131,131,42,2019,26790,-175,3,-172,228,337
42131,131,42,2020,26557,-118,3,-115,223,340
42133,133,42,2010,435420,97,99,196,1226,961
42133,133,42,2011,436749,-457,605,148,4945,3751
42133,133,42,2012,437551,-910,548,-362,4901,3673
42133,133,42,2013,439041,-58,620,562,4854,3866
42133,133,42,2014,440616,-205,743,538,4969,3840
42133,133,42,2015,441911,-73,620,547,4955,4154
42133,133,42,2016,444012,455,842,1297,4987,4154
42133,133,42,2017,445924,611,712,1323,4919,4296
42133,133,42,2018,448417,971,914,1885,4876,4244
42133,133,42,2019,449341,245,154,399,4638,4115
42133,133,42,2020,450448,643,282,925,4625,4460
44001,001,44,2010,49817,1,17,18,106,143
44001,001,44,2011,49238,-518,43,-475,359,471
44001,001,44,2012,49280,47,105,152,342,445
44001,001,44,2013,49266,59,68,127,343,482
44001,001,44,2014,49100,-75,77,2,354,520
44001,001,44,2015,49159,152,99,251,341,525
44001,001,44,2016,48866,-88,36,-52,314,554
44001,001,44,2017,48787,129,2,131,335,540
44001,001,44,2018,48696,62,30,92,343,522
44001,001,44,2019,48527,38,-10,28,308,504
44001,001,44,2020,48350,75,-4,71,310,558
44003,003,44,2010,166029,-139,93,-46,406,423
44003,003,44,2011,165288,-773,204,-569,1591,1762
44003,003,44,2012,164644,-669,122,-547,1623,1704
44003,003,44,2013,164387,-118,57,-61,1596,1769
44003,003,44,2014,164526,311,57,368,1527,1728
44003,003,44,2015,163801,-675,106,-569,1613,1759
44003,003,44,2016,163842,-67,182,115,1663,1727
44003,003,44,2017,163657,62,72,134,1516,1825
44003,003,44,2018,164230,585,187,772,1541,1738
44003,003,44,2019,164233,146,55,201,1505,1703
44003,003,44,2020,164646,660,43,703,1494,1788
44005,005,44,2010,83186,-97,127,30,177,157
44005,005,44,2011,83258,-195,213,18,738,681
44005,005,44,2012,83242,-444,400,-44,721,694
44005,005,44,2013,83576,53,275,328,697,677
44005,005,44,2014,83457,-292,218,-74,645,681
44005,005,44,2015,83496,-218,337,119,611,682
44005,005,44,2016,83454,-153,221,68,688,794
44005,005,44,2017,83099,-382,77,-305,692,739
44005,005,44,2018,82796,-418,137,-281,732,750
44005,005,44,2019,82472,-236,19,-217,699,805
44005,005,44,2020,81836,-492,39,-453,694,874
44007,007,44,2010,627868,-896,1410,514,1943,1371
44007,007,44,2011,629493,-3926,3951,25,7358,5765
44007,007,44,2012,631397,-3752,3745,-7,7399,5472
44007,007,44,2013,631836,-4727,3452,-1275,7336,5646
44007,007,44,2014,632995,-3557,3172,-385,7289,5701
44007,007,44,2015,634146,-4431,3993,-438,7448,5852
44007,007,44,2016,635384,-4222,3664,-558,7409,5612
44007,007,44,2017,634525,-4282,2078,-2204,7147,5800
44007,007,44,2018,637298,-2807,4133,1326,7247,5796
44007,007,44,2019,637052,-2792,1177,-1615,7087,5731
44007,007,44,2020,636547,-2776,1067,-1709,7081,5904
44009,009,44,2010,127094,-40,57,17,239,236
44009,009,44,2011,126552,-593,174,-419,952,1076
44009,009,44,2012,126330,-269,135,-134,921,1000
44009,009,44,2013,126495,259,86,345,901,1057
44009,009,44,2014,126433,39,83,122,911,1067
44009,009,44,2015,126284,145,119,264,861,1259
44009,009,44,2016,126270,94,139,233,901,1141
44009,009,44,2017,126486,425,53,478,887,1139
44009,009,44,2018,126318,56,144,200,874,1233
44009,009,44,2019,125874,-106,54,-52,860,1253
44009,009,44,2020,125746,299,48,347,868,1346
45001,001,45,2010,25338,-67,2,-65,65,90
45001,001,45,2011,25093,-192,6,-186,230,290
45001,001,45,2012,25033,-106,19,-87,281,252
45001,001,45,2013,24912,-113,0,-113,272,278
45001,001,45,2014,24811,-76,-3,-79,243,261
45001,001,45,2015,24814,80,-5,75,246,317
45001,001,45,2016,24688,-46,-2,-48,235,311
45001,001,45,2017,24598,13,1,14,209,311
45001,001,45,2018,24637,102,0,102,241,303
45001,001,45,2019,24584,9,2,11,237,301
45001,001,45,2020,24404,-99,0,-99,232,312
45003,003,45,2010,160558,316,29,345,464,388
45003,003,45,2011,161628,639,52,691,1926,1545
45003,003,45,2012,162982,880,87,967,1944,1549
45003,003,45,2013,163789,587,130,717,1786,1683
45003,003,45,2014,164333,235,159,394,1882,1696
45003,003,45,2015,165827,1018,243,1261,1926,1685
45003,003,45,2016,167328,1072,164,1236,1976,1706
45003,003,45,2017,168510,869,199,1068,1909,1785
45003,003,45,2018,169703,1057,210,1267,1878,1948
45003,003,45,2019,171300,1420,214,1634,1852,1890
45003,003,45,2020,172895,1593,183,1776,1845,2025
45005,005,45,2010,10354,-79,0,-79,20,11
45005,005,45,2011,10237,-129,1,-128,134,124
45005,005,45,2012,9982,-244,-2,-246,104,119
45005,005,45,2013,9828,-138,0,-138,89,105
45005,005,45,2014,9704,-107,1,-106,97,116
45005,005,45,2015,9435,-251,10,-241,91,121
45005,005,45,2016,9071,-338,2,-336,81,112
45005,005,45,2017,9010,-21,3,-18,75,118
45005,005,45,2018,8906,-60,4,-56,86,134
45005,005,45,2019,8627,-231,3,-228,69,120
45005,005,45,2020,8331,-250,3,-247,64,111
45007,007,45,2010,187095,58,36,94,529,434
45007,007,45,2011,188183,666,145,811,2233,1952
45007,007,45,2012,188860,336,155,491,2176,1947
45007,007,45,2013,190070,811,160,971,2282,2023
45007,007,45,2014,191872,1421,182,1603,2217,2023
45007,007,45,2015,193806,1570,137,1707,2295,2066
45007,007,45,2016,195672,1802,32,1834,2282,2247
45007,007,45,2017,198255,2427,47,2474,2359,2251
45007,007,45,2018,200209,1955,44,1999,2242,2288
45007,007,45,2019,202424,2190,81,2271,2211,2261
45007,007,45,2020,204353,2083,59,2142,2205,2414
45009,009,45,2010,15945,-37,0,-37,37,18
45009,009,45,2011,15809,-92,-5,-97,172,211
45009,009,45,2012,15683,-100,-9,-109,164,179
45009,009,45,2013,15389,-260,3,-257,154,197
45009,009,45,2014,15148,-246,1,-245,151,154
45009,009,45,2015,14676,-432,1,-431,135,182
45009,009,45,2016,14478,-137,13,-124,116,192
45009,009,45,2017,14402,-26,11,-15,134,194
45009,009,45,2018,14288,-69,14,-55,135,194
45009,009,45,2019,14108,-119,13,-106,134,207
45009,009,45,2020,13906,-146,11,-135,140,205
45011,011,45,2010,22639,-13,1,-12,68,36
45011,011,45,2011,22463,-235,0,-235,293,236
45011,011,45,2012,22362,-170,-2,-172,322,252
45011,011,45,2013,22217,-169,-1,-170,301,280
45011,011,45,2014,22032,-241,5,-236,314,265
45011,011,45,2015,21791,-240,5,-235,249,256
45011,011,45,2016,21610,-152,-3,-155,243,268
45011,011,45,2017,21362,-220,-3,-223,245,271
45011,011,45,2018,21150,-192,-4,-196,238,254
45011,011,45,2019,20924,-188,-5,-193,252,285
45011,011,45,2020,20805,-58,-4,-62,247,304
45013,013,45,2010,162843,298,163,461,512,359
45013,013,45,2011,163864,112,146,258,2076,1306
45013,013,45,2012,167423,1824,898,2722,2040,1262
45013,013,45,2013,171095,2494,469,2963,2031,1378
45013,013,45,2014,175318,3165,424,3589,2046,1506
45013,013,45,2015,180070,3541,575,4116,2081,1495
45013,013,45,2016,183808,2835,387,3222,2055,1552
45013,013,45,2017,186993,2549,300,2849,1927,1602
45013,013,45,2018,189563,1976,215,2191,1997,1617
45013,013,45,2019,192638,2564,356,2920,1865,1702
45013,013,45,2020,195656,2773,279,3052,1875,1894
45015,015,45,2010,179492,594,98,692,609,223
45015,015,45,2011,183833,2852,117,2969,2489,1136
45015,015,45,2012,189696,3628,707,4335,2588,1176
45015,015,45,2013,194171,2582,467,3049,2635,1255
45015,015,45,2014,198485,2533,463,2996,2559,1285
45015,015,45,2015,203313,2846,616,3462,2774,1438
45015,015,45,2016,208798,3750,410,4160,2716,1410
45015,015,45,2017,214938,4541,366,4907,2713,1508
45015,015,45,2018,221841,5374,304,5678,2740,1539
45015,015,45,2019,228952,5504,414,5918,2856,1653
45015,015,45,2020,235987,5675,346,6021,2873,1833
45017,017,45,2010,15098,-50,0,-50,41,73
45017,017,45,2011,15098,14,-1,13,146,158
45017,017,45,2012,14872,-243,-1,-244,166,156
45017,017,45,2013,14990,151,7,158,126,166
45017,017,45,2014,14844,-135,10,-125,149,171
45017,017,45,2015,14758,-36,6,-30,128,182
45017,017,45,2016,14754,3,0,3,150,156
45017,017,45,2017,14689,-7,0,-7,117,173
45017,017,45,2018,14530,-109,0,-109,143,193
45017,017,45,2019,14513,33,0,33,125,175
45017,017,45,2020,14554,110,1,111,124,194
45019,019,45,2010,350998,364,102,466,1108,754
45019,019,45,2011,357461,4383,143,4526,4787,2885
45019,019,45,2012,364913,4864,429,5293,4759,2810
45019,019,45,2013,372065,4861,382,5243,4624,2868
45019,019,45,2014,380239,5477,531,6008,4922,2960
45019,019,45,2015,389885,6922,648,7570,5079,3128
45019,019,45,2016,397433,5198,488,5686,4929,3106
45019,019,45,2017,402725,3113,521,3634,4932,3296
45019,019,45,2018,406959,2297,544,2841,4772,3392
45019,019,45,2019,412615,3527,589,4116,4941,3410
45019,019,45,2020,417981,3900,478,4378,4886,3890
45021,021,45,2010,55534,37,-2,35,188,166
45021,021,45,2011,55706,75,-12,63,690,580
45021,021,45,2012,55829,7,-15,-8,700,554
45021,021,45,2013,56065,193,-8,185,669,616
45021,021,45,2014,56361,259,-11,248,663,608
45021,021,45,2015,56534,132,3,135,676,633
45021,021,45,2016,56730,161,8,169,672,642
45021,021,45,2017,56974,211,11,222,652,626
45021,021,45,2018,57198,198,4,202,695,672
45021,021,45,2019,57331,222,11,233,641,742
45021,021,45,2020,57316,52,14,66,639,723
45023,023,45,2010,33163,-39,-1,-40,96,50
45023,023,45,2011,32884,-269,-6,-275,380,384
45023,023,45,2012,32708,-279,-4,-283,456,356
45023,023,45,2013,32744,0,-2,-2,412,368
45023,023,45,2014,32449,-239,-2,-241,370,425
45023,023,45,2015,32420,3,3,6,380,410
45023,023,45,2016,32299,-55,-2,-57,363,425
45023,023,45,2017,32300,71,-1,70,362,429
45023,023,45,2018,32281,53,0,53,361,431
45023,023,45,2019,32186,-9,0,-9,375,462
45023,023,45,2020,32232,159,-1,158,374,486
45025,025,45,2010,46612,-86,2,-84,115,138
45025,025,45,2011,46498,-164,12,-152,519,479
45025,025,45,2012,46078,-476,20,-456,505,473
45025,025,45,2013,46133,-5,42,37,515,491
45025,025,45,2014,46162,-35,36,1,529,493
45025,025,45,2015,46161,-31,22,-9,542,531
45025,025,45,2016,46134,0,7,7,502,533
45025,025,45,2017,45987,-125,20,-105,495,536
45025,025,45,2018,45807,-119,19,-100,475,553
45025,025,45,2019,45631,-162,13,-149,506,535
45025,025,45,2020,45606,87,16,103,475,603
45027,027,45,2010,34947,-14,2,-12,79,64
45027,027,45,2011,34711,-209,-7,-216,365,386
45027,027,45,2012,34329,-364,-7,-371,341,360
45027,027,45,2013,34267,-37,1,-36,352,372
45027,027,45,2014,34222,-5,3,-2,370,405
45027,027,45,2015,34037,-150,6,-144,343,384
45027,027,45,2016,34283,306,15,321,318,393
45027,027,45,2017,34053,-127,14,-113,304,419
45027,027,45,2018,33772,-207,15,-192,319,407
45027,027,45,2019,33803,129,18,147,321,436
45027,027,45,2020,33415,-262,15,-247,302,441
45029,029,45,2010,38886,-10,-1,-11,112,96
45029,029,45,2011,38447,-434,-10,-444,470,465
45029,029,45,2012,38106,-330,-10,-340,442,448
45029,029,45,2013,37666,-385,-6,-391,449,501
45029,029,45,2014,37529,-32,-16,-48,438,522
45029,029,45,2015,37444,0,-11,-11,458,527
45029,029,45,2016,37603,188,-10,178,477,496
45029,029,45,2017,37599,128,11,139,444,586
45029,029,45,2018,37731,196,-7,189,487,543
45029,029,45,2019,37705,83,17,100,438,561
45029,029,45,2020,37481,-79,16,-63,451,614
45031,031,45,2010,68513,-60,7,-53,183,213
45031,031,45,2011,68162,-395,48,-347,799,803
45031,031,45,2012,68053,-139,5,-134,793,762
45031,031,45,2013,67809,-199,12,-187,802,848
45031,031,45,2014,67660,-113,27,-86,739,790
45031,031,45,2015,67539,-142,28,-114,839,840
45031,031,45,2016,67310,-255,31,-224,831,833
45031,031,45,2017,67022,-157,34,-123,742,903
45031,031,45,2018,66793,-142,33,-109,760,877
45031,031,45,2019,66656,-50,37,-13,767,892
45031,031,45,2020,66509,-6,35,29,757,936
45033,033,45,2010,32080,37,1,38,121,135
45033,033,45,2011,31752,-468,23,-445,444,330
45033,033,45,2012,31529,-370,72,-298,427,360
45033,033,45,2013,31407,-257,54,-203,456,378
45033,033,45,2014,31290,-266,57,-209,425,334
45033,033,45,2015,31138,-181,29,-152,406,405
45033,033,45,2016,30695,-449,3,-446,402,400
45033,033,45,2017,30442,-247,8,-239,391,403
45033,033,45,2018,30509,-13,10,-3,412,341
45033,033,45,2019,30352,-223,10,-213,436,380
45033,033,45,2020,30367,20,8,28,404,418
45035,035,45,2010,137005,540,59,599,431,170
45035,035,45,2011,140155,2145,98,2243,1758,864
45035,035,45,2012,142645,1229,305,1534,1844,907
45035,035,45,2013,145614,1889,189,2078,1803,942
45035,035,45,2014,148854,2115,200,2315,1830,948
45035,035,45,2015,152946,2986,188,3174,1933,1047
45035,035,45,2016,156418,2582,210,2792,1812,1137
45035,035,45,2017,159533,2232,209,2441,1882,1210
45035,035,45,2018,161340,1052,231,1283,1750,1221
45035,035,45,2019,163517,1357,212,1569,1876,1268
45035,035,45,2020,165737,1562,183,1745,1835,1359
45037,037,45,2010,26965,-24,-2,-26,47,18
45037,037,45,2011,26894,-37,-5,-42,153,182
45037,037,45,2012,26563,-317,-8,-325,185,196
45037,037,45,2013,26573,1,-3,-2,212,196
45037,037,45,2014,26655,67,15,82,235,229
45037,037,45,2015,26789,151,18,169,204,237
45037,037,45,2016,26637,-138,8,-130,206,227
45037,037,45,2017,26846,228,12,240,194,223
45037,037,45,2018,27151,370,5,375,180,251
45037,037,45,2019,27349,218,13,231,195,228
45037,037,45,2020,27120,-136,16,-120,191,298
45039,039,45,2010,23860,-80,0,-80,60,100
45039,039,45,2011,23591,-245,16,-229,232,273
45039,039,45,2012,23425,-169,25,-144,242,264
45039,039,45,2013,23216,-175,22,-153,231,286
45039,039,45,2014,23050,-103,17,-86,213,290
45039,039,45,2015,22899,-83,22,-61,216,303
45039,039,45,2016,22651,-159,14,-145,201,304
45039,039,45,2017,22608,45,9,54,203,298
45039,039,45,2018,22392,-157,10,-147,224,292
45039,039,45,2019,22322,34,10,44,190,303
45039,039,45,2020,22059,-137,7,-130,193,326
45041,041,45,2010,137161,30,11,41,427,271
45041,041,45,2011,137670,135,34,169,1817,1471
45041,041,45,2012,138031,-55,47,-8,1837,1440
45041,041,45,2013,138230,-10,37,27,1776,1577
45041,041,45,2014,138837,218,65,283,1765,1412
45041,041,45,2015,138781,-418,82,-336,1735,1444
45041,041,45,2016,138665,-426,77,-349,1693,1455
45041,041,45,2017,138510,-244,64,-180,1603,1574
45041,041,45,2018,138294,-458,71,-387,1716,1545
45041,041,45,2019,138128,-153,68,-85,1594,1678
45041,041,45,2020,137588,-427,57,-370,1584,1759
45043,043,45,2010,60343,5,6,11,135,119
45043,043,45,2011,60192,-81,19,-62,586,671
45043,043,45,2012,60253,160,30,190,590,707
45043,043,45,2013,60503,375,21,396,602,744
45043,043,45,2014,60866,440,8,448,593,682
45043,043,45,2015,61506,760,17,777,569,710
45043,043,45,2016,61609,340,-2,338,555,787
45043,043,45,2017,61894,514,16,530,546,790
45043,043,45,2018,62462,768,20,788,555,775
45043,043,45,2019,63025,911,7,918,515,868
45043,043,45,2020,63353,738,13,751,520,939
45045,045,45,2010,452688,598,181,779,1536,814
45045,045,45,2011,458972,3171,743,3914,6103,3741
45045,045,45,2012,466172,3990,795,4785,6105,3745
45045,045,45,2013,473196,4012,883,4895,6035,3954
45045,045,45,2014,481737,5029,1182,6211,6202,3966
45045,045,45,2015,491218,5768,1415,7183,6415,4164
45045,045,45,2016,499595,4879,1392,6271,6355,4261
45045,045,45,2017,507484,4346,1639,5985,6325,4427
45045,045,45,2018,515572,4388,1866,6254,6307,4479
45045,045,45,2019,524748,5618,1860,7478,6269,4572
45045,045,45,2020,532486,4849,1499,6348,6276,4894
45047,047,45,2010,69759,-27,9,-18,237,137
45047,047,45,2011,69846,-190,33,-157,924,678
45047,047,45,2012,69966,-181,81,-100,890,658
45047,047,45,2013,69835,-376,73,-303,893,718
45047,047,45,2014,69686,-454,144,-310,876,721
45047,047,45,2015,69992,58,136,194,879,757
45047,047,45,2016,70175,106,67,173,765,751
45047,047,45,2017,70515,167,83,250,852,759
45047,047,45,2018,70633,123,80,203,795,877
45047,047,45,2019,70963,231,113,344,833,846
45047,047,45,2020,71074,101,88,189,801,883
45049,049,45,2010,21074,-57,1,-56,64,28
45049,049,45,2011,20798,-318,6,-312,240,205
45049,049,45,2012,20738,-80,-2,-82,222,198
45049,049,45,2013,20387,-320,0,-320,214,253
45049,049,45,2014,20433,16,5,21,220,190
45049,049,45,2015,19969,-466,4,-462,218,226
45049,049,45,2016,19804,-150,12,-138,207,234
45049,049,45,2017,19527,-256,15,-241,204,241
45049,049,45,2018,19416,-86,14,-72,207,246
45049,049,45,2019,19316,-55,14,-41,194,253
45049,049,45,2020,18053,-1183,12,-1171,188,272
45051,051,45,2010,270295,914,70,984,703,585
45051,051,45,2011,275545,4615,203,4818,3102,2697
45051,051,45,2012,281441,5159,245,5404,3081,2760
45051,051,45,2013,289005,6964,362,7326,2993,2926
45051,051,45,2014,298042,8164,420,8584,3191,3008
45051,051,45,2015,309350,10818,420,11238,3092,3204
45051,051,45,2016,321542,12050,285,12335,3192,3414
45051,051,45,2017,333246,11699,361,12060,3118,3558
45051,051,45,2018,344680,11532,386,11918,3204,3741
45051,051,45,2019,354418,10144,474,10618,3091,3950
45051,051,45,2020,365449,11943,359,12302,3135,4357
45053,053,45,2010,24949,119,21,140,73,68
45053,053,45,2011,25303,191,54,245,325,218
45053,053,45,2012,25743,268,34,302,327,193
45053,053,45,2013,26348,473,26,499,321,226
45053,053,45,2014,26712,212,26,238,335,215
45053,053,45,2015,27490,573,62,635,379,242
45053,053,45,2016,28122,457,53,510,348,229
45053,053,45,2017,28556,261,60,321,352,241
45053,053,45,2018,29228,519,60,579,365,273
45053,053,45,2019,30294,911,79,990,362,286
45053,053,45,2020,31588,1168,59,1227,372,302
45055,055,45,2010,61700,107,8,115,191,194
45055,055,45,2011,62125,229,22,251,725,549
45055,055,45,2012,62296,41,30,71,713,597
45055,055,45,2013,62601,273,26,299,708,697
45055,055,45,2014,63201,441,26,467,729,595
45055,055,45,2015,63677,393,29,422,718,663
45055,055,45,2016,64337,545,43,588,762,688
45055,055,45,2017,65219,731,41,772,769,657
45055,055,45,2018,65856,533,57,590,725,678
45055,055,45,2019,66748,833,25,858,757,721
45055,055,45,2020,67472,802,27,829,741,841
45057,057,45,2010,76976,230,5,235,205,130
45057,057,45,2011,77872,712,2,714,927,747
45057,057,45,2012,79350,1301,26,1327,884,763
45057,057,45,2013,80698,1185,64,1249,870,798
45057,057,45,2014,83499,2467,136,2603,957,837
45057,057,45,2015,86346,2559,85,2644,1057,889
45057,057,45,2016,89953,3349,39,3388,1079,878
45057,057,45,2017,92517,2390,37,2427,992,866
45057,057,45,2018,95213,2578,45,2623,1008,943
45057,057,45,2019,98280,2992,50,3042,1006,972
45057,057,45,2020,100926,2718,45,2763,1016,1123
45059,059,45,2010,66519,-60,5,-55,203,153
45059,059,45,2011,66462,-150,18,-132,811,733
45059,059,45,2012,66239,-236,16,-220,782,781
45059,059,45,2013,66177,59,21,80,738,873
45059,059,45,2014,66490,306,56,362,743,786
45059,059,45,2015,66459,23,54,77,733,833
45059,059,45,2016,66651,165,41,206,784,795
45059,059,45,2017,66858,274,59,333,772,894
45059,059,45,2018,66855,68,60,128,783,912
45059,059,45,2019,67448,639,72,711,799,916
45059,059,45,2020,67883,543,54,597,778,940
45061,061,45,2010,19221,-36,1,-35,48,18
45061,061,45,2011,18887,-248,-1,-249,164,251
45061,061,45,2012,18634,-225,-3,-228,200,230
45061,061,45,2013,18381,-221,0,-221,178,214
45061,061,45,2014,18339,-18,0,-18,182,202
45061,061,45,2015,17813,-476,1,-475,171,229
45061,061,45,2016,17508,-239,0,-239,174,242
45061,061,45,2017,17385,-39,-1,-40,179,261
45061,061,45,2018,17269,-22,-1,-23,177,269
45061,061,45,2019,16856,-350,0,-350,175,238
45061,061,45,2020,16701,-23,0,-23,167,299
45063,063,45,2010,263365,531,85,616,886,607
45063,063,45,2011,266409,1657,268,1925,3298,2180
45063,063,45,2012,269868,2055,340,2395,3190,2134
45063,063,45,2013,273363,2034,398,2432,3330,2270
45063,063,45,2014,277568,2720,511,3231,3167,2213
45063,063,45,2015,281855,2918,536,3454,3194,2374
45063,063,45,2016,286521,3439,320,3759,3312,2407
45063,063,45,2017,290511,2965,406,3371,3134,2513
45063,063,45,2018,294766,3179,451,3630,3263,2636
45063,063,45,2019,299421,3656,457,4113,3196,2645
45063,063,45,2020,303946,3798,378,4176,3202,2844
45065,065,45,2010,10210,14,0,14,19,50
45065,065,45,2011,10017,-139,-2,-141,57,111
45065,065,45,2012,9926,-23,-3,-26,52,116
45065,065,45,2013,9881,25,-2,23,57,123
45065,065,45,2014,9816,1,-2,-1,52,114
45065,065,45,2015,9671,-96,-1,-97,83,131
45065,065,45,2016,9597,-1,0,-1,62,134
45065,065,45,2017,9568,71,-1,70,47,145
45065,065,45,2018,9417,-57,-2,-59,52,143
45065,065,45,2019,9462,151,-3,148,48,150
45065,065,45,2020,9430,104,0,104,48,184
45067,067,45,2010,32951,-80,6,-74,112,145
45067,067,45,2011,32774,-211,7,-204,408,381
45067,067,45,2012,32398,-389,7,-382,421,424
45067,067,45,2013,32075,-284,18,-266,367,427
45067,067,45,2014,31947,-133,49,-84,402,440
45067,067,45,2015,31769,-160,35,-125,393,445
45067,067,45,2016,31772,-7,11,4,390,389
45067,067,45,2017,31288,-417,12,-405,362,442
45067,067,45,2018,30989,-213,5,-208,341,429
45067,067,45,2019,30565,-333,20,-313,335,446
45067,067,45,2020,30158,-254,15,-239,317,482
45069,069,45,2010,28918,-43,1,-42,78,52
45069,069,45,2011,28589,-319,8,-311,284,304
45069,069,45,2012,28263,-328,5,-323,308,318
45069,069,45,2013,28069,-133,11,-122,306,374
45069,069,45,2014,28049,5,10,15,319,351
45069,069,45,2015,27594,-409,11,-398,302,363
45069,069,45,2016,27023,-540,7,-533,338,380
45069,069,45,2017,26708,-223,4,-219,260,356
45069,069,45,2018,26413,-237,6,-231,290,354
45069,069,45,2019,26157,-200,6,-194,269,331
45069,069,45,2020,25581,-459,3,-456,271,388
45071,071,45,2010,37611,25,10,35,126,56
45071,071,45,2011,37507,-126,35,-91,435,447
45071,071,45,2012,37542,54,22,76,418,454
45071,071,45,2013,37474,-141,25,-116,454,401
45071,071,45,2014,37675,156,11,167,447,406
45071,071,45,2015,37787,98,17,115,446,446
45071,071,45,2016,37957,171,-8,163,470,461
45071,071,45,2017,38377,434,-5,429,429,439
45071,071,45,2018,38460,84,-2,82,426,424
45071,071,45,2019,38408,20,-9,11,385,447
45071,071,45,2020,38445,120,-1,119,412,497
45073,073,45,2010,74349,90,4,94,204,230
45073,073,45,2011,74265,-99,11,-88,800,793
45073,073,45,2012,74574,280,26,306,814,810
45073,073,45,2013,74962,391,82,473,792,879
45073,073,45,2014,75254,276,129,405,748,858
45073,073,45,2015,75908,573,133,706,822,876
45073,073,45,2016,76508,656,99,755,726,881
45073,073,45,2017,77382,884,123,1007,751,884
45073,073,45,2018,78215,975,136,1111,705,986
45073,073,45,2019,79450,1375,142,1517,697,977
45073,073,45,2020,80015,794,123,917,695,1045
45075,075,45,2010,92323,-234,5,-229,306,269
45075,075,45,2011,91706,-766,9,-757,1196,1056
45075,075,45,2012,91471,-436,20,-416,1144,957
45075,075,45,2013,90682,-836,26,-810,1066,1058
45075,075,45,2014,90058,-714,63,-651,1061,1036
45075,075,45,2015,89174,-881,57,-824,996,1062
45075,075,45,2016,88421,-703,34,-669,981,1063
45075,075,45,2017,87664,-733,32,-701,956,1012
45075,075,45,2018,87106,-518,44,-474,1010,1092
45075,075,45,2019,86231,-675,19,-656,951,1169
45075,075,45,2020,85343,-617,24,-593,942,1233
45077,077,45,2010,119344,-116,40,-76,288,248
45077,077,45,2011,119735,55,166,221,1210,1036
45077,077,45,2012,119863,-176,216,40,1203,1101
45077,077,45,2013,119333,-743,183,-560,1148,1126
45077,077,45,2014,120651,971,294,1265,1234,1190
45077,077,45,2015,121637,647,261,908,1291,1206
45077,077,45,2016,123180,1276,177,1453,1262,1176
45077,077,45,2017,123590,306,146,452,1160,1195
45077,077,45,2018,125176,1540,158,1698,1133,1252
45077,077,45,2019,126974,1647,176,1823,1252,1280
45077,077,45,2020,127983,1031,134,1165,1212,1369
45079,079,45,2010,385754,404,276,680,1212,566
45079,079,45,2011,389333,667,704,1371,4826,2611
45079,079,45,2012,393205,369,1416,1785,4893,2711
45079,079,45,2013,397015,1018,1055,2073,4746,2964
45079,079,45,2014,400688,852,1026,1878,4798,2946
45079,079,45,2015,406455,2566,1326,3892,4910,3040
45079,079,45,2016,409569,256,905,1161,4976,3011
45079,079,45,2017,412492,257,1032,1289,4685,3034
45079,079,45,2018,415159,11,1112,1123,4748,3199
45079,079,45,2019,417027,-680,1044,364,4658,3168
45079,079,45,2020,419051,-154,874,720,4713,3440
45081,081,45,2010,19905,15,6,21,55,27
45081,081,45,2011,19797,-142,-4,-146,240,202
45081,081,45,2012,19858,14,-5,9,272,215
45081,081,45,2013,20053,107,62,169,228,201
45081,081,45,2014,20061,-110,74,-36,254,206
45081,081,45,2015,20155,-7,65,58,278,241
45081,081,45,2016,20171,-20,15,-5,241,217
45081,081,45,2017,20262,98,3,101,216,227
45081,081,45,2018,20333,26,2,28,240,195
45081,081,45,2019,20381,17,7,24,222,198
45081,081,45,2020,20315,-63,8,-55,224,235
45083,083,45,2010,284769,117,46,163,901,593
45083,083,45,2011,286180,360,123,483,3683,2743
45083,083,45,2012,288283,1220,105,1325,3575,2764
45083,083,45,2013,290545,1508,142,1650,3516,2899
45083,083,45,2014,293146,1842,190,2032,3517,2939
45083,083,45,2015,296741,2841,269,3110,3569,3095
45083,083,45,2016,301027,3470,211,3681,3579,2979
45083,083,45,2017,306979,4990,271,5261,3776,3107
45083,083,45,2018,314490,6606,309,6915,3853,3273
45083,083,45,2019,320254,4787,309,5096,3947,3275
45083,083,45,2020,326205,5290,259,5549,3942,3518
45085,085,45,2010,107610,-105,60,-45,368,192
45085,085,45,2011,107316,-844,84,-760,1516,1052
45085,085,45,2012,107944,-183,246,63,1567,979
45085,085,45,2013,107840,-730,149,-581,1524,1044
45085,085,45,2014,107784,-711,169,-542,1507,1023
45085,085,45,2015,107346,-962,174,-788,1496,1153
45085,085,45,2016,107257,-502,87,-415,1426,1097
45085,085,45,2017,106604,-952,74,-878,1362,1138
45085,085,45,2018,106518,-325,49,-276,1376,1182
45085,085,45,2019,106635,-168,92,-76,1398,1206
45085,085,45,2020,106360,-517,74,-443,1366,1200
45087,087,45,2010,28914,-63,0,-63,78,58
45087,087,45,2011,28654,-202,-2,-204,308,364
45087,087,45,2012,28193,-377,-3,-380,299,386
45087,087,45,2013,27991,-119,0,-119,304,387
45087,087,45,2014,27912,-9,0,-9,317,381
45087,087,45,2015,27731,-112,-1,-113,317,383
45087,087,45,2016,27651,29,-1,28,320,427
45087,087,45,2017,27433,-127,-1,-128,313,401
45087,087,45,2018,27327,-51,-1,-52,314,367
45087,087,45,2019,27221,28,-1,27,279,411
45087,087,45,2020,26991,-100,-1,-101,280,411
45089,089,45,2010,34342,-64,2,-62,92,94
45089,089,45,2011,34101,-200,16,-184,355,412
45089,089,45,2012,33554,-523,15,-508,356,412
45089,089,45,2013,33069,-416,8,-408,333,418
45089,089,45,2014,32728,-295,35,-260,341,424
45089,089,45,2015,32515,-184,39,-145,350,418
45089,089,45,2016,31876,-555,13,-542,315,415
45089,089,45,2017,31185,-661,21,-640,360,415
45089,089,45,2018,30907,-137,25,-112,287,451
45089,089,45,2019,30256,-512,11,-501,288,437
45089,089,45,2020,29825,-271,15,-256,271,445
45091,091,45,2010,226871,465,27,492,743,416
45091,091,45,2011,230131,2113,87,2200,2843,1790
45091,091,45,2012,234151,2780,100,2880,2929,1839
45091,091,45,2013,238736,3376,154,3530,2887,1888
45091,091,45,2014,244661,4554,210,4764,2965,1913
45091,091,45,2015,250785,5070,216,5286,2872,2090
45091,091,45,2016,258140,6233,159,6392,2977,2040
45091,091,45,2017,266502,7198,230,7428,2985,2084
45091,091,45,2018,274188,6685,268,6953,2955,2235
45091,091,45,2019,281499,6248,313,6561,2948,2185
45091,091,45,2020,289105,6899,240,7139,2969,2465
46003,003,46,2010,2701,-1,0,-1,3,10
46003,003,46,2011,2716,5,0,5,34,24
46003,003,46,2012,2763,37,3,40,38,31
46003,003,46,2013,2716,-47,0,-47,29,29
46003,003,46,2014,2744,22,2,24,39,36
46003,003,46,2015,2745,-32,11,-21,45,23
46003,003,46,2016,2772,-17,17,0,49,23
46003,003,46,2017,2759,-36,14,-22,35,24
46003,003,46,2018,2775,11,1,12,44,40
46003,003,46,2019,2749,-43,7,-36,33,23
46003,003,46,2020,2730,-39,5,-34,38,24
46005,005,46,2010,17406,-4,9,5,68,65
46005,005,46,2011,17712,73,135,208,304,205
46005,005,46,2012,18003,47,153,200,294,200
46005,005,46,2013,18217,9,27,36,353,173
46005,005,46,2014,18073,-411,129,-282,317,191
46005,005,46,2015,18146,-296,214,-82,348,196
46005,005,46,2016,18154,-382,272,-110,318,201
46005,005,46,2017,18397,-216,340,124,322,203
46005,005,46,2018,18239,-343,78,-265,274,168
46005,005,46,2019,18389,-134,177,43,292,185
46005,005,46,2020,18513,-109,148,39,287,202
46007,007,46,2010,3451,5,0,5,21,7
46007,007,46,2011,3450,-31,0,-31,67,37
46007,007,46,2012,3451,-49,0,-49,82,33
46007,007,46,2013,3467,-28,0,-28,69,25
46007,007,46,2014,3440,-72,0,-72,71,29
46007,007,46,2015,3407,-51,0,-51,55,38
46007,007,46,2016,3458,-2,2,0,82,30
46007,007,46,2017,3447,-22,2,-20,56,46
46007,007,46,2018,3482,11,0,11,70,46
46007,007,46,2019,3364,-136,1,-135,42,26
46007,007,46,2020,3399,18,1,19,46,30
46009,009,46,2010,7061,2,0,2,17,25
46009,009,46,2011,7016,-45,3,-42,63,66
46009,009,46,2012,7028,15,4,19,66,71
46009,009,46,2013,6982,-23,0,-23,67,88
46009,009,46,2014,6977,-1,0,-1,58,63
46009,009,46,2015,6942,-26,3,-23,62,72
46009,009,46,2016,6939,18,0,18,69,91
46009,009,46,2017,6955,13,0,13,69,67
46009,009,46,2018,6919,-13,0,-13,70,92
46009,009,46,2019,6911,-8,0,-8,70,70
46009,009,46,2020,6848,-57,0,-57,71,77
46011,011,46,2010,32003,-11,11,0,94,54
46011,011,46,2011,32151,-130,94,-36,368,185
46011,011,46,2012,32799,274,178,452,394,205
46011,011,46,2013,33059,42,12,54,409,197
46011,011,46,2014,33304,-99,117,18,425,197
46011,011,46,2015,33861,147,165,312,441,194
46011,011,46,2016,34371,-128,377,249,445,181
46011,011,46,2017,34871,-166,438,272,432,204
46011,011,46,2018,35266,9,110,119,461,186
46011,011,46,2019,35463,-332,309,-23,409,190
46011,011,46,2020,35603,-301,239,-62,419,217
46013,013,46,2010,36655,67,11,78,126,82
46013,013,46,2011,36932,58,89,147,498,366
46013,013,46,2012,37578,388,178,566,453,387
46013,013,46,2013,38149,406,21,427,519,379
46013,013,46,2014,38278,-38,68,30,494,390
46013,013,46,2015,38434,-3,77,74,484,398
46013,013,46,2016,38884,151,149,300,512,360
46013,013,46,2017,39332,20,240,260,555,365
46013,013,46,2018,39103,-431,71,-360,500,370
46013,013,46,2019,38883,-523,139,-384,491,328
46013,013,46,2020,38738,-391,123,-268,477,354
46015,015,46,2010,5282,9,0,9,32,15
46015,015,46,2011,5296,6,0,6,68,59
46015,015,46,2012,5292,-17,0,-17,82,69
46015,015,46,2013,5356,52,0,52,69,57
46015,015,46,2014,5277,-100,0,-100,72,53
46015,015,46,2015,5239,-60,0,-60,78,56
46015,015,46,2016,5202,-50,1,-49,61,51
46015,015,46,2017,5300,84,2,86,74,61
46015,015,46,2018,5185,-151,0,-151,72,37
46015,015,46,2019,5222,8,2,10,72,44
46015,015,46,2020,5254,18,0,18,65,50
46017,017,46,2010,1934,15,0,15,6,1
46017,017,46,2011,1979,10,0,10,52,17
46017,017,46,2012,2016,-4,0,-4,59,17
46017,017,46,2013,2025,-19,0,-19,45,17
46017,017,46,2014,2087,20,0,20,56,14
46017,017,46,2015,2099,-21,0,-21,51,19
46017,017,46,2016,2035,-78,0,-78,49,34
46017,017,46,2017,2014,-42,0,-42,50,29
46017,017,46,2018,2039,12,0,12,32,17
46017,017,46,2019,1982,-60,0,-60,30,27
46017,017,46,2020,1956,-28,0,-28,31,30
46019,019,46,2010,10144,16,0,16,30,14
46019,019,46,2011,10312,139,0,139,131,102
46019,019,46,2012,10222,-86,-1,-87,126,128
46019,019,46,2013,10288,43,-2,41,127,102
46019,019,46,2014,10254,-78,-2,-80,141,96
46019,019,46,2015,10219,-49,0,-49,120,105
46019,019,46,2016,10130,-91,-1,-92,110,107
46019,019,46,2017,10128,-29,0,-29,135,106
46019,019,46,2018,10259,101,0,101,138,109
46019,019,46,2019,10418,137,0,137,138,116
46019,019,46,2020,10538,103,0,103,135,117
46021,021,46,2010,1471,4,0,4,3,2
46021,021,46,2011,1425,-45,0,-45,15,17
46021,021,46,2012,1406,-8,3,-5,3,17
46021,021,46,2013,1369,-33,0,-33,14,18
46021,021,46,2014,1402,32,1,33,9,9
46021,021,46,2015,1414,7,1,8,18,14
46021,021,46,2016,1387,-26,3,-23,10,15
46021,021,46,2017,1373,-11,1,-10,12,16
46021,021,46,2018,1377,6,0,6,13,15
46021,021,46,2019,1380,3,1,4,12,13
46021,021,46,2020,1380,-4,1,-3,12,9
46023,023,46,2010,9153,0,0,0,34,11
46023,023,46,2011,9187,-2,0,-2,146,109
46023,023,46,2012,9192,-72,2,-70,167,93
46023,023,46,2013,9184,-84,0,-84,156,79
46023,023,46,2014,9238,0,0,0,150,93
46023,023,46,2015,9359,54,0,54,182,116
46023,023,46,2016,9363,-27,-1,-28,165,133
46023,023,46,2017,9402,-6,-1,-7,153,107
46023,023,46,2018,9309,-141,-1,-142,157,108
46023,023,46,2019,9286,-85,-1,-86,154,92
46023,023,46,2020,9262,-59,0,-59,147,112
46025,025,46,2010,3698,0,0,0,15,8
46025,025,46,2011,3597,-99,17,-82,45,64
46025,025,46,2012,3596,-3,19,16,35,51
46025,025,46,2013,3627,24,1,25,49,44
46025,025,46,2014,3651,10,8,18,59,53
46025,025,46,2015,3652,-33,3,-30,67,35
46025,025,46,2016,3634,-34,4,-30,62,50
46025,025,46,2017,3677,5,11,16,66,38
46025,025,46,2018,3721,11,17,28,68,50
46025,025,46,2019,3740,-20,-1,-21,65,25
46025,025,46,2020,3802,26,4,30,67,35
46027,027,46,2010,13830,-28,-2,-30,29,35
46027,027,46,2011,13993,81,13,94,157,89
46027,027,46,2012,14077,-8,50,42,143,99
46027,027,46,2013,13914,-218,-1,-219,159,111
46027,027,46,2014,13907,-120,27,-93,165,81
46027,027,46,2015,13798,-150,23,-127,128,111
46027,027,46,2016,13980,64,72,136,155,109
46027,027,46,2017,14075,-19,67,48,150,103
46027,027,46,2018,13985,-111,-1,-112,138,115
46027,027,46,2019,14096,21,40,61,127,77
46027,027,46,2020,14246,80,27,107,130,88
46029,029,46,2010,27212,-37,3,-34,93,71
46029,029,46,2011,27431,72,20,92,369,241
46029,029,46,2012,27629,43,38,81,380,259
46029,029,46,2013,27864,82,1,83,367,210
46029,029,46,2014,27958,-70,7,-63,423,262
46029,029,46,2015,27907,-197,14,-183,367,235
46029,029,46,2016,28069,-4,38,34,372,243
46029,029,46,2017,28219,-83,117,34,368,253
46029,029,46,2018,28098,-234,17,-217,324,229
46029,029,46,2019,28092,-134,62,-72,313,248
46029,029,46,2020,28186,0,49,49,309,265
46031,031,46,2010,4064,18,0,18,20,15
46031,031,46,2011,4034,-60,0,-60,79,50
46031,031,46,2012,4067,-9,3,-6,82,41
46031,031,46,2013,4206,93,0,93,88,46
46031,031,46,2014,4170,-82,1,-81,94,51
46031,031,46,2015,4172,-57,2,-55,90,35
46031,031,46,2016,4098,-100,1,-99,81,56
46031,031,46,2017,4187,32,0,32,108,50
46031,031,46,2018,4137,-86,0,-86,88,52
46031,031,46,2019,4076,-132,0,-132,107,35
46031,031,46,2020,4031,-70,0,-70,91,66
46033,033,46,2010,8275,40,0,40,24,11
46033,033,46,2011,8346,78,0,78,80,87
46033,033,46,2012,8316,-8,0,-8,69,90
46033,033,46,2013,8408,105,1,106,68,85
46033,033,46,2014,8435,21,2,23,70,64
46033,033,46,2015,8456,36,3,39,73,92
46033,033,46,2016,8614,191,8,199,70,113
46033,033,46,2017,8747,83,70,153,81,100
46033,033,46,2018,8821,84,2,86,72,83
46033,033,46,2019,8929,142,7,149,69,109
46033,033,46,2020,9017,109,6,115,69,94
46035,035,46,2010,19484,-3,-2,-5,62,76
46035,035,46,2011,19723,7,165,172,245,176
46035,035,46,2012,19958,113,81,194,264,223
46035,035,46,2013,19950,-71,-5,-76,271,200
46035,035,46,2014,19974,-44,-7,-51,270,193
46035,035,46,2015,19922,-44,-5,-49,240,242
46035,035,46,2016,20034,61,9,70,260,218
46035,035,46,2017,19893,-187,13,-174,247,214
46035,035,46,2018,19847,-66,-3,-69,251,229
46035,035,46,2019,19865,-9,8,-1,246,227
46035,035,46,2020,19812,-113,5,-108,260,205
46037,037,46,2010,5710,11,1,12,18,30
46037,037,46,2011,5743,23,3,26,73,66
46037,037,46,2012,5600,-133,6,-127,60,78
46037,037,46,2013,5583,2,1,3,63,82
46037,037,46,2014,5510,-63,3,-60,53,67
46037,037,46,2015,5504,-5,2,-3,68,70
46037,037,46,2016,5515,11,2,13,59,61
46037,037,46,2017,5498,24,1,25,51,91
46037,037,46,2018,5487,9,0,9,68,88
46037,037,46,2019,5414,-71,1,-70,63,66
46037,037,46,2020,5345,-49,1,-48,61,81
46039,039,46,2010,4350,-11,0,-11,12,15
46039,039,46,2011,4368,-13,19,6,50,38
46039,039,46,2012,4376,8,11,19,38,49
46039,039,46,2013,4312,-84,0,-84,52,34
46039,039,46,2014,4323,-5,3,-2,53,39
46039,039,46,2015,4326,3,2,5,46,48
46039,039,46,2016,4244,-84,2,-82,46,46
46039,039,46,2017,4302,24,25,49,60,50
46039,039,46,2018,4317,18,0,18,52,55
46039,039,46,2019,4334,-10,4,-6,54,31
46039,039,46,2020,4346,-5,3,-2,56,41
46041,041,46,2010,5325,11,0,11,32,18
46041,041,46,2011,5396,9,1,10,114,52
46041,041,46,2012,5532,32,0,32,152,50
46041,041,46,2013,5584,-4,0,-4,140,83
46041,041,46,2014,5666,-15,0,-15,158,61
46041,041,46,2015,5702,-46,0,-46,150,67
46041,041,46,2016,5787,-15,0,-15,160,59
46041,041,46,2017,5854,-18,0,-18,147,62
46041,041,46,2018,5904,-37,0,-37,149,64
46041,041,46,2019,5872,-108,0,-108,133,57
46041,041,46,2020,5789,-134,0,-134,127,76
46043,043,46,2010,2991,-7,1,-6,5,6
46043,043,46,2011,2970,-3,1,-2,37,55
46043,043,46,2012,2944,-7,0,-7,30,49
46043,043,46,2013,2969,27,1,28,33,34
46043,043,46,2014,2924,-41,2,-39,39,47
46043,043,46,2015,2947,21,7,28,44,48
46043,043,46,2016,2911,-54,12,-42,44,38
46043,043,46,2017,2914,0,10,10,38,44
46043,043,46,2018,2919,-18,2,-16,58,37
46043,043,46,2019,2911,-16,8,-8,37,37
46043,043,46,2020,2906,-18,6,-12,43,35
46045,045,46,2010,4066,2,0,2,11,18
46045,045,46,2011,4042,-10,0,-10,34,47
46045,045,46,2012,4013,-19,0,-19,44,53
46045,045,46,2013,4026,17,1,18,55,59
46045,045,46,2014,3972,-75,4,-71,45,30
46045,045,46,2015,3998,7,7,14,51,39
46045,045,46,2016,3937,-72,12,-60,41,42
46045,045,46,2017,3915,-27,9,-18,49,52
46045,045,46,2018,3853,-56,2,-54,33,42
46045,045,46,2019,3857,-16,5,-11,45,29
46045,045,46,2020,3817,-49,5,-44,39,34
46047,047,46,2010,7115,25,1,26,8,13
46047,047,46,2011,6960,-91,2,-89,51,117
46047,047,46,2012,6974,73,1,74,53,115
46047,047,46,2013,6811,-117,0,-117,69,117
46047,047,46,2014,6849,112,1,113,52,127
46047,047,46,2015,6809,4,7,11,75,125
46047,047,46,2016,6779,19,11,30,56,117
46047,047,46,2017,6698,-22,11,-11,55,124
46047,047,46,2018,6730,90,2,92,49,110
46047,047,46,2019,6688,19,8,27,48,116
46047,047,46,2020,6708,73,7,80,46,105
46049,049,46,2010,2368,3,0,3,5,5
46049,049,46,2011,2355,-15,-1,-16,29,26
46049,049,46,2012,2355,4,-1,3,23,26
46049,049,46,2013,2350,-11,-1,-12,31,23
46049,049,46,2014,2321,-23,0,-23,29,35
46049,049,46,2015,2310,-8,1,-7,32,36
46049,049,46,2016,2318,16,1,17,30,38
46049,049,46,2017,2324,-7,0,-7,39,26
46049,049,46,2018,2320,-8,0,-8,33,29
46049,049,46,2019,2307,-20,0,-20,34,27
46049,049,46,2020,2306,-12,0,-12,31,19
46051,051,46,2010,7351,-8,-1,-9,23,22
46051,051,46,2011,7358,-106,113,7,72,73
46051,051,46,2012,7401,-32,75,43,72,72
46051,051,46,2013,7390,-13,4,-9,89,90
46051,051,46,2014,7315,-66,1,-65,79,92
46051,051,46,2015,7221,-104,-2,-106,92,82
46051,051,46,2016,7223,13,4,17,80,94
46051,051,46,2017,7179,-46,16,-30,77,90
46051,051,46,2018,7123,-60,1,-59,92,90
46051,051,46,2019,7102,-31,10,-21,75,76
46051,051,46,2020,7000,-97,7,-90,76,87
46053,053,46,2010,4270,0,0,0,13,14
46053,053,46,2011,4223,-31,-1,-32,55,69
46053,053,46,2012,4247,49,0,49,36,62
46053,053,46,2013,4234,8,0,8,47,66
46053,053,46,2014,4227,13,0,13,51,70
46053,053,46,2015,4195,-17,0,-17,56,70
46053,053,46,2016,4157,-28,0,-28,50,60
46053,053,46,2017,4207,46,0,46,57,54
46053,053,46,2018,4197,-14,0,-14,57,52
46053,053,46,2019,4183,-2,0,-2,44,56
46053,053,46,2020,4219,43,0,43,49,56
46055,055,46,2010,1930,-11,0,-11,7,4
46055,055,46,2011,1918,-8,0,-8,21,25
46055,055,46,2012,1922,6,0,6,20,22
46055,055,46,2013,1880,-27,0,-27,18,33
46055,055,46,2014,1845,-23,0,-23,19,32
46055,055,46,2015,1849,8,0,8,23,27
46055,055,46,2016,1884,30,0,30,23,18
46055,055,46,2017,1919,47,0,47,17,28
46055,055,46,2018,1888,-27,0,-27,26,29
46055,055,46,2019,1866,-17,0,-17,16,21
46055,055,46,2020,1861,-8,0,-8,17,13
46057,057,46,2010,5915,7,0,7,29,19
46057,057,46,2011,5964,-25,40,15,112,79
46057,057,46,2012,5946,-82,23,-59,115,75
46057,057,46,2013,5927,-61,1,-60,114,75
46057,057,46,2014,5952,-42,0,-42,126,59
46057,057,46,2015,5977,-31,1,-30,120,64
46057,057,46,2016,5916,-110,5,-105,109,65
46057,057,46,2017,6032,25,35,60,123,67
46057,057,46,2018,6113,18,3,21,113,53
46057,057,46,2019,6224,38,8,46,129,63
46057,057,46,2020,6234,-68,7,-61,131,61
46059,059,46,2010,3434,7,0,7,12,15
46059,059,46,2011,3435,-2,5,3,45,48
46059,059,46,2012,3377,-56,2,-54,31,38
46059,059,46,2013,3375,15,0,15,33,50
46059,059,46,2014,3340,-33,0,-33,39,42
46059,059,46,2015,3305,-22,0,-22,30,43
46059,059,46,2016,3275,-5,0,-5,31,56
46059,059,46,2017,3273,-4,0,-4,45,42
46059,059,46,2018,3234,-32,0,-32,39,45
46059,059,46,2019,3170,-60,0,-60,31,36
46059,059,46,2020,3127,-46,0,-46,30,27
46061,061,46,2010,3331,3,0,3,8,11
46061,061,46,2011,3375,12,0,12,51,20
46061,061,46,2012,3381,-22,0,-22,45,19
46061,061,46,2013,3403,-9,-1,-10,49,15
46061,061,46,2014,3422,-16,-1,-17,62,26
46061,061,46,2015,3388,-38,0,-38,37,33
46061,061,46,2016,3385,-21,0,-21,37,18
46061,061,46,2017,3411,6,0,6,45,25
46061,061,46,2018,3369,-50,0,-50,39,31
46061,061,46,2019,3463,66,0,66,38,11
46061,061,46,2020,3489,-5,0,-5,44,13
46063,063,46,2010,1246,-10,1,-9,3,4
46063,063,46,2011,1275,24,5,29,14,15
46063,063,46,2012,1304,21,6,27,10,8
46063,063,46,2013,1259,-59,0,-59,18,6
46063,063,46,2014,1245,-26,0,-26,18,7
46063,063,46,2015,1269,8,2,10,22,7
46063,063,46,2016,1266,-20,2,-18,17,5
46063,063,46,2017,1243,-29,2,-27,15,10
46063,063,46,2018,1252,3,0,3,14,8
46063,063,46,2019,1307,40,0,40,18,4
46063,063,46,2020,1311,-4,0,-4,16,7
46065,065,46,2010,17077,23,0,23,53,22
46065,065,46,2011,17317,128,2,130,248,138
46065,065,46,2012,17445,54,-7,47,228,147
46065,065,46,2013,17444,-108,-3,-111,239,131
46065,065,46,2014,17647,84,-5,79,254,126
46065,065,46,2015,17579,-162,2,-160,232,140
46065,065,46,2016,17615,-51,6,-45,228,146
46065,065,46,2017,17697,18,5,23,230,170
46065,065,46,2018,17663,-108,-1,-109,232,158
46065,065,46,2019,17487,-250,4,-246,243,173
46065,065,46,2020,17336,-182,3,-179,224,195
46067,067,46,2010,7339,8,0,8,24,39
46067,067,46,2011,7249,-47,1,-46,67,112
46067,067,46,2012,7257,9,6,15,96,102
46067,067,46,2013,7192,-34,1,-33,82,113
46067,067,46,2014,7229,35,5,40,105,108
46067,067,46,2015,7270,42,6,48,113,119
46067,067,46,2016,7331,55,1,56,124,119
46067,067,46,2017,7347,-5,18,13,119,115
46067,067,46,2018,7292,-63,7,-56,107,106
46067,067,46,2019,7287,-20,-1,-21,119,101
46067,067,46,2020,7282,-21,1,-20,112,97
46069,069,46,2010,1422,1,0,1,3,2
46069,069,46,2011,1399,-18,0,-18,13,19
46069,069,46,2012,1429,31,1,32,15,16
46069,069,46,2013,1379,-39,0,-39,10,23
46069,069,46,2014,1393,9,0,9,18,13
46069,069,46,2015,1387,-3,0,-3,18,20
46069,069,46,2016,1330,-48,0,-48,15,24
46069,069,46,2017,1299,-25,0,-25,19,27
46069,069,46,2018,1265,-26,0,-26,15,23
46069,069,46,2019,1295,27,0,27,18,14
46069,069,46,2020,1281,-15,0,-15,16,15
46071,071,46,2010,3049,3,0,3,17,2
46071,071,46,2011,3158,64,2,66,72,29
46071,071,46,2012,3174,-23,7,-16,75,41
46071,071,46,2013,3236,21,1,22,71,29
46071,071,46,2014,3273,-11,4,-7,75,33
46071,071,46,2015,3281,-19,0,-19,72,45
46071,071,46,2016,3271,-37,1,-36,61,35
46071,071,46,2017,3277,-55,2,-53,94,36
46071,071,46,2018,3277,-46,0,-46,84,38
46071,071,46,2019,3335,7,2,9,69,19
46071,071,46,2020,3321,-66,1,-65,69,18
46073,073,46,2010,2091,16,0,16,7,4
46073,073,46,2011,2075,-9,0,-9,25,30
46073,073,46,2012,2056,-21,3,-18,24,26
46073,073,46,2013,2073,26,2,28,24,35
46073,073,46,2014,2042,-48,3,-45,33,21
46073,073,46,2015,2021,-15,5,-10,21,32
46073,073,46,2016,2007,-18,6,-12,18,18
46073,073,46,2017,2020,20,6,26,19,33
46073,073,46,2018,2017,11,1,12,18,33
46073,073,46,2019,2014,-8,4,-4,23,22
46073,073,46,2020,1985,-31,4,-27,25,26
46075,075,46,2010,1011,5,0,5,1,1
46075,075,46,2011,1004,-13,0,-13,17,11
46075,075,46,2012,991,-12,0,-12,9,10
46075,075,46,2013,972,-14,0,-14,6,11
46075,075,46,2014,956,-20,0,-20,11,8
46075,075,46,2015,917,-41,0,-41,12,11
46075,075,46,2016,929,13,0,13,11,12
46075,075,46,2017,918,-7,0,-7,10,13
46075,075,46,2018,924,4,0,4,11,9
46075,075,46,2019,911,-18,0,-18,14,8
46075,075,46,2020,938,19,0,19,14,6
46077,077,46,2010,5132,1,1,2,11,28
46077,077,46,2011,5167,44,0,44,65,74
46077,077,46,2012,5229,61,4,65,59,64
46077,077,46,2013,5064,-165,1,-164,63,68
46077,077,46,2014,5051,7,3,10,52,75
46077,077,46,2015,4951,-100,0,-100,73,73
46077,077,46,2016,4970,15,2,17,66,64
46077,077,46,2017,4922,-34,3,-31,60,77
46077,077,46,2018,4896,-39,5,-34,71,64
46077,077,46,2019,4907,-7,0,-7,60,42
46077,077,46,2020,4987,70,1,71,61,52
46079,079,46,2010,11278,45,6,51,39,18
46079,079,46,2011,11563,252,24,276,116,109
46079,079,46,2012,11757,117,46,163,146,118
46079,079,46,2013,11921,142,-2,140,120,99
46079,079,46,2014,12101,158,0,158,140,122
46079,079,46,2015,12350,229,-1,228,127,109
46079,079,46,2016,12621,244,5,249,134,112
46079,079,46,2017,12814,191,13,204,127,139
46079,079,46,2018,13045,233,0,233,125,128
46079,079,46,2019,12769,-322,4,-318,129,86
46079,079,46,2020,12488,-300,2,-298,122,103
46081,081,46,2010,24204,70,-1,69,73,31
46081,081,46,2011,24335,99,-4,95,244,208
46081,081,46,2012,24418,70,21,91,219,228
46081,081,46,2013,24962,546,-7,539,232,242
46081,081,46,2014,24759,-242,14,-228,247,228
46081,081,46,2015,24862,89,32,121,217,234
46081,081,46,2016,25389,371,130,501,256,230
46081,081,46,2017,25736,238,145,383,219,254
46081,081,46,2018,25776,38,23,61,235,254
46081,081,46,2019,25908,43,102,145,199,213
46081,081,46,2020,26221,260,80,340,204,230
46083,083,46,2010,45185,159,2,161,221,43
46083,083,46,2011,46808,1069,4,1073,755,214
46083,083,46,2012,48414,937,18,955,835,211
46083,083,46,2013,49918,893,0,893,786,195
46083,083,46,2014,51601,1056,8,1064,783,194
46083,083,46,2015,52997,817,9,826,773,210
46083,083,46,2016,54568,1042,39,1081,735,251
46083,083,46,2017,56732,1532,29,1561,869,276
46083,083,46,2018,58881,1594,-19,1575,827,259
46083,083,46,2019,61235,1782,12,1794,843,280
46083,083,46,2020,63019,1219,5,1224,854,292
46085,085,46,2010,3761,1,0,1,9,4
46085,085,46,2011,3808,13,0,13,83,49
46085,085,46,2012,3775,-58,0,-58,63,40
46085,085,46,2013,3843,44,0,44,58,35
46085,085,46,2014,3852,-45,0,-45,78,25
46085,085,46,2015,3875,-6,0,-6,65,36
46085,085,46,2016,3905,-13,0,-13,87,43
46085,085,46,2017,3869,-73,0,-73,70,33
46085,085,46,2018,3796,-101,0,-101,62,33
46085,085,46,2019,3787,-41,0,-41,64,32
46085,085,46,2020,3797,-42,0,-42,68,16
46087,087,46,2010,5609,2,3,5,19,32
46087,087,46,2011,5539,-91,8,-83,80,67
46087,087,46,2012,5565,34,15,49,63,85
46087,087,46,2013,5595,9,2,11,79,59
46087,087,46,2014,5549,-41,0,-41,73,79
46087,087,46,2015,5485,-59,9,-50,78,92
46087,087,46,2016,5513,6,11,17,87,76
46087,087,46,2017,5549,12,17,29,71,64
46087,087,46,2018,5572,5,3,8,90,75
46087,087,46,2019,5560,-49,15,-34,82,59
46087,087,46,2020,5520,-67,11,-56,90,75
46089,089,46,2010,2455,-2,0,-2,3,4
46089,089,46,2011,2451,5,0,5,25,36
46089,089,46,2012,2428,-11,0,-11,25,37
46089,089,46,2013,2425,18,-1,17,21,41
46089,089,46,2014,2420,4,0,4,29,38
46089,089,46,2015,2399,-3,-1,-4,25,42
46089,089,46,2016,2414,30,0,30,19,33
46089,089,46,2017,2403,7,0,7,27,44
46089,089,46,2018,2405,10,0,10,20,28
46089,089,46,2019,2388,-15,0,-15,25,27
46089,089,46,2020,2363,-20,0,-20,25,30
46091,091,46,2010,4643,1,0,1,15,28
46091,091,46,2011,4627,-60,40,-20,60,56
46091,091,46,2012,4694,48,33,81,51,66
46091,091,46,2013,4802,89,2,91,64,47
46091,091,46,2014,4734,-94,0,-94,69,44
46091,091,46,2015,4830,51,28,79,66,49
46091,091,46,2016,4835,-22,9,-13,72,53
46091,091,46,2017,4898,-9,52,43,77,56
46091,091,46,2018,4873,-62,-1,-63,75,37
46091,091,46,2019,4913,-6,8,2,62,25
46091,091,46,2020,4884,-49,3,-46,67,49
46093,093,46,2010,25478,-24,20,-4,78,26
46093,093,46,2011,25504,-120,12,-108,310,176
46093,093,46,2012,25851,63,133,196,315,160
46093,093,46,2013,26417,363,46,409,346,196
46093,093,46,2014,26737,147,50,197,311,193
46093,093,46,2015,26794,-115,61,-54,309,197
46093,093,46,2016,27374,411,46,457,294,172
46093,093,46,2017,28007,541,51,592,253,218
46093,093,46,2018,28305,254,-15,239,281,223
46093,093,46,2019,28469,108,26,134,244,215
46093,093,46,2020,28588,68,26,94,253,227
46095,095,46,2010,2026,-5,0,-5,5,17
46095,095,46,2011,2073,23,0,23,43,19
46095,095,46,2012,2052,-19,2,-17,22,26
46095,095,46,2013,2048,-15,0,-15,32,22
46095,095,46,2014,2068,7,1,8,27,16
46095,095,46,2015,2027,-65,0,-65,50,25
46095,095,46,2016,2071,36,0,36,35,27
46095,095,46,2017,2066,-21,0,-21,48,32
46095,095,46,2018,2032,-39,0,-39,39,34
46095,095,46,2019,2068,24,0,24,31,19
46095,095,46,2020,2089,14,0,14,31,23
46097,097,46,2010,2374,-7,0,-7,3,12
46097,097,46,2011,2325,-32,0,-32,19,36
46097,097,46,2012,2298,-10,0,-10,23,40
46097,097,46,2013,2312,15,0,15,25,25
46097,097,46,2014,2281,-21,1,-20,23,35
46097,097,46,2015,2208,-70,0,-70,28,31
46097,097,46,2016,2233,31,-1,30,30,35
46097,097,46,2017,2200,-16,-1,-17,17,33
46097,097,46,2018,2211,10,-1,9,32,30
46097,097,46,2019,2221,18,-1,17,23,29
46097,097,46,2020,2202,-19,-1,-20,24,23
46099,099,46,2010,169964,12,107,119,742,353
46099,099,46,2011,171482,-350,424,74,2758,1309
46099,099,46,2012,174825,968,846,1814,2790,1282
46099,099,46,2013,178062,1573,109,1682,2763,1243
46099,099,46,2014,180925,594,606,1200,2964,1300
46099,099,46,2015,183563,260,799,1059,2973,1377
46099,099,46,2016,186562,-235,1551,1316,3036,1343
46099,099,46,2017,189786,253,1514,1767,2903,1442
46099,099,46,2018,191250,-343,320,-23,2958,1463
46099,099,46,2019,194153,528,1020,1548,2830,1482
46099,099,46,2020,196659,370,800,1170,2856,1532
46101,101,46,2010,6493,-2,0,-2,16,14
46101,101,46,2011,6499,-63,25,-38,92,48
46101,101,46,2012,6492,-88,40,-48,81,42
46101,101,46,2013,6452,-67,12,-55,88,73
46101,101,46,2014,6436,-98,24,-74,106,51
46101,101,46,2015,6454,-34,13,-21,89,49
46101,101,46,2016,6499,9,14,23,83,62
46101,101,46,2017,6483,-60,4,-56,94,54
46101,101,46,2018,6479,-25,-3,-28,85,59
46101,101,46,2019,6555,40,2,42,87,53
46101,101,46,2020,6525,-62,0,-62,86,54
46102,102,46,2010,13636,6,0,6,97,54
46102,102,46,2011,13897,27,-2,25,354,117
46102,102,46,2012,14041,-77,0,-77,347,125
46102,102,46,2013,14130,-125,0,-125,336,124
46102,102,46,2014,14217,-147,-2,-149,339,106
46102,102,46,2015,14364,-33,-3,-36,328,144
46102,102,46,2016,14426,-89,-3,-92,303,148
46102,102,46,2017,14392,-168,-5,-173,298,162
46102,102,46,2018,14324,-172,-5,-177,288,178
46102,102,46,2019,14171,-267,-5,-272,277,157
46102,102,46,2020,14070,-187,-2,-189,260,172
46103,103,46,2010,101253,97,26,123,392,232
46103,103,46,2011,102443,450,29,479,1513,801
46103,103,46,2012,104291,880,177,1057,1543,773
46103,103,46,2013,106003,918,10,928,1587,818
46103,103,46,2014,107613,744,56,800,1563,759
46103,103,46,2015,108212,-212,100,-112,1561,837
46103,103,46,2016,109240,203,273,476,1487,932
46103,103,46,2017,110686,645,284,929,1456,942
46103,103,46,2018,112260,1002,-2,1000,1524,954
46103,103,46,2019,114407,1439,174,1613,1505,975
46103,103,46,2020,115926,923,145,1068,1499,1045
46105,105,46,2010,2988,4,0,4,15,23
46105,105,46,2011,3017,53,0,53,22,46
46105,105,46,2012,3031,27,1,28,33,48
46105,105,46,2013,3024,4,0,4,34,45
46105,105,46,2014,3022,-3,0,-3,38,37
46105,105,46,2015,2983,-24,0,-24,34,48
46105,105,46,2016,2958,-16,0,-16,32,40
46105,105,46,2017,2962,-10,0,-10,47,34
46105,105,46,2018,2899,-49,0,-49,38,51
46105,105,46,2019,2833,-71,0,-71,31,26
46105,105,46,2020,2832,-14,0,-14,37,23
46107,107,46,2010,2351,12,0,12,8,3
46107,107,46,2011,2370,28,0,28,22,32
46107,107,46,2012,2340,-5,0,-5,28,52
46107,107,46,2013,2358,29,1,30,19,31
46107,107,46,2014,2307,-47,0,-47,28,32
46107,107,46,2015,2297,8,1,9,19,38
46107,107,46,2016,2261,-26,1,-25,31,41
46107,107,46,2017,2216,-35,3,-32,20,34
46107,107,46,2018,2205,2,1,3,21,35
46107,107,46,2019,2149,-55,2,-53,19,20
46107,107,46,2020,2163,15,2,17,22,26
46109,109,46,2010,10189,22,0,22,37,17
46109,109,46,2011,10291,42,8,50,175,121
46109,109,46,2012,10323,-54,12,-42,189,115
46109,109,46,2013,10238,-131,1,-130,179,136
46109,109,46,2014,10280,-47,-1,-48,190,99
46109,109,46,2015,10210,-128,11,-117,175,129
46109,109,46,2016,10192,-84,9,-75,175,117
46109,109,46,2017,10269,-8,20,12,172,106
46109,109,46,2018,10358,47,1,48,163,122
46109,109,46,2019,10399,-43,5,-38,173,93
46109,109,46,2020,10331,-118,3,-115,161,115
46111,111,46,2010,2354,-1,0,-1,5,4
46111,111,46,2011,2355,-2,0,-2,28,25
46111,111,46,2012,2318,-32,1,-31,29,36
46111,111,46,2013,2325,4,0,4,35,32
46111,111,46,2014,2331,2,3,5,35,34
46111,111,46,2015,2348,3,3,6,38,27
46111,111,46,2016,2371,16,3,19,35,30
46111,111,46,2017,2437,50,3,53,38,24
46111,111,46,2018,2387,-50,1,-49,29,30
46111,111,46,2019,2345,-67,2,-65,37,15
46111,111,46,2020,2322,-40,1,-39,32,15
46115,115,46,2010,6421,-3,-1,-4,17,7
46115,115,46,2011,6562,75,71,146,74,79
46115,115,46,2012,6736,130,38,168,86,84
46115,115,46,2013,6663,-71,0,-71,75,78
46115,115,46,2014,6655,-25,0,-25,86,70
46115,115,46,2015,6555,-93,0,-93,68,75
46115,115,46,2016,6483,-50,-1,-51,64,86
46115,115,46,2017,6516,6,12,18,93,77
46115,115,46,2018,6469,-45,0,-45,73,74
46115,115,46,2019,6401,-102,0,-102,94,60
46115,115,46,2020,6319,-97,0,-97,81,67
46117,117,46,2010,2972,9,0,9,7,9
46117,117,46,2011,2979,-11,0,-11,37,20
46117,117,46,2012,2978,-24,0,-24,42,19
46117,117,46,2013,2982,-9,0,-9,31,19
46117,117,46,2014,2984,-13,0,-13,37,21
46117,117,46,2015,2978,-23,0,-23,38,21
46117,117,46,2016,3016,10,-1,9,45,16
46117,117,46,2017,2987,-38,-1,-39,43,31
46117,117,46,2018,3035,24,-1,23,36,13
46117,117,46,2019,3129,73,-1,72,35,12
46117,117,46,2020,3121,-27,-1,-28,35,16
46119,119,46,2010,1377,0,0,0,9,0
46119,119,46,2011,1374,-9,3,-6,15,13
46119,119,46,2012,1429,39,4,43,20,10
46119,119,46,2013,1436,7,2,9,13,15
46119,119,46,2014,1406,-42,1,-41,15,6
46119,119,46,2015,1402,-11,0,-11,14,7
46119,119,46,2016,1409,6,0,6,13,11
46119,119,46,2017,1400,-23,0,-23,20,6
46119,119,46,2018,1373,-30,0,-30,15,12
46119,119,46,2019,1377,-5,0,-5,21,12
46119,119,46,2020,1391,9,0,9,16,11
46121,121,46,2010,9643,4,0,4,66,37
46121,121,46,2011,9848,-8,0,-8,276,61
46121,121,46,2012,9914,-118,0,-118,285,101
46121,121,46,2013,9999,-89,0,-89,290,114
46121,121,46,2014,9958,-258,10,-248,278,77
46121,121,46,2015,10050,-109,34,-75,262,96
46121,121,46,2016,10253,-38,81,43,256,95
46121,121,46,2017,10332,-178,81,-97,275,101
46121,121,46,2018,10341,-149,8,-141,239,89
46121,121,46,2019,10303,-186,49,-137,232,132
46121,121,46,2020,10313,-138,40,-98,230,123
46123,123,46,2010,5647,0,-1,-1,12,13
46123,123,46,2011,5634,-3,1,-2,61,72
46123,123,46,2012,5519,-114,-1,-115,72,74
46123,123,46,2013,5525,2,-2,0,67,60
46123,123,46,2014,5512,5,0,5,64,81
46123,123,46,2015,5423,-93,-2,-95,68,62
46123,123,46,2016,5502,70,3,73,78,71
46123,123,46,2017,5448,-42,3,-39,81,97
46123,123,46,2018,5484,15,1,16,90,67
46123,123,46,2019,5430,-79,2,-77,80,58
46123,123,46,2020,5377,-63,1,-62,83,74
46125,125,46,2010,8352,4,0,4,26,28
46125,125,46,2011,8356,17,0,17,91,102
46125,125,46,2012,8301,-49,2,-47,90,100
46125,125,46,2013,8308,12,0,12,81,85
46125,125,46,2014,8193,-105,5,-100,86,104
46125,125,46,2015,8133,-23,3,-20,93,131
46125,125,46,2016,8258,141,3,144,90,108
46125,125,46,2017,8290,51,8,59,92,118
46125,125,46,2018,8392,101,0,101,102,99
46125,125,46,2019,8316,-77,2,-75,95,95
46125,125,46,2020,8368,51,1,52,90,89
46127,127,46,2010,14488,77,1,78,51,37
46127,127,46,2011,14641,96,-2,94,178,120
46127,127,46,2012,14801,101,-6,95,170,108
46127,127,46,2013,14761,-73,-6,-79,157,116
46127,127,46,2014,14996,199,4,203,146,115
46127,127,46,2015,14934,-125,46,-79,147,131
46127,127,46,2016,15174,61,105,166,185,110
46127,127,46,2017,15311,-12,110,98,163,123
46127,127,46,2018,15616,242,11,253,190,138
46127,127,46,2019,16003,264,77,341,166,121
46127,127,46,2020,16192,89,60,149,175,134
46129,129,46,2010,5443,12,0,12,16,23
46129,129,46,2011,5561,123,4,127,70,79
46129,129,46,2012,5449,-110,9,-101,66,80
46129,129,46,2013,5489,47,2,49,66,76
46129,129,46,2014,5508,5,22,27,80,87
46129,129,46,2015,5412,-94,27,-67,80,108
46129,129,46,2016,5469,37,23,60,73,76
46129,129,46,2017,5480,4,19,23,79,91
46129,129,46,2018,5450,-36,4,-32,70,67
46129,129,46,2019,5421,-62,15,-47,75,58
46129,129,46,2020,5336,-103,9,-94,65,55
46135,135,46,2010,22436,11,2,13,54,66
46135,135,46,2011,22507,40,-6,34,259,221
46135,135,46,2012,22594,44,3,47,249,206
46135,135,46,2013,22654,-4,-4,-8,272,201
46135,135,46,2014,22695,-40,10,-30,278,202
46135,135,46,2015,22702,-33,14,-19,268,240
46135,135,46,2016,22653,-86,19,-67,284,265
46135,135,46,2017,22691,-53,28,-25,305,243
46135,135,46,2018,22807,83,-1,82,283,247
46135,135,46,2019,22837,20,20,40,229,240
46135,135,46,2020,22742,-128,17,-111,248,232
46137,137,46,2010,2826,10,0,10,16,2
46137,137,46,2011,2840,-17,2,-15,44,14
46137,137,46,2012,2879,4,0,4,42,7
46137,137,46,2013,2855,-45,0,-45,34,15
46137,137,46,2014,2859,-26,1,-25,39,10
46137,137,46,2015,2838,-37,0,-37,33,17
46137,137,46,2016,2870,20,0,20,28,17
46137,137,46,2017,2747,-123,0,-123,21,19
46137,137,46,2018,2759,1,0,1,26,15
46137,137,46,2019,2801,30,0,30,28,17
46137,137,46,2020,2656,-143,0,-143,31,30
47001,001,47,2010,75088,-5,10,5,217,194
47001,001,47,2011,75212,144,49,193,811,876
47001,001,47,2012,75240,132,39,171,803,934
47001,001,47,2013,75323,124,67,191,824,924
47001,001,47,2014,75191,-4,57,53,763,933
47001,001,47,2015,75500,385,62,447,819,951
47001,001,47,2016,75567,192,44,236,780,945
47001,001,47,2017,76113,713,47,760,777,987
47001,001,47,2018,76337,404,55,459,809,1042
47001,001,47,2019,76991,832,15,847,822,1013
47001,001,47,2020,77558,744,14,758,812,1000
47003,003,47,2010,45082,-14,9,-5,162,128
47003,003,47,2011,45249,-105,98,-7,613,437
47003,003,47,2012,45254,-229,59,-170,600,426
47003,003,47,2013,45567,117,43,160,639,480
47003,003,47,2014,46257,494,30,524,590,433
47003,003,47,2015,46954,472,85,557,627,487
47003,003,47,2016,47454,310,76,386,608,495
47003,003,47,2017,48214,546,81,627,654,521
47003,003,47,2018,49153,713,82,795,687,542
47003,003,47,2019,49684,278,41,319,676,465
47003,003,47,2020,50179,283,34,317,680,503
47005,005,47,2010,16510,31,0,31,33,44
47005,005,47,2011,16531,64,2,66,172,218
47005,005,47,2012,16447,23,1,24,151,256
47005,005,47,2013,16363,-37,5,-32,173,225
47005,005,47,2014,16201,-45,0,-45,137,251
47005,005,47,2015,16224,105,5,110,168,254
47005,005,47,2016,16094,-51,-2,-53,171,248
47005,005,47,2017,15989,43,-1,42,139,284
47005,005,47,2018,16253,372,-1,371,171,277
47005,005,47,2019,16199,30,-1,29,173,256
47005,005,47,2020,16131,30,-1,29,170,267
47007,007,47,2010,12892,-3,0,-3,30,15
47007,007,47,2011,13002,111,-1,110,130,131
47007,007,47,2012,12936,-70,-2,-72,131,126
47007,007,47,2013,13917,959,-1,958,101,121
47007,007,47,2014,14514,587,0,587,119,138
47007,007,47,2015,14611,78,22,100,138,141
47007,007,47,2016,14741,120,19,139,127,135
47007,007,47,2017,14907,163,25,188,121,144
47007,007,47,2018,14847,-22,22,0,115,175
47007,007,47,2019,15085,224,21,245,127,134
47007,007,47,2020,15223,168,18,186,118,166
47009,009,47,2010,123208,72,11,83,298,259
47009,009,47,2011,123689,414,88,502,1242,1258
47009,009,47,2012,124062,299,59,358,1305,1264
47009,009,47,2013,124937,908,52,960,1274,1364
47009,009,47,2014,125932,1001,50,1051,1281,1339
47009,009,47,2015,127047,1087,84,1171,1300,1357
47009,009,47,2016,128356,1360,66,1426,1227,1345
47009,009,47,2017,130106,1850,91,1941,1239,1434
47009,009,47,2018,131595,1622,88,1710,1257,1473
47009,009,47,2019,133396,1990,35,2025,1283,1503
47009,009,47,2020,134751,1579,37,1616,1283,1541
47011,011,47,2010,99086,55,9,64,298,195
47011,011,47,2011,99813,478,111,589,1092,952
47011,011,47,2012,101077,896,90,986,1199,940
47011,011,47,2013,101819,396,126,522,1180,954
47011,011,47,2014,102830,682,83,765,1226,970
47011,011,47,2015,103846,761,147,908,1204,1093
47011,011,47,2016,104469,321,154,475,1149,997
47011,011,47,2017,105575,810,177,987,1230,1110
47011,011,47,2018,107271,1302,239,1541,1262,1109
47011,011,47,2019,108233,815,61,876,1228,1139
47011,011,47,2020,109071,759,51,810,1224,1199
47013,013,47,2010,40735,7,0,7,105,94
47013,013,47,2011,40697,100,-6,94,402,532
47013,013,47,2012,40545,-91,-7,-98,430,477
47013,013,47,2013,40262,-150,-4,-154,428,552
47013,013,47,2014,39918,-177,-4,-181,419,579
47013,013,47,2015,39805,49,13,62,418,590
47013,013,47,2016,39829,158,13,171,449,594
47013,013,47,2017,39824,147,17,164,452,619
47013,013,47,2018,39820,142,20,162,450,615
47013,013,47,2019,39778,112,8,120,437,598
47013,013,47,2020,39837,237,9,246,441,628
47015,015,47,2010,13796,-2,1,-1,36,50
47015,015,47,2011,13725,-76,12,-64,149,156
47015,015,47,2012,13792,76,8,84,145,162
47015,015,47,2013,13704,-70,20,-50,136,172
47015,015,47,2014,13581,-91,7,-84,139,181
47015,015,47,2015,13746,186,5,191,166,193
47015,015,47,2016,13884,143,2,145,166,173
47015,015,47,2017,14162,296,5,301,154,177
47015,015,47,2018,14395,224,9,233,194,196
47015,015,47,2019,14583,186,2,188,166,165
47015,015,47,2020,14847,254,2,256,166,158
47017,017,47,2010,28453,13,1,14,66,110
47017,017,47,2011,28548,172,2,174,330,409
47017,017,47,2012,28670,194,4,198,323,404
47017,017,47,2013,28614,18,6,24,324,398
47017,017,47,2014,28417,-131,5,-126,316,385
47017,017,47,2015,27986,-244,5,-239,290,483
47017,017,47,2016,27956,47,1,48,356,431
47017,017,47,2017,27824,17,4,21,273,425
47017,017,47,2018,27937,249,1,250,300,437
47017,017,47,2019,27710,-140,3,-137,300,389
47017,017,47,2020,27779,174,4,178,299,408
47019,019,47,2010,57343,-27,2,-25,129,135
47019,019,47,2011,57387,24,17,41,584,578
47019,019,47,2012,57355,100,18,118,520,656
47019,019,47,2013,56985,-164,10,-154,506,719
47019,019,47,2014,56334,-519,2,-517,539,678
47019,019,47,2015,56385,214,1,215,533,690
47019,019,47,2016,56481,306,3,309,506,716
47019,019,47,2017,56526,295,3,298,479,730
47019,019,47,2018,56437,201,6,207,481,775
47019,019,47,2019,56396,277,-3,274,467,782
47019,019,47,2020,56418,407,-1,406,451,835
47021,021,47,2010,39120,-28,3,-25,102,57
47021,021,47,2011,38978,-194,5,-189,415,369
47021,021,47,2012,39226,154,2,156,448,351
47021,021,47,2013,39335,93,4,97,413,397
47021,021,47,2014,39611,156,6,162,455,335
47021,021,47,2015,39597,-91,5,-86,461,384
47021,021,47,2016,39793,139,19,158,460,420
47021,021,47,2017,40436,534,39,573,489,422
47021,021,47,2018,40539,135,25,160,423,480
47021,021,47,2019,40828,172,30,202,496,409
47021,021,47,2020,41101,233,24,257,466,452
47023,023,47,2010,17194,27,0,27,44,19
47023,023,47,2011,17150,-43,9,-34,180,189
47023,023,47,2012,17080,-90,-1,-91,182,166
47023,023,47,2013,17120,11,5,16,205,178
47023,023,47,2014,17141,3,16,19,201,198
47023,023,47,2015,17130,-16,13,-3,195,204
47023,023,47,2016,17132,6,2,8,171,176
47023,023,47,2017,17153,14,4,18,188,184
47023,023,47,2018,17279,121,5,126,182,181
47023,023,47,2019,17306,53,-4,49,175,197
47023,023,47,2020,17432,130,0,130,178,181
47025,025,47,2010,32213,39,1,40,81,115
47025,025,47,2011,32112,-50,17,-33,320,386
47025,025,47,2012,31774,-230,15,-215,315,439
47025,025,47,2013,31645,-3,15,12,287,424
47025,025,47,2014,31597,64,12,76,313,430
47025,025,47,2015,31585,79,15,94,325,429
47025,025,47,2016,31672,231,18,249,292,455
47025,025,47,2017,31700,138,19,157,308,435
47025,025,47,2018,31823,213,23,236,342,454
47025,025,47,2019,31919,168,0,168,333,406
47025,025,47,2020,32023,226,4,230,330,456
47027,027,47,2010,7847,12,0,12,18,39
47027,027,47,2011,7744,-71,1,-70,76,109
47027,027,47,2012,7706,5,2,7,81,124
47027,027,47,2013,7693,-12,6,-6,99,107
47027,027,47,2014,7626,-28,7,-21,63,109
47027,027,47,2015,7668,63,4,67,83,107
47027,027,47,2016,7660,50,0,50,76,133
47027,027,47,2017,7661,45,0,45,75,120
47027,027,47,2018,7654,52,0,52,55,113
47027,027,47,2019,7597,-28,0,-28,70,99
47027,027,47,2020,7629,81,0,81,65,113
47029,029,47,2010,35641,4,7,11,98,103
47029,029,47,2011,35434,-142,6,-136,357,427
47029,029,47,2012,35535,166,3,169,396,462
47029,029,47,2013,35409,-21,3,-18,404,505
47029,029,47,2014,35279,26,2,28,373,525
47029,029,47,2015,35157,-9,-4,-13,415,519
47029,029,47,2016,35243,243,-3,240,364,517
47029,029,47,2017,35564,472,2,474,370,524
47029,029,47,2018,35937,533,3,536,362,527
47029,029,47,2019,36017,275,1,276,362,558
47029,029,47,2020,36225,416,1,417,351,558
47031,031,47,2010,52770,-17,2,-15,159,172
47031,031,47,2011,52929,139,14,153,642,634
47031,031,47,2012,53165,249,10,259,635,652
47031,031,47,2013,53325,171,-7,164,654,650
47031,031,47,2014,53555,242,-21,221,651,636
47031,031,47,2015,54130,510,-12,498,728,652
47031,031,47,2016,54593,473,2,475,695,706
47031,031,47,2017,55128,529,39,568,650,683
47031,031,47,2018,56049,875,22,897,724,701
47031,031,47,2019,56717,647,18,665,694,689
47031,031,47,2020,57632,887,13,900,703,685
47033,033,47,2010,14589,-10,0,-10,49,25
47033,033,47,2011,14563,-35,6,-29,179,176
47033,033,47,2012,14612,65,4,69,172,190
47033,033,47,2013,14613,-26,8,-18,182,163
47033,033,47,2014,14654,38,12,50,179,183
47033,033,47,2015,14588,-54,4,-50,165,181
47033,033,47,2016,14464,-122,8,-114,168,177
47033,033,47,2017,14443,22,13,35,153,208
47033,033,47,2018,14276,-137,3,-134,161,195
47033,033,47,2019,14189,-64,10,-54,153,185
47033,033,47,2020,14180,3,9,12,165,185
47035,035,47,2010,56193,168,4,172,138,181
47035,035,47,2011,56538,441,30,471,580,705
47035,035,47,2012,57008,613,31,644,555,745
47035,035,47,2013,57462,629,41,670,579,805
47035,035,47,2014,57952,711,31,742,523,788
47035,035,47,2015,58259,526,42,568,570,833
47035,035,47,2016,58599,626,23,649,519,827
47035,035,47,2017,59077,753,39,792,522,837
47035,035,47,2018,59971,1170,23,1193,546,847
47035,035,47,2019,60832,1167,29,1196,544,875
47035,035,47,2020,61603,1131,25,1156,547,926
47037,037,47,2010,627794,-316,363,47,2415,1206
47037,037,47,2011,636083,702,3023,3725,9481,4937
47037,037,47,2012,649619,5986,2458,8444,9711,4919
47037,037,47,2013,660560,2552,3511,6063,9893,5121
47037,037,47,2014,670102,1677,2909,4586,10021,5164
47037,037,47,2015,680397,1519,3489,5008,10357,5146
47037,037,47,2016,686420,-1354,2635,1281,10165,5428
47037,037,47,2017,687808,-6172,3022,-3150,10054,5445
47037,037,47,2018,691298,-4394,3402,-992,10082,5553
47037,037,47,2019,692999,-4110,1389,-2721,9985,5526
47037,037,47,2020,694176,-3946,1079,-2867,10034,5962
47039,039,47,2010,11713,3,0,3,27,61
47039,039,47,2011,11679,7,14,21,104,159
47039,039,47,2012,11631,5,10,15,104,163
47039,039,47,2013,11693,73,19,92,119,151
47039,039,47,2014,11681,30,6,36,136,183
47039,039,47,2015,11596,-28,7,-21,126,188
47039,039,47,2016,11728,169,2,171,118,156
47039,039,47,2017,11711,65,2,67,115,199
47039,039,47,2018,11669,14,2,16,114,170
47039,039,47,2019,11608,4,0,4,103,170
47039,039,47,2020,11601,72,0,72,106,183
47041,041,47,2010,18694,4,1,5,56,86
47041,041,47,2011,18753,29,35,64,223,229
47041,041,47,2012,18865,101,21,122,226,236
47041,041,47,2013,19147,213,71,284,229,233
47041,041,47,2014,19218,68,50,118,209,252
47041,041,47,2015,19281,-21,76,55,252,242
47041,041,47,2016,19414,116,46,162,214,243
47041,041,47,2017,19817,360,66,426,218,243
47041,041,47,2018,20045,240,40,280,200,253
47041,041,47,2019,20409,333,49,382,237,254
47041,041,47,2020,20837,431,40,471,229,270
47043,043,47,2010,49692,32,1,33,157,150
47043,043,47,2011,49996,196,3,199,599,494
47043,043,47,2012,50229,166,5,171,569,504
47043,043,47,2013,50182,-214,-1,-215,641,472
47043,043,47,2014,50484,217,-2,215,621,527
47043,043,47,2015,51357,753,0,753,627,512
47043,043,47,2016,51936,575,-6,569,608,599
47043,043,47,2017,52811,891,1,892,574,595
47043,043,47,2018,53467,619,-8,611,641,596
47043,043,47,2019,53856,333,-2,331,647,590
47043,043,47,2020,54376,453,1,454,638,575
47045,045,47,2010,38320,-21,3,-18,117,106
47045,045,47,2011,38122,-251,18,-233,475,441
47045,045,47,2012,38196,-50,19,-31,519,411
47045,045,47,2013,38112,-142,26,-116,479,445
47045,045,47,2014,37835,-320,13,-307,466,438
47045,045,47,2015,37784,-74,3,-71,445,425
47045,045,47,2016,37588,-227,-4,-231,491,454
47045,045,47,2017,37368,-157,-2,-159,466,527
47045,045,47,2018,37233,-87,-2,-89,450,495
47045,045,47,2019,37122,-102,-3,-105,456,463
47045,045,47,2020,36693,-379,-1,-380,451,499
47047,047,47,2010,38427,18,1,19,105,136
47047,047,47,2011,38574,18,5,23,447,322
47047,047,47,2012,38689,-1,7,6,417,302
47047,047,47,2013,38819,21,20,41,422,331
47047,047,47,2014,39131,234,25,259,443,396
47047,047,47,2015,39291,125,28,153,416,408
47047,047,47,2016,39712,405,21,426,417,423
47047,047,47,2017,40156,445,18,463,416,438
47047,047,47,2018,40529,370,13,383,407,419
47047,047,47,2019,41044,543,8,551,391,428
47047,047,47,2020,41620,656,6,662,393,477
47049,049,47,2010,17922,-4,0,-4,49,84
47049,049,47,2011,17999,90,-2,88,198,208
47049,049,47,2012,17919,-31,-2,-33,179,222
47049,049,47,2013,17909,39,-2,37,191,235
47049,049,47,2014,17856,13,0,13,193,255
47049,049,47,2015,17974,179,1,180,176,240
47049,049,47,2016,18069,128,6,134,203,240
47049,049,47,2017,18240,250,7,257,182,269
47049,049,47,2018,18362,191,8,199,186,262
47049,049,47,2019,18568,263,3,266,192,253
47049,049,47,2020,18787,307,4,311,188,279
47051,051,47,2010,40960,-53,0,-53,80,128
47051,051,47,2011,40866,12,3,15,374,482
47051,051,47,2012,40706,-114,23,-91,408,470
47051,051,47,2013,41241,549,69,618,411,504
47051,051,47,2014,41320,185,41,226,364,509
47051,051,47,2015,41385,104,52,156,402,488
47051,051,47,2016,41579,274,22,296,414,515
47051,051,47,2017,41662,139,37,176,403,497
47051,051,47,2018,42016,409,39,448,428,521
47051,051,47,2019,42255,306,27,333,395,487
47051,051,47,2020,42485,313,22,335,405,510
47053,053,47,2010,49733,27,0,27,153,126
47053,053,47,2011,49896,287,3,290,585,712
47053,053,47,2012,49668,-218,8,-210,641,655
47053,053,47,2013,49381,-240,5,-235,619,671
47053,053,47,2014,49437,91,6,97,600,630
47053,053,47,2015,49327,-65,6,-59,631,678
47053,053,47,2016,49252,23,8,31,609,712
47053,053,47,2017,49257,105,8,113,591,694
47053,053,47,2018,49181,5,6,11,596,682
47053,053,47,2019,49114,26,4,30,568,665
47053,053,47,2020,49159,187,3,190,559,703
47055,055,47,2010,29409,-103,2,-101,73,45
47055,055,47,2011,29292,-72,27,-45,286,359
47055,055,47,2012,28978,-276,21,-255,284,347
47055,055,47,2013,28810,-129,32,-97,315,383
47055,055,47,2014,28829,55,35,90,300,369
47055,055,47,2015,28982,104,41,145,342,330
47055,055,47,2016,29167,168,38,206,336,357
47055,055,47,2017,29401,231,61,292,325,382
47055,055,47,2018,29434,133,39,172,292,429
47055,055,47,2019,29481,57,47,104,324,382
47055,055,47,2020,29530,126,36,162,304,418
47057,057,47,2010,22718,67,0,67,70,76
47057,057,47,2011,22748,67,-2,65,203,237
47057,057,47,2012,22682,-56,2,-54,228,238
47057,057,47,2013,22733,116,6,122,213,284
47057,057,47,2014,22857,191,-3,188,236,299
47057,057,47,2015,22847,48,4,52,223,283
47057,057,47,2016,23092,298,3,301,223,279
47057,057,47,2017,23119,86,15,101,229,301
47057,057,47,2018,23160,114,5,119,234,310
47057,057,47,2019,23406,282,12,294,242,290
47057,057,47,2020,23565,228,11,239,237,316
47059,059,47,2010,68834,19,3,22,169,171
47059,059,47,2011,69174,583,41,624,566,852
47059,059,47,2012,68773,-205,20,-185,633,842
47059,059,47,2013,68352,-212,16,-196,617,836
47059,059,47,2014,68491,344,3,347,658,857
47059,059,47,2015,68621,357,23,380,634,878
47059,059,47,2016,68582,197,15,212,679,925
47059,059,47,2017,68866,593,19,612,673,998
47059,059,47,2018,69237,685,16,701,659,989
47059,059,47,2019,69127,172,9,181,667,955
47059,059,47,2020,69571,809,9,818,652,1022
47061,061,47,2010,13725,3,0,3,36,40
47061,061,47,2011,13588,-116,0,-116,157,178
47061,061,47,2012,13583,54,0,54,165,222
47061,061,47,2013,13449,-67,0,-67,147,212
47061,061,47,2014,13341,-60,1,-59,155,202
47061,061,47,2015,13339,42,1,43,159,205
47061,061,47,2016,13284,-8,0,-8,160,207
47061,061,47,2017,13336,121,1,122,156,224
47061,061,47,2018,13343,53,1,54,181,229
47061,061,47,2019,13409,91,-1,90,143,167
47061,061,47,2020,13485,110,0,110,157,191
47063,063,47,2010,62509,18,4,22,171,211
47063,063,47,2011,62900,168,103,271,795,675
47063,063,47,2012,62775,-293,76,-217,765,670
47063,063,47,2013,63068,110,143,253,803,752
47063,063,47,2014,63027,-96,85,-11,784,797
47063,063,47,2015,63379,227,87,314,801,755
47063,063,47,2016,63674,270,40,310,734,747
47063,063,47,2017,64084,436,61,497,730,814
47063,063,47,2018,64654,423,92,515,815,759
47063,063,47,2019,64873,199,-1,198,776,755
47063,063,47,2020,65110,264,14,278,778,821
47065,065,47,2010,337235,455,60,515,1074,834
47065,065,47,2011,341179,2415,662,3077,4047,3189
47065,065,47,2012,345828,3358,410,3768,4118,3331
47065,065,47,2013,349234,1978,520,2498,4213,3315
47065,065,47,2014,350972,640,400,1040,4097,3359
47065,065,47,2015,353985,1870,413,2283,4223,3485
47065,065,47,2016,358165,2903,321,3224,4371,3420
47065,065,47,2017,361362,2336,406,2742,4157,3711
47065,065,47,2018,364626,2273,481,2754,4276,3774
47065,065,47,2019,367776,2451,144,2595,4300,3754
47065,065,47,2020,371662,3520,119,3639,4290,4042
47067,067,47,2010,6796,12,0,12,13,37
47067,067,47,2011,6706,-50,0,-50,64,104
47067,067,47,2012,6656,-28,0,-28,70,90
47067,067,47,2013,6621,-5,1,-4,74,105
47067,067,47,2014,6619,24,1,25,61,86
47067,067,47,2015,6577,14,1,15,67,123
47067,067,47,2016,6596,25,1,26,84,91
47067,067,47,2017,6592,31,1,32,70,103
47067,067,47,2018,6552,-11,1,-10,71,102
47067,067,47,2019,6605,72,1,73,67,87
47067,067,47,2020,6493,-83,1,-82,70,100
47069,069,47,2010,27169,-96,0,-96,58,44
47069,069,47,2011,26874,-305,0,-305,289,280
47069,069,47,2012,26614,-240,0,-240,276,299
47069,069,47,2013,26362,-254,-1,-255,264,264
47069,069,47,2014,25992,-336,-1,-337,264,304
47069,069,47,2015,25823,-171,-1,-172,290,287
47069,069,47,2016,25590,-202,0,-202,263,293
47069,069,47,2017,25491,-6,0,-6,245,338
47069,069,47,2018,25270,-148,0,-148,238,311
47069,069,47,2019,25049,-141,0,-141,217,298
47069,069,47,2020,24836,-123,0,-123,216,306
47071,071,47,2010,26050,20,1,21,65,43
47071,071,47,2011,25871,-130,1,-129,286,336
47071,071,47,2012,25966,148,4,152,299,350
47071,071,47,2013,25931,99,-1,98,267,397
47071,071,47,2014,25808,-20,20,0,260,380
47071,071,47,2015,25760,38,23,61,283,390
47071,071,47,2016,25746,47,15,62,301,376
47071,071,47,2017,25708,109,0,109,251,397
47071,071,47,2018,25659,108,-3,105,255,409
47071,071,47,2019,25627,112,-1,111,230,372
47071,071,47,2020,25583,127,-1,126,227,397
47073,073,47,2010,56870,43,2,45,129,125
47073,073,47,2011,56632,-141,-11,-152,551,635
47073,073,47,2012,56574,108,-7,101,533,683
47073,073,47,2013,56719,221,3,224,568,642
47073,073,47,2014,56506,-14,2,-12,520,707
47073,073,47,2015,56397,57,15,72,557,733
47073,073,47,2016,56599,354,19,373,549,717
47073,073,47,2017,56671,251,38,289,523,739
47073,073,47,2018,56774,266,38,304,541,739
47073,073,47,2019,56855,289,26,315,517,752
47073,073,47,2020,56775,215,19,234,527,842
47075,075,47,2010,18811,-38,0,-38,66,22
47075,075,47,2011,18550,-298,4,-294,221,190
47075,075,47,2012,18282,-286,-2,-288,215,200
47075,075,47,2013,18241,-99,11,-88,237,190
47075,075,47,2014,18243,-56,6,-50,238,183
47075,075,47,2015,18040,-228,6,-222,206,188
47075,075,47,2016,17820,-195,-3,-198,189,212
47075,075,47,2017,17606,-177,-1,-178,195,231
47075,075,47,2018,17281,-285,-1,-286,197,238
47075,075,47,2019,17244,-23,-2,-25,196,208
47075,075,47,2020,17002,-195,-1,-196,186,231
47077,077,47,2010,27794,-23,0,-23,93,61
47077,077,47,2011,28048,197,1,198,336,279
47077,077,47,2012,28094,48,-5,43,322,316
47077,077,47,2013,28057,-15,-2,-17,307,322
47077,077,47,2014,28107,40,-2,38,331,312
47077,077,47,2015,28092,15,-1,14,317,341
47077,077,47,2016,27860,-165,-1,-166,312,378
47077,077,47,2017,27868,1,-2,-1,342,332
47077,077,47,2018,27924,113,-2,111,300,354
47077,077,47,2019,28050,143,-2,141,312,326
47077,077,47,2020,28076,94,-2,92,299,364
47079,079,47,2010,32396,30,2,32,101,85
47079,079,47,2011,32442,134,16,150,324,426
47079,079,47,2012,32379,59,7,66,332,456
47079,079,47,2013,32247,-20,14,-6,370,492
47079,079,47,2014,32247,135,7,142,304,439
47079,079,47,2015,32133,-6,3,-3,343,450
47079,079,47,2016,32213,262,-5,257,314,491
47079,079,47,2017,32387,320,-1,319,326,470
47079,079,47,2018,32289,75,-2,73,325,494
47079,079,47,2019,32309,168,-3,165,319,463
47079,079,47,2020,32056,-31,-2,-33,305,525
47081,081,47,2010,24649,-31,3,-28,57,71
47081,081,47,2011,24369,-279,3,-276,268,274
47081,081,47,2012,24200,-145,-1,-146,253,277
47081,081,47,2013,24219,9,4,13,258,249
47081,081,47,2014,24481,215,8,223,305,269
47081,081,47,2015,24395,-91,-2,-93,301,292
47081,081,47,2016,24656,294,1,295,239,273
47081,081,47,2017,24871,221,-1,220,289,296
47081,081,47,2018,25017,178,1,179,265,298
47081,081,47,2019,25155,176,-2,174,264,300
47081,081,47,2020,25387,253,0,253,269,291
47083,083,47,2010,8450,9,0,9,23,9
47083,083,47,2011,8346,-96,2,-94,98,109
47083,083,47,2012,8425,116,2,118,69,111
47083,083,47,2013,8276,-122,1,-121,76,106
47083,083,47,2014,8222,-5,0,-5,68,115
47083,083,47,2015,8127,-101,-1,-102,102,96
47083,083,47,2016,8110,4,-1,3,94,115
47083,083,47,2017,8160,104,0,104,81,135
47083,083,47,2018,8235,114,0,114,83,122
47083,083,47,2019,8206,-6,0,-6,77,100
47083,083,47,2020,8292,117,0,117,80,110
47085,085,47,2010,18557,36,0,36,53,65
47085,085,47,2011,18403,-145,5,-140,216,232
47085,085,47,2012,18285,-102,3,-99,203,221
47085,085,47,2013,18243,7,3,10,215,264
47085,085,47,2014,18145,-51,2,-49,186,234
47085,085,47,2015,18153,41,1,42,200,232
47085,085,47,2016,18378,269,5,274,188,238
47085,085,47,2017,18519,172,7,179,215,252
47085,085,47,2018,18559,101,9,110,222,292
47085,085,47,2019,18596,65,2,67,218,247
47085,085,47,2020,18590,41,3,44,207,257
47087,087,47,2010,11628,-13,0,-13,24,20
47087,087,47,2011,11566,-21,-1,-22,94,132
47087,087,47,2012,11602,71,-1,70,111,147
47087,087,47,2013,11569,17,0,17,104,154
47087,087,47,2014,11531,23,0,23,83,145
47087,087,47,2015,11541,86,1,87,102,179
47087,087,47,2016,11621,134,2,136,111,166
47087,087,47,2017,11709,129,3,132,93,138
47087,087,47,2018,11802,153,2,155,107,171
47087,087,47,2019,11838,109,2,111,91,165
47087,087,47,2020,11864,116,1,117,89,179
47089,089,47,2010,51719,20,3,23,132,103
47089,089,47,2011,51918,233,13,246,520,567
47089,089,47,2012,52316,396,25,421,538,567
47089,089,47,2013,52157,-117,24,-93,519,579
47089,089,47,2014,52439,302,24,326,516,558
47089,089,47,2015,53049,605,31,636,542,573
47089,089,47,2016,53193,260,4,264,517,636
47089,089,47,2017,53760,731,2,733,493,661
47089,089,47,2018,53989,450,9,459,455,685
47089,089,47,2019,54563,717,-12,705,504,635
47089,089,47,2020,55307,995,-8,987,485,724
47091,091,47,2010,18287,31,0,31,44,27
47091,091,47,2011,18227,-25,-1,-26,168,202
47091,091,47,2012,18164,4,0,4,133,198
47091,091,47,2013,18020,-72,-1,-73,138,209
47091,091,47,2014,17942,16,-4,12,154,240
47091,091,47,2015,17851,-37,-4,-41,170,218
47091,091,47,2016,17782,18,-5,13,169,250
47091,091,47,2017,17611,-33,-2,-35,116,251
47091,091,47,2018,17759,244,-3,241,173,265
47091,091,47,2019,17773,124,-2,122,153,261
47091,091,47,2020,17849,184,-1,183,149,257
47093,093,47,2010,432952,334,72,406,1277,975
47093,093,47,2011,436822,2090,612,2702,5085,3921
47093,093,47,2012,440883,2321,519,2840,5272,4056
47093,093,47,2013,444453,1902,663,2565,5201,4180
47093,093,47,2014,448112,2188,472,2660,5140,4129
47093,093,47,2015,451551,1823,822,2645,5339,4518
47093,093,47,2016,456410,3165,677,3842,5315,4300
47093,093,47,2017,461977,4081,768,4849,5234,4529
47093,093,47,2018,466787,3369,949,4318,5217,4735
47093,093,47,2019,470137,2566,271,2837,5141,4640
47093,093,47,2020,475609,4983,238,5221,5136,4888
47095,095,47,2010,7827,5,0,5,17,26
47095,095,47,2011,7794,2,1,3,73,109
47095,095,47,2012,7718,-61,0,-61,72,86
47095,095,47,2013,7712,10,1,11,59,76
47095,095,47,2014,7679,4,1,5,64,104
47095,095,47,2015,7603,-43,1,-42,72,104
47095,095,47,2016,7528,-35,0,-35,67,108
47095,095,47,2017,7450,-40,1,-39,63,103
47095,095,47,2018,7387,-19,1,-18,60,104
47095,095,47,2019,7010,-366,1,-365,64,75
47095,095,47,2020,6988,7,1,8,65,97
47097,097,47,2010,27722,-70,2,-68,58,92
47097,097,47,2011,27703,-122,26,-96,329,252
47097,097,47,2012,27698,-48,22,-26,295,270
47097,097,47,2013,27578,-175,32,-143,307,286
47097,097,47,2014,27359,-226,2,-224,287,282
47097,097,47,2015,26907,-474,0,-474,290,275
47097,097,47,2016,25319,-1581,-4,-1585,314,333
47097,097,47,2017,26088,748,-1,747,333,322
47097,097,47,2018,25980,-84,-2,-86,297,318
47097,097,47,2019,25608,-371,-1,-372,279,278
47097,097,47,2020,25451,-142,0,-142,278,295
47099,099,47,2010,41971,110,0,110,142,144
47099,099,47,2011,42165,98,16,114,562,480
47099,099,47,2012,42162,-80,14,-66,570,502
47099,099,47,2013,42037,-208,17,-191,550,482
47099,099,47,2014,42313,238,8,246,579,543
47099,099,47,2015,42607,265,-5,260,575,540
47099,099,47,2016,43087,438,-2,436,577,532
47099,099,47,2017,43406,325,-1,324,565,568
47099,099,47,2018,43814,397,-1,396,566,555
47099,099,47,2019,44163,371,-2,369,574,593
47099,099,47,2020,44432,269,0,269,555,555
47101,101,47,2010,12175,1,0,1,22,17
47101,101,47,2011,12151,6,-2,4,116,143
47101,101,47,2012,11950,-217,-2,-219,128,115
47101,101,47,2013,12001,67,-1,66,141,155
47101,101,47,2014,11893,-73,-2,-75,130,163
47101,101,47,2015,11884,-17,-1,-18,143,135
47101,101,47,2016,11894,54,-1,53,129,171
47101,101,47,2017,12028,127,-1,126,152,145
47101,101,47,2018,12105,87,-1,86,147,157
47101,101,47,2019,12267,198,-1,197,129,163
47101,101,47,2020,12363,124,0,124,139,167
47103,103,47,2010,33378,77,2,79,95,148
47103,103,47,2011,33386,2,26,28,349,366
47103,103,47,2012,33386,44,12,56,359,406
47103,103,47,2013,33515,176,25,201,347,416
47103,103,47,2014,33465,-8,10,2,323,368
47103,103,47,2015,33634,207,13,220,356,404
47103,103,47,2016,33616,25,23,48,370,433
47103,103,47,2017,33941,326,41,367,367,408
47103,103,47,2018,34257,359,24,383,402,469
47103,103,47,2019,34436,233,27,260,355,435
47103,103,47,2020,34540,150,21,171,375,443
47105,105,47,2010,48719,171,4,175,117,153
47105,105,47,2011,49200,410,62,472,545,535
47105,105,47,2012,49842,655,0,655,544,573
47105,105,47,2013,50408,692,-6,686,534,668
47105,105,47,2014,50613,245,21,266,538,598
47105,105,47,2015,50950,401,51,452,532,645
47105,105,47,2016,51427,534,47,581,552,655
47105,105,47,2017,52319,950,82,1032,518,662
47105,105,47,2018,53152,982,27,1009,478,657
47105,105,47,2019,54039,1020,62,1082,493,684
47105,105,47,2020,54910,1024,50,1074,490,689
47107,107,47,2010,52173,-45,7,-38,105,172
47107,107,47,2011,52334,189,69,258,568,663
47107,107,47,2012,52441,52,55,107,598,588
47107,107,47,2013,52437,19,78,97,546,641
47107,107,47,2014,52687,329,57,386,583,717
47107,107,47,2015,52519,-117,55,-62,572,671
47107,107,47,2016,52697,257,39,296,567,684
47107,107,47,2017,52918,284,46,330,571,676
47107,107,47,2018,53329,451,59,510,613,712
47107,107,47,2019,53810,563,24,587,572,678
47107,107,47,2020,54208,522,23,545,582,727
47109,109,47,2010,26065,23,0,23,72,111
47109,109,47,2011,26079,55,12,67,293,345
47109,109,47,2012,26148,94,-2,92,296,315
47109,109,47,2013,26040,-44,-1,-45,283,345
47109,109,47,2014,26039,67,-1,66,267,331
47109,109,47,2015,25874,-44,3,-41,266,387
47109,109,47,2016,25845,48,8,56,264,347
47109,109,47,2017,26030,284,9,293,287,396
47109,109,47,2018,25837,-90,13,-77,274,388
47109,109,47,2019,25662,-67,4,-63,258,370
47109,109,47,2020,25696,159,3,162,256,384
47111,111,47,2010,22236,16,9,25,74,87
47111,111,47,2011,22452,48,74,122,323,229
47111,111,47,2012,22486,-56,51,-5,294,253
47111,111,47,2013,22634,83,54,137,312,298
47111,111,47,2014,22916,242,2,244,324,289
47111,111,47,2015,23075,80,4,84,343,265
47111,111,47,2016,23364,215,12,227,334,273
47111,111,47,2017,23931,505,15,520,319,273
47111,111,47,2018,24294,293,17,310,345,292
47111,111,47,2019,24624,252,-2,250,324,245
47111,111,47,2020,24827,147,4,151,329,278
47113,113,47,2010,98251,-72,0,-72,298,271
47113,113,47,2011,98095,-555,80,-475,1214,893
47113,113,47,2012,98532,-48,47,-1,1316,855
47113,113,47,2013,98760,-165,83,-82,1277,950
47113,113,47,2014,98172,-981,62,-919,1246,921
47113,113,47,2015,97613,-840,63,-777,1221,1008
47113,113,47,2016,97535,-366,46,-320,1260,1016
47113,113,47,2017,97543,-171,80,-91,1219,1116
47113,113,47,2018,97706,-81,95,14,1228,1076
47113,113,47,2019,98046,129,43,172,1212,1046
47113,113,47,2020,98360,103,39,142,1217,1049
47115,115,47,2010,28227,33,0,33,70,100
47115,115,47,2011,28107,-97,5,-92,286,314
47115,115,47,2012,28237,153,2,155,310,331
47115,115,47,2013,28337,182,13,195,279,374
47115,115,47,2014,28416,149,2,151,331,402
47115,115,47,2015,28407,29,0,29,353,386
47115,115,47,2016,28375,44,5,49,296,376
47115,115,47,2017,28425,152,3,155,321,424
47115,115,47,2018,28593,178,2,180,338,350
47115,115,47,2019,28878,330,2,332,306,353
47115,115,47,2020,28924,107,2,109,307,371
47117,117,47,2010,30688,32,4,36,95,50
47117,117,47,2011,30855,111,12,123,371,327
47117,117,47,2012,30980,40,13,53,357,279
47117,117,47,2013,31147,105,15,120,354,302
47117,117,47,2014,31293,126,3,129,341,319
47117,117,47,2015,31597,187,44,231,408,334
47117,117,47,2016,32076,402,68,470,380,371
47117,117,47,2017,33077,895,75,970,373,345
47117,117,47,2018,33865,659,71,730,433,379
47117,117,47,2019,34507,533,34,567,406,331
47117,117,47,2020,35016,442,32,474,425,388
47119,119,47,2010,81230,68,18,86,312,152
47119,119,47,2011,81601,-138,114,-24,1143,745
47119,119,47,2012,82147,171,77,248,1043,733
47119,119,47,2013,83722,1198,84,1282,1061,795
47119,119,47,2014,85498,1448,44,1492,1088,842
47119,119,47,2015,87547,1777,53,1830,1134,938
47119,119,47,2016,89719,1884,20,1904,1185,927
47119,119,47,2017,92393,2367,54,2421,1182,945
47119,119,47,2018,94577,1866,53,1919,1236,980
47119,119,47,2019,96795,1970,19,1989,1223,992
47119,119,47,2020,99590,2668,16,2684,1207,1084
47121,121,47,2010,11791,17,0,17,34,25
47121,121,47,2011,11689,-42,-3,-45,93,151
47121,121,47,2012,11673,32,-1,31,105,148
47121,121,47,2013,11668,11,0,11,143,160
47121,121,47,2014,11713,79,-1,78,108,140
47121,121,47,2015,11813,122,0,122,125,148
47121,121,47,2016,11974,190,0,190,140,169
47121,121,47,2017,12054,151,0,151,109,180
47121,121,47,2018,12267,240,0,240,129,158
47121,121,47,2019,12358,138,0,138,135,181
47121,121,47,2020,12532,229,0,229,130,184
47123,123,47,2010,44610,75,4,79,131,94
47123,123,47,2011,44911,275,51,326,502,527
47123,123,47,2012,45106,191,22,213,450,469
47123,123,47,2013,45242,62,63,125,499,481
47123,123,47,2014,45407,126,24,150,549,529
47123,123,47,2015,45645,285,12,297,494,549
47123,123,47,2016,45905,287,1,288,516,542
47123,123,47,2017,46032,284,-11,273,446,590
47123,123,47,2018,46303,379,-9,370,503,603
47123,123,47,2019,46650,455,-21,434,513,599
47123,123,47,2020,47177,669,-14,655,507,631
47125,125,47,2010,173181,184,150,334,774,310
47125,125,47,2011,176603,1103,345,1448,2997,1030
47125,125,47,2012,184946,4192,1557,5749,3496,1088
47125,125,47,2013,184480,-3667,826,-2841,3406,1099
47125,125,47,2014,189294,2002,592,2594,3291,1131
47125,125,47,2015,192749,422,770,1192,3448,1181
47125,125,47,2016,194823,-409,332,-77,3443,1285
47125,125,47,2017,200228,3102,118,3220,3393,1239
47125,125,47,2018,205849,3606,-62,3544,3523,1476
47125,125,47,2019,209807,1971,-69,1902,3479,1433
47125,125,47,2020,214251,2445,-8,2437,3482,1483
47127,127,47,2010,6333,-1,0,-1,17,28
47127,127,47,2011,6368,55,1,56,44,65
47127,127,47,2012,6290,-58,0,-58,48,68
47127,127,47,2013,6276,4,0,4,52,70
47127,127,47,2014,6286,15,0,15,55,58
47127,127,47,2015,6261,-10,8,-2,48,71
47127,127,47,2016,6287,31,12,43,42,58
47127,127,47,2017,6387,105,12,117,55,72
47127,127,47,2018,6431,50,13,63,55,73
47127,127,47,2019,6439,3,5,8,61,61
47127,127,47,2020,6438,0,4,4,57,63
47129,129,47,2010,22028,12,0,12,55,33
47129,129,47,2011,22010,12,1,13,195,225
47129,129,47,2012,21908,-63,0,-63,166,204
47129,129,47,2013,21691,-209,0,-209,215,227
47129,129,47,2014,21714,77,2,79,180,233
47129,129,47,2015,21514,-193,2,-191,230,241
47129,129,47,2016,21761,277,2,279,217,249
47129,129,47,2017,21574,-128,2,-126,193,254
47129,129,47,2018,21541,25,0,25,194,252
47129,129,47,2019,21385,-106,1,-105,207,259
47129,129,47,2020,21431,121,1,122,188,263
47131,131,47,2010,31822,6,-2,4,79,63
47131,131,47,2011,31679,-112,-4,-116,355,381
47131,131,47,2012,31320,-314,-3,-317,378,429
47131,131,47,2013,31032,-244,2,-242,347,393
47131,131,47,2014,30845,-128,5,-123,331,394
47131,131,47,2015,30580,-234,8,-226,333,371
47131,131,47,2016,30572,-5,8,3,365,374
47131,131,47,2017,30409,-128,19,-109,337,391
47131,131,47,2018,30353,-36,10,-26,344,373
47131,131,47,2019,30249,-60,14,-46,351,411
47131,131,47,2020,30131,-34,12,-22,347,442
47133,133,47,2010,22085,25,1,26,65,81
47133,133,47,2011,22160,87,-1,86,253,264
47133,133,47,2012,22158,17,0,17,260,275
47133,133,47,2013,21965,-91,1,-90,212,311
47133,133,47,2014,21945,27,1,28,241,285
47133,133,47,2015,22062,171,3,174,221,278
47133,133,47,2016,21951,-24,2,-22,218,305
47133,133,47,2017,21995,104,0,104,232,292
47133,133,47,2018,22071,191,1,192,235,351
47133,133,47,2019,22271,268,-1,267,241,306
47133,133,47,2020,22566,393,-1,392,241,337
47135,135,47,2010,7940,18,0,18,31,39
47135,135,47,2011,7867,-66,0,-66,91,97
47135,135,47,2012,7856,-8,0,-8,92,94
47135,135,47,2013,7883,34,2,36,103,111
47135,135,47,2014,7822,-54,0,-54,102,108
47135,135,47,2015,7855,59,5,64,100,132
47135,135,47,2016,7888,59,7,66,95,126
47135,135,47,2017,7963,90,9,99,98,121
47135,135,47,2018,8065,114,10,124,111,132
47135,135,47,2019,8084,11,6,17,109,107
47135,135,47,2020,8099,9,4,13,106,106
47137,137,47,2010,5082,0,1,1,15,20
47137,137,47,2011,5125,68,-2,66,42,66
47137,137,47,2012,5049,-42,-1,-43,39,72
47137,137,47,2013,5015,28,-2,26,26,85
47137,137,47,2014,5081,72,-2,70,45,53
47137,137,47,2015,5143,89,0,89,47,74
47137,137,47,2016,5093,-33,0,-33,45,62
47137,137,47,2017,5069,2,0,2,51,76
47137,137,47,2018,5050,46,0,46,29,94
47137,137,47,2019,5068,44,0,44,43,68
47137,137,47,2020,5061,15,0,15,41,63
47139,139,47,2010,16813,9,-1,8,32,47
47139,139,47,2011,16772,34,-6,28,149,217
47139,139,47,2012,16626,-65,-2,-67,141,219
47139,139,47,2013,16636,106,-4,102,148,242
47139,139,47,2014,16690,79,-3,76,172,194
47139,139,47,2015,16778,129,2,131,184,227
47139,139,47,2016,16787,76,2,78,150,218
47139,139,47,2017,16769,40,3,43,170,231
47139,139,47,2018,16880,182,4,186,172,248
47139,139,47,2019,16764,-41,2,-39,168,245
47139,139,47,2020,16835,171,1,172,162,262
47141,141,47,2010,72552,109,14,123,232,147
47141,141,47,2011,73071,76,189,265,905,648
47141,141,47,2012,73540,184,197,381,867,769
47141,141,47,2013,74106,132,344,476,865,761
47141,141,47,2014,74946,419,270,689,926,773
47141,141,47,2015,75091,-97,251,154,857,855
47141,141,47,2016,75984,714,127,841,901,850
47141,141,47,2017,77246,1040,132,1172,890,803
47141,141,47,2018,78596,1093,146,1239,903,796
47141,141,47,2019,79957,1318,55,1373,867,877
47141,141,47,2020,80929,861,45,906,909,842
47143,143,47,2010,31860,22,2,24,95,58
47143,143,47,2011,32088,172,24,196,384,354
47143,143,47,2012,32378,240,10,250,374,336
47143,143,47,2013,32545,107,33,140,393,363
47143,143,47,2014,32648,75,40,115,391,398
47143,143,47,2015,32402,-227,40,-187,377,435
47143,143,47,2016,32530,116,36,152,397,419
47143,143,47,2017,32709,192,34,226,396,441
47143,143,47,2018,32933,237,21,258,388,422
47143,143,47,2019,33206,298,23,321,378,426
47143,143,47,2020,33443,264,21,285,376,425
47145,145,47,2010,54173,-38,2,-36,137,129
47145,145,47,2011,53996,0,12,12,510,696
47145,145,47,2012,53628,-202,15,-187,477,653
47145,145,47,2013,53175,-217,13,-204,488,732
47145,145,47,2014,52870,-28,-2,-30,446,707
47145,145,47,2015,52799,209,-4,205,442,713
47145,145,47,2016,52988,444,-21,423,489,723
47145,145,47,2017,53039,377,-18,359,441,748
47145,145,47,2018,53313,616,-17,599,492,816
47145,145,47,2019,53476,472,-24,448,464,749
47145,145,47,2020,53841,725,-15,710,463,803
47147,147,47,2010,66314,0,1,1,197,191
47147,147,47,2011,66775,118,60,178,887,602
47147,147,47,2012,66809,-301,13,-288,955,629
47147,147,47,2013,67423,301,65,366,871,618
47147,147,47,2014,68063,287,59,346,872,576
47147,147,47,2015,68709,373,65,438,886,673
47147,147,47,2016,69439,455,52,507,891,669
47147,147,47,2017,70342,678,66,744,840,685
47147,147,47,2018,71159,542,41,583,935,703
47147,147,47,2019,71693,347,44,391,853,712
47147,147,47,2020,72275,383,32,415,891,725
47149,149,47,2010,263721,453,43,496,934,324
47149,149,47,2011,269206,2859,509,3368,3686,1586
47149,149,47,2012,274482,2759,430,3189,3653,1621
47149,149,47,2013,281277,4105,608,4713,3655,1660
47149,149,47,2014,289014,4828,546,5374,3860,1620
47149,149,47,2015,298401,6506,638,7144,3979,1828
47149,149,47,2016,307724,6583,417,7000,4142,1853
47149,149,47,2017,316777,6513,530,7043,4007,2035
47149,149,47,2018,324809,5419,613,6032,4107,2123
47149,149,47,2019,332125,5148,145,5293,4205,2176
47149,149,47,2020,339261,5081,132,5213,4254,2322
47151,151,47,2010,22226,-3,0,-3,69,70
47151,151,47,2011,22107,-79,-2,-81,225,261
47151,151,47,2012,22176,58,-1,57,285,268
47151,151,47,2013,22068,-115,-2,-117,280,271
47151,151,47,2014,21994,-90,-1,-91,282,267
47151,151,47,2015,21896,-62,1,-61,254,289
47151,151,47,2016,21899,-10,-1,-11,281,266
47151,151,47,2017,21971,87,2,89,269,285
47151,151,47,2018,22036,101,2,103,280,316
47151,151,47,2019,22102,68,1,69,245,248
47151,151,47,2020,22090,25,1,26,251,292
47153,153,47,2010,14124,-12,-1,-13,40,19
47153,153,47,2011,14272,143,-1,142,154,149
47153,153,47,2012,14349,65,-2,63,164,148
47153,153,47,2013,14537,191,-1,190,134,140
47153,153,47,2014,14636,125,-1,124,146,170
47153,153,47,2015,14641,11,0,11,164,169
47153,153,47,2016,14748,127,-4,123,149,164
47153,153,47,2017,14766,11,-2,9,171,162
47153,153,47,2018,14919,142,-2,140,165,152
47153,153,47,2019,15071,161,-3,158,171,175
47153,153,47,2020,15176,117,-2,115,173,183
47155,155,47,2010,89921,166,33,199,257,247
47155,155,47,2011,91201,950,168,1118,1044,884
47155,155,47,2012,92385,839,170,1009,1021,865
47155,155,47,2013,93515,832,201,1033,1038,950
47155,155,47,2014,94716,996,142,1138,1040,993
47155,155,47,2015,95492,647,164,811,1034,1066
47155,155,47,2016,96613,845,157,1002,1103,982
47155,155,47,2017,97544,745,253,998,1058,1126
47155,155,47,2018,98231,392,316,708,1061,1081
47155,155,47,2019,98402,153,104,257,1043,1130
47155,155,47,2020,99244,849,101,950,1041,1146
47157,157,47,2010,928475,-926,204,-722,3284,1746
47157,157,47,2011,933321,-2956,1613,-1343,13740,7541
47157,157,47,2012,939421,-1597,1248,-349,14113,7477
47157,157,47,2013,938713,-8199,1524,-6675,13772,7948
47157,157,47,2014,937949,-8065,1201,-6864,13834,7825
47157,157,47,2015,937598,-7627,1617,-6010,13695,8051
47157,157,47,2016,936716,-7585,1331,-6254,13370,8003
47157,157,47,2017,936012,-7207,1552,-5655,13171,8230
47157,157,47,2018,937239,-5288,1687,-3601,13256,8428
47157,157,47,2019,937070,-5086,609,-4477,12836,8548
47157,157,47,2020,936017,-5241,521,-4720,12832,9204
47159,159,47,2010,19127,-11,0,-11,60,72
47159,159,47,2011,19211,94,-1,93,211,219
47159,159,47,2012,19185,-16,-1,-17,216,222
47159,159,47,2013,19123,-72,-1,-73,231,221
47159,159,47,2014,19104,-54,0,-54,248,210
47159,159,47,2015,19316,202,2,204,209,203
47159,159,47,2016,19542,180,1,181,240,196
47159,159,47,2017,19743,145,-1,144,256,200
47159,159,47,2018,19946,239,-1,238,193,229
47159,159,47,2019,20115,168,-2,166,230,226
47159,159,47,2020,20285,198,-3,195,216,241
47161,161,47,2010,13347,29,4,33,35,32
47161,161,47,2011,13223,-112,1,-111,135,149
47161,161,47,2012,13309,82,26,108,130,154
47161,161,47,2013,13277,-3,6,3,125,159
47161,161,47,2014,13211,-31,3,-28,136,171
47161,161,47,2015,13193,31,1,32,125,174
47161,161,47,2016,13191,20,-5,15,135,153
47161,161,47,2017,13424,239,-2,237,146,151
47161,161,47,2018,13594,194,0,194,132,154
47161,161,47,2019,13699,139,-6,133,152,180
47161,161,47,2020,13859,214,-3,211,143,192
47163,163,47,2010,156756,57,7,64,395,483
47163,163,47,2011,156895,533,17,550,1551,1955
47163,163,47,2012,156367,-45,2,-43,1522,1969
47163,163,47,2013,156258,363,19,382,1630,2100
47163,163,47,2014,156509,684,-6,678,1578,1987
47163,163,47,2015,156336,360,16,376,1531,2060
47163,163,47,2016,156372,583,14,597,1526,2076
47163,163,47,2017,157154,1288,42,1330,1538,2083
47163,163,47,2018,157785,1244,45,1289,1473,2132
47163,163,47,2019,158469,1284,-1,1283,1519,2117
47163,163,47,2020,158755,931,10,941,1491,2144
47165,165,47,2010,161226,391,13,404,470,298
47165,165,47,2011,163713,1810,125,1935,1858,1314
47165,165,47,2012,166026,1533,83,1616,1934,1252
47165,165,47,2013,168839,2156,96,2252,1956,1420
47165,165,47,2014,172380,2690,76,2766,2114,1384
47165,165,47,2015,175467,2261,154,2415,2127,1469
47165,165,47,2016,179474,3347,134,3481,2035,1519
47165,165,47,2017,184016,3861,177,4038,2083,1595
47165,165,47,2018,187854,3091,231,3322,2240,1728
47165,165,47,2019,191497,3148,55,3203,2136,1688
47165,165,47,2020,195561,3725,57,3782,2156,1857
47167,167,47,2010,61067,-6,3,-3,201,138
47167,167,47,2011,61313,-20,49,29,738,521
47167,167,47,2012,61542,-83,41,-42,759,485
47167,167,47,2013,61594,-212,50,-162,740,525
47167,167,47,2014,61625,-220,35,-185,749,533
47167,167,47,2015,61570,-199,18,-181,723,596
47167,167,47,2016,61242,-436,2,-434,709,604
47167,167,47,2017,61335,52,8,60,700,664
47167,167,47,2018,61601,203,8,211,676,618
47167,167,47,2019,61715,26,-6,20,707,613
47167,167,47,2020,61918,164,-2,162,688,651
47169,169,47,2010,7868,-1,1,0,19,8
47169,169,47,2011,7812,-52,-1,-53,89,92
47169,169,47,2012,7795,-20,2,-18,91,90
47169,169,47,2013,7814,23,6,29,83,92
47169,169,47,2014,8001,168,4,172,97,87
47169,169,47,2015,8053,49,1,50,112,110
47169,169,47,2016,9955,1883,-2,1881,97,97
47169,169,47,2017,10833,881,-3,878,101,113
47169,169,47,2018,11030,174,-2,172,116,92
47169,169,47,2019,11277,215,-5,210,124,86
47169,169,47,2020,11455,138,-2,136,124,82
47171,171,47,2010,18283,-17,3,-14,30,42
47171,171,47,2011,18303,91,18,109,167,256
47171,171,47,2012,18256,24,8,32,158,234
47171,171,47,2013,18102,-53,9,-44,167,273
47171,171,47,2014,17957,-15,-7,-22,156,277
47171,171,47,2015,17830,-2,11,9,157,292
47171,171,47,2016,17736,27,13,40,143,274
47171,171,47,2017,17833,190,37,227,166,295
47171,171,47,2018,17867,133,27,160,166,290
47171,171,47,2019,17914,158,25,183,161,296
47171,171,47,2020,17755,-41,22,-19,155,295
47173,173,47,2010,19118,-20,0,-20,50,19
47173,173,47,2011,19193,65,-6,59,210,193
47173,173,47,2012,19107,-107,-2,-109,221,199
47173,173,47,2013,19064,-55,-1,-56,228,212
47173,173,47,2014,18992,25,5,30,158,255
47173,173,47,2015,19159,160,7,167,206,208
47173,173,47,2016,19222,74,3,77,220,235
47173,173,47,2017,19394,198,-2,196,199,222
47173,173,47,2018,19651,273,-1,272,216,233
47173,173,47,2019,19936,290,-2,288,209,213
47173,173,47,2020,20187,278,-1,277,210,235
47175,175,47,2010,5567,3,0,3,13,6
47175,175,47,2011,5555,-12,0,-12,57,56
47175,175,47,2012,5652,103,0,103,47,56
47175,175,47,2013,5573,-79,0,-79,63,65
47175,175,47,2014,5696,137,0,137,61,79
47175,175,47,2015,5697,13,0,13,68,78
47175,175,47,2016,5721,42,0,42,66,85
47175,175,47,2017,5747,35,0,35,64,71
47175,175,47,2018,5777,50,0,50,72,91
47175,175,47,2019,5874,108,0,108,69,80
47175,175,47,2020,5947,73,0,73,68,67
47177,177,47,2010,39859,8,-2,6,111,78
47177,177,47,2011,39910,36,31,67,510,523
47177,177,47,2012,39757,-167,13,-154,443,439
47177,177,47,2013,39883,55,54,109,499,475
47177,177,47,2014,39993,59,44,103,489,475
47177,177,47,2015,40271,264,40,304,455,478
47177,177,47,2016,40424,174,17,191,468,504
47177,177,47,2017,40698,241,45,286,500,511
47177,177,47,2018,40859,176,18,194,485,517
47177,177,47,2019,41269,434,25,459,478,526
47177,177,47,2020,41605,323,25,348,496,508
47179,179,47,2010,123393,255,7,262,356,299
47179,179,47,2011,123910,417,69,486,1315,1284
47179,179,47,2012,124914,864,84,948,1352,1315
47179,179,47,2013,125454,434,137,571,1370,1391
47179,179,47,2014,125821,255,132,387,1312,1305
47179,179,47,2015,126238,335,215,550,1317,1440
47179,179,47,2016,127439,1050,207,1257,1335,1392
47179,179,47,2017,127869,425,230,655,1279,1500
47179,179,47,2018,129025,1147,280,1427,1216,1489
47179,179,47,2019,129670,749,104,853,1242,1451
47179,179,47,2020,130367,881,82,963,1231,1500
47181,181,47,2010,16981,-5,0,-5,33,67
47181,181,47,2011,16997,69,1,70,129,183
47181,181,47,2012,16972,-24,0,-24,158,157
47181,181,47,2013,16918,16,2,18,149,217
47181,181,47,2014,16857,-3,1,-2,146,204
47181,181,47,2015,16765,-10,1,-9,144,225
47181,181,47,2016,16754,47,1,48,144,202
47181,181,47,2017,16637,-16,1,-15,126,227
47181,181,47,2018,16633,52,0,52,144,200
47181,181,47,2019,16644,95,0,95,118,201
47181,181,47,2020,16524,-28,1,-27,123,217
47183,183,47,2010,35044,-19,1,-18,104,55
47183,183,47,2011,34860,-162,10,-152,347,378
47183,183,47,2012,34556,-311,10,-301,361,372
47183,183,47,2013,34154,-348,20,-328,340,420
47183,183,47,2014,34003,-214,29,-185,367,335
47183,183,47,2015,33875,-143,50,-93,351,384
47183,183,47,2016,33591,-262,27,-235,335,385
47183,183,47,2017,33323,-240,40,-200,333,401
47183,183,47,2018,33368,102,43,145,298,396
47183,183,47,2019,33269,-79,23,-56,344,388
47183,183,47,2020,33334,127,19,146,318,400
47185,185,47,2010,25833,15,0,15,77,103
47185,185,47,2011,26058,272,8,280,281,337
47185,185,47,2012,26043,46,8,54,310,375
47185,185,47,2013,26207,201,7,208,293,338
47185,185,47,2014,26279,145,8,153,327,408
47185,185,47,2015,26363,120,9,129,299,340
47185,185,47,2016,26473,200,2,202,288,380
47185,185,47,2017,26780,359,2,361,302,357
47185,185,47,2018,27099,423,3,426,290,397
47185,185,47,2019,27378,340,2,342,299,362
47185,185,47,2020,27707,414,1,415,285,369
47187,187,47,2010,184082,485,61,546,490,175
47187,187,47,2011,188464,3007,394,3401,1962,990
47187,187,47,2012,193207,3294,367,3661,2008,981
47187,187,47,2013,199177,4406,466,4872,2018,985
47187,187,47,2014,205395,4748,360,5108,2084,1058
47187,187,47,2015,211713,4619,547,5166,2223,1103
47187,187,47,2016,219105,5839,505,6344,2258,1223
47187,187,47,2017,226373,5624,561,6185,2380,1296
47187,187,47,2018,232517,4464,687,5151,2342,1334
47187,187,47,2019,238556,4987,189,5176,2293,1409
47187,187,47,2020,245348,5860,159,6019,2310,1501
47189,189,47,2010,114681,401,14,415,333,150
47189,189,47,2011,116814,1557,149,1706,1306,886
47189,189,47,2012,119172,1801,88,1889,1363,939
47189,189,47,2013,122033,2327,96,2423,1345,942
47189,189,47,2014,125253,2668,86,2754,1454,1052
47189,189,47,2015,128610,2840,146,2986,1415,1080
47189,189,47,2016,132649,3409,125,3534,1558,1066
47189,189,47,2017,136824,3538,163,3701,1492,1035
47189,189,47,2018,140909,3460,197,3657,1611,1194
47189,189,47,2019,144507,3053,46,3099,1676,1170
47189,189,47,2020,148130,3227,56,3283,1669,1312
48001,001,48,2010,58498,-3,2,-1,149,104
48001,001,48,2011,58404,-38,-5,-43,594,642
48001,001,48,2012,58074,-284,11,-273,570,625
48001,001,48,2013,57982,-83,34,-49,583,616
48001,001,48,2014,57846,-54,48,-6,587,702
48001,001,48,2015,57665,-208,59,-149,584,613
48001,001,48,2016,57595,-100,64,-36,640,673
48001,001,48,2017,58232,667,58,725,582,677
48001,001,48,2018,58138,-12,48,36,629,756
48001,001,48,2019,57816,-286,50,-236,629,718
48001,001,48,2020,57805,55,40,95,578,688
48003,003,48,2010,14849,10,9,19,58,13
48003,003,48,2011,15387,398,0,398,261,124
48003,003,48,2012,16102,535,3,538,285,130
48003,003,48,2013,16774,429,21,450,333,120
48003,003,48,2014,17424,411,28,439,332,131
48003,003,48,2015,18058,376,32,408,349,127
48003,003,48,2016,17775,-514,50,-464,299,121
48003,003,48,2017,17599,-370,17,-353,300,124
48003,003,48,2018,18063,324,15,339,321,196
48003,003,48,2019,18821,587,27,614,322,176
48003,003,48,2020,18879,-171,21,-150,325,117
48005,005,48,2010,86905,39,2,41,280,177
48005,005,48,2011,87299,-6,15,9,1241,851
48005,005,48,2012,87511,-186,-12,-198,1243,820
48005,005,48,2013,87317,-507,26,-481,1168,881
48005,005,48,2014,87575,-139,54,-85,1208,853
48005,005,48,2015,87837,-94,66,-28,1198,898
48005,005,48,2016,87661,-491,26,-465,1199,908
48005,005,48,2017,87523,-375,11,-364,1146,918
48005,005,48,2018,86854,-841,-4,-845,1121,947
48005,005,48,2019,86761,-247,-7,-254,1137,978
48005,005,48,2020,86796,-68,-9,-77,1101,993
48007,007,48,2010,23189,41,4,45,69,93
48007,007,48,2011,23222,108,16,124,232,322
48007,007,48,2012,23466,315,11,326,245,343
48007,007,48,2013,23893,526,2,528,228,344
48007,007,48,2014,24573,689,0,689,295,327
48007,007,48,2015,24812,361,-7,354,251,370
48007,007,48,2016,25216,464,-1,463,291,351
48007,007,48,2017,25421,321,-5,316,224,336
48007,007,48,2018,23283,-2022,-7,-2029,230,344
48007,007,48,2019,23364,201,-3,198,236,351
48007,007,48,2020,23814,611,1,612,219,376
48009,009,48,2010,9118,47,0,47,21,12
48009,009,48,2011,8840,-286,4,-282,65,63
48009,009,48,2012,8815,-26,3,-23,69,73
48009,009,48,2013,8799,-2,1,-1,68,81
48009,009,48,2014,8842,56,2,58,69,83
48009,009,48,2015,8762,-101,0,-101,96,77
48009,009,48,2016,8780,35,3,38,81,100
48009,009,48,2017,8788,21,3,24,80,97
48009,009,48,2018,8778,10,2,12,103,124
48009,009,48,2019,8692,-46,2,-44,97,138
48009,009,48,2020,8730,27,3,30,73,65
48011,011,48,2010,1902,-2,0,-2,5,2
48011,011,48,2011,1936,39,5,44,18,27
48011,011,48,2012,1953,19,5,24,21,28
48011,011,48,2013,1940,-8,0,-8,29,36
48011,011,48,2014,1914,-14,0,-14,18,29
48011,011,48,2015,1901,-5,0,-5,19,28
48011,011,48,2016,1838,-34,0,-34,14,43
48011,011,48,2017,1866,28,0,28,23,22
48011,011,48,2018,1859,-5,0,-5,23,27
48011,011,48,2019,1853,-1,0,-1,14,18
48011,011,48,2020,1869,28,0,28,16,27
48013,013,48,2010,44964,9,1,10,151,116
48013,013,48,2011,45506,270,-12,258,673,387
48013,013,48,2012,46444,703,-7,696,594,373
48013,013,48,2013,47029,297,1,298,662,374
48013,013,48,2014,47730,434,10,444,659,411
48013,013,48,2015,48382,292,14,306,751,404
48013,013,48,2016,48689,41,12,53,638,382
48013,013,48,2017,49094,71,6,77,711,379
48013,013,48,2018,50325,962,1,963,700,433
48013,013,48,2019,51140,541,-2,539,706,428
48013,013,48,2020,51724,346,0,346,701,464
48015,015,48,2010,28372,-21,13,-8,67,105
48015,015,48,2011,28612,90,52,142,351,252
48015,015,48,2012,28572,-174,42,-132,335,244
48015,015,48,2013,28690,44,11,55,331,263
48015,015,48,2014,28975,186,21,207,338,260
48015,015,48,2015,29477,389,25,414,372,286
48015,015,48,2016,29650,76,30,106,358,288
48015,015,48,2017,29729,34,11,45,331,295
48015,015,48,2018,30000,203,0,203,330,260
48015,015,48,2019,30107,68,11,79,325,295
48015,015,48,2020,29972,-149,6,-143,332,324
48017,017,48,2010,7154,-8,4,-4,21,29
48017,017,48,2011,7175,-87,37,-50,135,64
48017,017,48,2012,7139,-159,43,-116,126,51
48017,017,48,2013,7123,-81,22,-59,106,63
48017,017,48,2014,6962,-244,33,-211,108,63
48017,017,48,2015,7219,146,39,185,129,59
48017,017,48,2016,7138,-146,0,-146,129,65
48017,017,48,2017,6987,-230,-5,-235,143,60
48017,017,48,2018,6901,-138,-7,-145,122,62
48017,017,48,2019,6859,-116,-5,-121,117,36
48017,017,48,2020,6697,-231,-1,-232,117,45
48019,019,48,2010,20546,62,0,62,40,30
48019,019,48,2011,20526,9,5,14,170,203
48019,019,48,2012,20579,45,8,53,181,179
48019,019,48,2013,20543,7,2,9,155,196
48019,019,48,2014,20800,327,7,334,141,224
48019,019,48,2015,21127,374,4,378,161,214
48019,019,48,2016,21678,608,10,618,159,229
48019,019,48,2017,22312,656,7,663,200,231
48019,019,48,2018,22816,575,7,582,191,272
48019,019,48,2019,23181,427,10,437,163,234
48019,019,48,2020,23861,752,10,762,170,246
48021,021,48,2010,74381,146,-5,141,184,176
48021,021,48,2011,75058,354,14,368,875,564
48021,021,48,2012,74745,-565,20,-545,797,580
48021,021,48,2013,75809,820,-31,789,892,623
48021,021,48,2014,77726,1493,11,1504,1036,657
48021,021,48,2015,80109,1972,0,1972,1033,646
48021,021,48,2016,82642,2071,26,2097,1109,680
48021,021,48,2017,84624,1598,-8,1590,1087,697
48021,021,48,2018,86590,1626,-26,1600,1092,728
48021,021,48,2019,88737,1838,-34,1804,1070,722
48021,021,48,2020,91601,2609,-21,2588,1095,803
48023,023,48,2010,3708,2,0,2,8,28
48023,023,48,2011,3696,6,0,6,37,55
48023,023,48,2012,3593,-75,0,-75,40,70
48023,023,48,2013,3581,18,0,18,43,72
48023,023,48,2014,3569,-9,0,-9,36,40
48023,023,48,2015,3610,64,0,64,40,63
48023,023,48,2016,3636,47,0,47,38,59
48023,023,48,2017,3554,-52,0,-52,38,68
48023,023,48,2018,3565,50,0,50,34,72
48023,023,48,2019,3525,-39,0,-39,39,40
48023,023,48,2020,3518,0,0,0,38,45
48025,025,48,2010,31862,10,2,12,88,94
48025,025,48,2011,32316,341,14,355,338,242
48025,025,48,2012,32486,14,16,30,383,238
48025,025,48,2013,32811,139,5,144,386,204
48025,025,48,2014,32847,-66,4,-62,385,281
48025,025,48,2015,32620,-383,3,-380,414,265
48025,025,48,2016,32823,55,4,59,400,255
48025,025,48,2017,32598,-321,5,-316,344,255
48025,025,48,2018,32494,-141,5,-136,336,305
48025,025,48,2019,32618,58,1,59,305,242
48025,025,48,2020,32513,-205,2,-203,307,210
48027,027,48,2010,312886,1009,451,1460,1551,393
48027,027,48,2011,315915,-2241,490,-1751,6657,1882
48027,027,48,2012,325138,2638,2415,5053,5891,1863
48027,027,48,2013,327254,-4011,1488,-2523,6522,1927
48027,027,48,2014,330436,-2620,1562,-1058,6317,2071
48027,027,48,2015,336434,-55,1912,1857,6378,2200
48027,027,48,2016,341477,-245,1202,957,6318,2223
48027,027,48,2017,347683,1683,802,2485,5857,2141
48027,027,48,2018,355722,3737,550,4287,6031,2301
48027,027,48,2019,363693,4201,160,4361,5921,2326
48027,027,48,2020,369927,2462,337,2799,5939,2527
48029,029,48,2010,1722841,3580,867,4447,6214,2790
48029,029,48,2011,1755360,13822,3845,17667,26202,11408
48029,029,48,2012,1788768,12743,6009,18752,25870,11412
48029,029,48,2013,1821354,13531,4734,18265,26433,12289
48029,029,48,2014,1857977,15418,5841,21259,27456,12272
48029,029,48,2015,1894811,15501,6128,21629,28139,12976
48029,029,48,2016,1927409,12240,5154,17394,28093,12887
48029,029,48,2017,1956394,10805,4152,14957,27351,13346
48029,029,48,2018,1981061,8717,2867,11584,26823,13764
48029,029,48,2019,2002445,6775,2176,8951,26522,14178
48029,029,48,2020,2026823,10790,2056,12846,26476,15038
48031,031,48,2010,10501,26,8,34,21,40
48031,031,48,2011,10569,72,21,93,99,123
48031,031,48,2012,10619,41,16,57,97,104
48031,031,48,2013,10639,47,12,59,72,110
48031,031,48,2014,10807,155,19,174,86,96
48031,031,48,2015,11030,224,15,239,105,123
48031,031,48,2016,11291,287,5,292,100,133
48031,031,48,2017,11473,195,2,197,100,116
48031,031,48,2018,11661,245,2,247,76,135
48031,031,48,2019,11971,364,1,365,82,135
48031,031,48,2020,12269,358,5,363,83,145
48033,033,48,2010,646,4,0,4,1,0
48033,033,48,2011,632,-14,0,-14,6,6
48033,033,48,2012,613,-15,0,-15,3,6
48033,033,48,2013,646,28,0,28,8,4
48033,033,48,2014,665,13,0,13,8,3
48033,033,48,2015,655,-9,0,-9,5,7
48033,033,48,2016,658,0,0,0,10,6
48033,033,48,2017,669,8,0,8,8,4
48033,033,48,2018,650,-20,0,-20,3,3
48033,033,48,2019,656,6,0,6,4,5
48033,033,48,2020,706,54,0,54,4,7
48035,035,48,2010,18269,56,-1,55,51,50
48035,035,48,2011,18260,73,-2,71,177,255
48035,035,48,2012,18127,-75,3,-72,183,246
48035,035,48,2013,17864,-231,2,-229,200,239
48035,035,48,2014,17715,-64,4,-60,177,263
48035,035,48,2015,17860,196,4,200,174,229
48035,035,48,2016,18035,195,15,210,214,249
48035,035,48,2017,18309,348,11,359,175,260
48035,035,48,2018,18598,365,8,373,188,273
48035,035,48,2019,18594,76,10,86,153,242
48035,035,48,2020,18603,109,8,117,159,267
48037,037,48,2010,92645,46,11,57,302,273
48037,037,48,2011,92832,-98,47,-51,1213,972
48037,037,48,2012,93068,-121,65,-56,1223,918
48037,037,48,2013,93425,122,58,180,1196,1007
48037,037,48,2014,93337,-436,114,-322,1215,977
48037,037,48,2015,93146,-452,77,-375,1222,1034
48037,037,48,2016,93575,76,90,166,1271,1002
48037,037,48,2017,93625,-214,70,-144,1207,1011
48037,037,48,2018,93922,217,50,267,1119,1084
48037,037,48,2019,93505,-561,52,-509,1133,1041
48037,037,48,2020,93481,-98,39,-59,1098,1068
48039,039,48,2010,314499,514,82,596,1205,505
48039,039,48,2011,319214,1682,302,1984,4700,1969
48039,039,48,2012,324295,2101,435,2536,4505,1956
48039,039,48,2013,329961,2800,417,3217,4550,2133
48039,039,48,2014,337632,4423,648,5071,4762,2247
48039,039,48,2015,345295,4394,501,4895,4885,2149
48039,039,48,2016,353361,4878,608,5486,4873,2306
48039,039,48,2017,362261,5920,607,6527,4684,2328
48039,039,48,2018,369470,4469,480,4949,4694,2437
48039,039,48,2019,374699,2761,253,3014,4756,2546
48039,039,48,2020,380518,3647,271,3918,4721,2816
48041,041,48,2010,195671,80,302,382,670,227
48041,041,48,2011,197481,-1124,1133,9,2612,824
48041,041,48,2012,200304,-191,1325,1134,2586,872
48041,041,48,2013,204164,866,1301,2167,2627,930
48041,041,48,2014,209039,1363,1727,3090,2703,935
48041,041,48,2015,216339,3771,1646,5417,2893,1077
48041,041,48,2016,219881,179,1467,1646,2888,990
48041,041,48,2017,223985,1016,1385,2401,2670,976
48041,041,48,2018,226011,-611,998,387,2714,1085
48041,041,48,2019,229418,997,1022,2019,2534,1154
48041,041,48,2020,232555,977,810,1787,2587,1262
48043,043,48,2010,9258,40,2,42,25,45
48043,043,48,2011,9350,40,2,42,136,86
48043,043,48,2012,9262,-125,-2,-127,103,66
48043,043,48,2013,9288,-36,-1,-37,124,61
48043,043,48,2014,9148,-179,0,-179,102,66
48043,043,48,2015,9140,-51,10,-41,101,68
48043,043,48,2016,9213,48,7,55,102,84
48043,043,48,2017,9324,123,7,130,81,100
48043,043,48,2018,9236,-128,6,-122,109,73
48043,043,48,2019,9144,-102,1,-101,82,73
48043,043,48,2020,9237,82,3,85,88,79
48045,045,48,2010,1633,-2,0,-2,7,9
48045,045,48,2011,1658,26,1,27,18,21
48045,045,48,2012,1576,-87,1,-86,13,13
48045,045,48,2013,1563,-9,2,-7,11,15
48045,045,48,2014,1553,1,2,3,11,24
48045,045,48,2015,1515,-32,1,-31,13,19
48045,045,48,2016,1481,-20,1,-19,9,24
48045,045,48,2017,1515,37,1,38,13,17
48045,045,48,2018,1511,-5,1,-4,17,17
48045,045,48,2019,1542,28,1,29,18,16
48045,045,48,2020,1487,-64,1,-63,20,12
48047,047,48,2010,7213,-34,5,-29,26,12
48047,047,48,2011,7223,-77,25,-52,137,76
48047,047,48,2012,7203,-111,39,-72,132,82
48047,047,48,2013,7266,-15,55,40,111,86
48047,047,48,2014,7237,-101,36,-65,131,96
48047,047,48,2015,7203,-110,51,-59,115,90
48047,047,48,2016,7220,-84,49,-35,134,82
48047,047,48,2017,7138,-140,42,-98,95,82
48047,047,48,2018,7084,-121,32,-89,105,70
48047,047,48,2019,7093,-70,39,-31,107,67
48047,047,48,2020,6964,-190,29,-161,108,75
48049,049,48,2010,38076,25,3,28,108,160
48049,049,48,2011,37995,-53,18,-35,429,473
48049,049,48,2012,37804,-167,19,-148,417,459
48049,049,48,2013,37663,-72,29,-43,410,502
48049,049,48,2014,37544,-111,39,-72,448,494
48049,049,48,2015,37729,253,27,280,389,482
48049,049,48,2016,38056,358,31,389,432,491
48049,049,48,2017,37816,-148,23,-125,399,511
48049,049,48,2018,37750,65,18,83,363,511
48049,049,48,2019,37770,16,24,40,415,433
48049,049,48,2020,37633,-61,17,-44,383,475
48051,051,48,2010,17238,17,7,24,52,24
48051,051,48,2011,17330,67,33,100,185,192
48051,051,48,2012,17437,78,30,108,191,189
48051,051,48,2013,17272,-170,16,-154,200,212
48051,051,48,2014,17388,102,32,134,191,208
48051,051,48,2015,17612,186,40,226,207,209
48051,051,48,2016,17862,222,40,262,226,238
48051,051,48,2017,18055,171,34,205,223,235
48051,051,48,2018,18329,299,29,328,187,242
48051,051,48,2019,18425,85,27,112,198,214
48051,051,48,2020,18514,107,24,131,193,235
48053,053,48,2010,42760,47,14,61,108,117
48053,053,48,2011,43221,399,34,433,465,437
48053,053,48,2012,43383,86,28,114,460,411
48053,053,48,2013,43580,190,-3,187,457,445
48053,053,48,2014,43957,362,-1,361,468,451
48053,053,48,2015,44738,837,-9,828,484,539
48053,053,48,2016,45836,1034,-20,1014,550,472
48053,053,48,2017,46592,804,-27,777,489,514
48053,053,48,2018,47377,893,-31,862,451,530
48053,053,48,2019,48280,942,-32,910,485,489
48053,053,48,2020,49653,1445,-21,1424,477,517
48055,055,48,2010,38087,-6,3,-3,115,38
48055,055,48,2011,38432,135,10,145,483,283
48055,055,48,2012,38648,63,5,68,453,300
48055,055,48,2013,39167,331,-3,328,478,286
48055,055,48,2014,39670,340,28,368,485,345
48055,055,48,2015,40386,482,37,519,529,333
48055,055,48,2016,41095,477,46,523,530,343
48055,055,48,2017,42302,968,39,1007,551,355
48055,055,48,2018,43129,585,28,613,588,371
48055,055,48,2019,43579,231,20,251,556,358
48055,055,48,2020,43979,195,23,218,565,385
48057,057,48,2010,21312,-77,7,-70,73,73
48057,057,48,2011,21353,-58,17,-41,285,203
48057,057,48,2012,21564,111,34,145,251,186
48057,057,48,2013,21719,50,29,79,285,206
48057,057,48,2014,21799,-78,39,-39,322,200
48057,057,48,2015,21873,-73,40,-33,318,207
48057,057,48,2016,21939,-91,45,-46,305,194
48057,057,48,2017,21716,-329,44,-285,270,209
48057,057,48,2018,21455,-345,41,-304,269,226
48057,057,48,2019,21237,-310,7,-303,279,193
48057,057,48,2020,21001,-282,16,-266,268,237
48059,059,48,2010,13511,-3,0,-3,31,61
48059,059,48,2011,13513,35,6,41,120,158
48059,059,48,2012,13488,-8,5,-3,122,142
48059,059,48,2013,13502,51,5,56,136,176
48059,059,48,2014,13508,36,8,44,141,178
48059,059,48,2015,13595,92,9,101,155,168
48059,059,48,2016,13789,231,4,235,150,191
48059,059,48,2017,13967,183,4,187,163,172
48059,059,48,2018,13986,51,3,54,135,170
48059,059,48,2019,13941,2,2,4,133,182
48059,059,48,2020,14110,245,2,247,121,198
48061,061,48,2010,407608,136,75,211,1817,598
48061,061,48,2011,413116,-643,681,38,7816,2327
48061,061,48,2012,415729,-2970,558,-2412,7359,2369
48061,061,48,2013,417129,-3872,317,-3555,7365,2461
48061,061,48,2014,418698,-3788,557,-3231,7361,2605
48061,061,48,2015,419062,-4852,595,-4257,7248,2660
48061,061,48,2016,420894,-3252,582,-2670,7167,2666
48061,061,48,2017,421506,-3360,70,-3290,6545,2653
48061,061,48,2018,421446,-3492,-111,-3603,6261,2728
48061,061,48,2019,422649,-2198,-59,-2257,6258,2809
48061,061,48,2020,424180,-1712,12,-1700,6223,3006
48063,063,48,2010,12396,-11,9,-2,56,57
48063,063,48,2011,12421,-50,36,-14,173,135
48063,063,48,2012,12487,2,64,66,157,155
48063,063,48,2013,12462,-110,26,-84,205,146
48063,063,48,2014,12654,71,48,119,210,139
48063,063,48,2015,12691,-59,42,-17,200,145
48063,063,48,2016,12751,14,42,56,165,160
48063,063,48,2017,12829,-3,28,25,181,126
48063,063,48,2018,12974,86,23,109,176,139
48063,063,48,2019,13078,32,29,61,181,138
48063,063,48,2020,13060,-86,22,-64,183,138
48065,065,48,2010,6164,-20,0,-20,15,18
48065,065,48,2011,6240,77,1,78,64,67
48065,065,48,2012,6090,-133,4,-129,57,79
48065,065,48,2013,5988,-92,1,-91,58,73
48065,065,48,2014,6035,34,2,36,70,58
48065,065,48,2015,6014,-23,6,-17,56,59
48065,065,48,2016,6093,86,2,88,54,62
48065,065,48,2017,6003,-86,2,-84,59,66
48065,065,48,2018,5966,-10,1,-9,46,73
48065,065,48,2019,5867,-88,0,-88,38,49
48065,065,48,2020,5854,15,2,17,43,73
48067,067,48,2010,30457,34,-1,33,89,132
48067,067,48,2011,30279,-127,-2,-129,335,383
48067,067,48,2012,30032,-225,17,-208,348,388
48067,067,48,2013,30235,231,12,243,365,407
48067,067,48,2014,30119,-84,14,-70,367,411
48067,067,48,2015,30137,20,10,30,362,371
48067,067,48,2016,30048,-14,4,-10,353,429
48067,067,48,2017,29958,-1,5,4,329,421
48067,067,48,2018,30125,262,4,266,308,404
48067,067,48,2019,30002,-7,4,-3,298,418
48067,067,48,2020,29879,56,2,58,308,489
48069,069,48,2010,8125,25,5,30,30,0
48069,069,48,2011,8089,-166,51,-115,139,59
48069,069,48,2012,8254,26,47,73,140,49
48069,069,48,2013,8108,-237,48,-189,114,76
48069,069,48,2014,7912,-314,40,-274,129,60
48069,069,48,2015,7774,-225,36,-189,124,74
48069,069,48,2016,7730,-118,31,-87,102,60
48069,069,48,2017,7668,-133,25,-108,103,58
48069,069,48,2018,7529,-191,15,-176,100,63
48069,069,48,2019,7484,-127,15,-112,116,49
48069,069,48,2020,7396,-157,23,-134,104,56
48071,071,48,2010,35452,284,3,287,121,82
48071,071,48,2011,35693,-9,12,3,476,238
48071,071,48,2012,36497,590,21,611,453,269
48071,071,48,2013,37359,563,73,636,480,261
48071,071,48,2014,38287,635,94,729,447,257
48071,071,48,2015,39025,462,77,539,495,296
48071,071,48,2016,40160,814,62,876,535,277
48071,071,48,2017,41249,756,46,802,559,272
48071,071,48,2018,42128,599,26,625,539,282
48071,071,48,2019,43726,1270,30,1300,600,298
48071,071,48,2020,45590,1570,24,1594,604,320
48073,073,48,2010,50932,-14,1,-13,202,78
48073,073,48,2011,51082,-92,9,-83,769,532
48073,073,48,2012,51271,-41,7,-34,710,478
48073,073,48,2013,51089,-367,5,-362,729,547
48073,073,48,2014,51187,-208,30,-178,786,503
48073,073,48,2015,51567,95,43,138,777,529
48073,073,48,2016,51870,61,47,108,764,565
48073,073,48,2017,52099,48,2,50,753,571
48073,073,48,2018,52299,88,-14,74,712,585
48073,073,48,2019,52561,80,4,84,717,540
48073,073,48,2020,52875,185,6,191,699,578
48075,075,48,2010,7069,15,0,15,16,5
48075,075,48,2011,7028,-78,0,-78,100,63
48075,075,48,2012,7102,74,1,75,70,73
48075,075,48,2013,7061,-37,3,-34,70,78
48075,075,48,2014,7201,130,3,133,74,72
48075,075,48,2015,7177,-19,6,-13,68,79
48075,075,48,2016,7204,30,3,33,73,79
48075,075,48,2017,7260,66,-4,62,82,88
48075,075,48,2018,7265,14,-6,8,62,64
48075,075,48,2019,7222,-43,-4,-47,62,58
48075,075,48,2020,7143,-50,-4,-54,53,78
48077,077,48,2010,10737,-16,0,-16,19,22
48077,077,48,2011,10668,-62,3,-59,92,102
48077,077,48,2012,10525,-110,8,-102,75,118
48077,077,48,2013,10458,-70,5,-65,112,114
48077,077,48,2014,10380,-37,9,-28,74,125
48077,077,48,2015,10363,13,12,25,88,128
48077,077,48,2016,10268,-91,14,-77,99,117
48077,077,48,2017,10496,265,13,278,81,132
48077,077,48,2018,10439,-27,10,-17,83,124
48077,077,48,2019,10465,68,12,80,73,125
48077,077,48,2020,10550,145,10,155,77,147
48079,079,48,2010,3147,8,3,11,11,1
48079,079,48,2011,3083,-104,13,-91,57,31
48079,079,48,2012,3029,-76,7,-69,43,29
48079,079,48,2013,3013,-49,5,-44,53,27
48079,079,48,2014,2948,-90,14,-76,46,37
48079,079,48,2015,2979,7,17,24,39,33
48079,079,48,2016,2913,-84,18,-66,33,34
48079,079,48,2017,2847,-102,16,-86,43,24
48079,079,48,2018,2816,-59,13,-46,42,25
48079,079,48,2019,2825,-33,16,-17,39,14
48079,079,48,2020,2897,40,12,52,39,18
48081,081,48,2010,3318,6,0,6,4,7
48081,081,48,2011,3264,-27,0,-27,28,56
48081,081,48,2012,3198,-39,0,-39,28,55
48081,081,48,2013,3175,6,0,6,26,56
48081,081,48,2014,3211,51,1,52,28,44
48081,081,48,2015,3220,24,0,24,34,50
48081,081,48,2016,3255,47,0,47,41,52
48081,081,48,2017,3278,49,-1,48,32,57
48081,081,48,2018,3317,50,-1,49,35,45
48081,081,48,2019,3316,25,-1,24,31,56
48081,081,48,2020,3323,40,-1,39,34,65
48083,083,48,2010,8873,8,0,8,19,46
48083,083,48,2011,8748,-116,2,-114,99,111
48083,083,48,2012,8673,-36,7,-29,96,140
48083,083,48,2013,8533,-140,7,-133,96,103
48083,083,48,2014,8422,-46,6,-40,85,157
48083,083,48,2015,8317,-36,6,-30,77,149
48083,083,48,2016,8415,132,4,136,72,110
48083,083,48,2017,8402,49,3,52,75,139
48083,083,48,2018,8364,16,3,19,86,142
48083,083,48,2019,8125,-195,3,-192,77,123
48083,083,48,2020,8100,26,1,27,74,125
48085,085,48,2010,787102,3470,623,4093,2620,747
48085,085,48,2011,812083,14780,2806,17586,10564,3265
48085,085,48,2012,834839,11947,3505,15452,10350,3309
48085,085,48,2013,856063,10117,4125,14242,10436,3527
48085,085,48,2014,884410,15358,5646,21004,10768,3705
48085,085,48,2015,915014,16814,6766,23580,10797,3925
48085,085,48,2016,944313,15551,6612,22163,11151,4050
48085,085,48,2017,972724,15454,6317,21771,10951,4334
48085,085,48,2018,1006012,22298,4495,26793,11108,4654
48085,085,48,2019,1035072,18595,4398,22993,11179,5075
48085,085,48,2020,1072069,28051,3444,31495,11413,5752
48087,087,48,2010,3054,-3,1,-2,14,15
48087,087,48,2011,3085,21,6,27,51,48
48087,087,48,2012,3023,-81,6,-75,52,40
48087,087,48,2013,3098,66,5,71,44,42
48087,087,48,2014,3014,-87,6,-81,26,31
48087,087,48,2015,3007,2,1,3,31,40
48087,087,48,2016,3009,3,1,4,37,39
48087,087,48,2017,2958,-48,0,-48,27,30
48087,087,48,2018,2928,-23,0,-23,35,43
48087,087,48,2019,2921,-13,0,-13,34,28
48087,087,48,2020,2877,-47,0,-47,35,32
48089,089,48,2010,20868,10,10,20,70,84
48089,089,48,2011,20803,-129,53,-76,256,246
48089,089,48,2012,20724,-69,43,-26,231,281
48089,089,48,2013,20717,-4,41,37,256,297
48089,089,48,2014,20695,-76,47,-29,266,259
48089,089,48,2015,20946,176,77,253,251,251
48089,089,48,2016,21091,37,93,130,264,248
48089,089,48,2017,21301,131,86,217,280,286
48089,089,48,2018,21317,-54,66,12,249,243
48089,089,48,2019,21467,84,67,151,257,259
48089,089,48,2020,21610,127,52,179,259,293
48091,091,48,2010,109311,588,26,614,312,185
48091,091,48,2011,112128,2467,68,2535,1258,989
48091,091,48,2012,114897,2348,96,2444,1283,1028
48091,091,48,2013,118663,3292,102,3394,1352,1059
48091,091,48,2014,123268,3957,169,4126,1384,1022
48091,091,48,2015,128870,4840,180,5020,1528,1020
48091,091,48,2016,134408,4922,126,5048,1572,1109
48091,091,48,2017,140721,5965,91,6056,1454,1232
48091,091,48,2018,148230,7256,42,7298,1504,1317
48091,091,48,2019,156435,7853,65,7918,1573,1267
48091,091,48,2020,164812,8070,54,8124,1626,1318
48093,093,48,2010,13954,-2,5,3,29,38
48093,093,48,2011,13870,-130,20,-110,186,161
48093,093,48,2012,13723,-166,-2,-168,158,140
48093,093,48,2013,13552,-155,2,-153,155,174
48093,093,48,2014,13470,-23,11,-12,138,205
48093,093,48,2015,13392,-74,22,-52,142,166
48093,093,48,2016,13554,138,19,157,178,173
48093,093,48,2017,13531,28,15,43,128,193
48093,093,48,2018,13519,17,10,27,149,185
48093,093,48,2019,13629,135,9,144,145,177
48093,093,48,2020,13750,161,11,172,154,205
48095,095,48,2010,4101,8,2,10,6,2
48095,095,48,2011,4121,-8,30,22,33,36
48095,095,48,2012,4082,-89,45,-44,32,29
48095,095,48,2013,4118,34,20,54,16,37
48095,095,48,2014,4080,-64,34,-30,25,34
48095,095,48,2015,4065,-53,39,-14,31,33
48095,095,48,2016,4134,38,40,78,27,35
48095,095,48,2017,2701,-1481,35,-1446,18,26
48095,095,48,2018,2679,-36,27,-9,24,37
48095,095,48,2019,2749,28,32,60,31,21
48095,095,48,2020,2827,60,27,87,29,38
48097,097,48,2010,38482,-35,7,-28,139,70
48097,097,48,2011,38452,-179,54,-125,475,380
48097,097,48,2012,38729,144,25,169,521,415
48097,097,48,2013,38465,-440,28,-412,570,427
48097,097,48,2014,38772,143,53,196,528,415
48097,097,48,2015,39179,196,63,259,550,397
48097,097,48,2016,39334,-38,30,-8,567,401
48097,097,48,2017,39903,415,23,438,559,429
48097,097,48,2018,40434,364,9,373,553,394
48097,097,48,2019,41074,545,10,555,512,426
48097,097,48,2020,41393,236,13,249,541,471
48099,099,48,2010,75654,-116,149,33,247,96
48099,099,48,2011,76656,175,174,349,1066,412
48099,099,48,2012,78515,464,794,1258,950,408
48099,099,48,2013,76827,-2791,417,-2374,1007,395
48099,099,48,2014,76245,-1651,403,-1248,1070,429
48099,099,48,2015,76242,-1084,493,-591,1065,483
48099,099,48,2016,74924,-2115,295,-1820,983,488
48099,099,48,2017,74886,-637,119,-518,942,460
48099,099,48,2018,74791,-451,-47,-498,915,508
48099,099,48,2019,76543,1300,33,1333,876,462
48099,099,48,2020,76737,-259,61,-198,895,508
48101,101,48,2010,1512,-1,0,-1,9,2
48101,101,48,2011,1507,1,0,1,15,21
48101,101,48,2012,1485,-18,0,-18,15,18
48101,101,48,2013,1442,-18,0,-18,10,37
48101,101,48,2014,1427,-3,0,-3,16,28
48101,101,48,2015,1437,21,0,21,16,28
48101,101,48,2016,1398,-22,0,-22,10,26
48101,101,48,2017,1373,-12,0,-12,13,26
48101,101,48,2018,1375,6,0,6,19,22
48101,101,48,2019,1385,18,0,18,8,16
48101,101,48,2020,1363,-25,0,-25,14,11
48103,103,48,2010,4382,-6,0,-6,16,3
48103,103,48,2011,4357,-46,2,-44,65,47
48103,103,48,2012,4522,121,2,123,70,31
48103,103,48,2013,4716,158,10,168,80,55
48103,103,48,2014,4894,121,10,131,80,37
48103,103,48,2015,4991,59,11,70,67,39
48103,103,48,2016,4776,-274,11,-263,81,34
48103,103,48,2017,4675,-139,5,-134,69,38
48103,103,48,2018,4718,21,4,25,55,37
48103,103,48,2019,4759,-1,5,4,61,24
48103,103,48,2020,4765,-23,5,-18,56,32
48105,105,48,2010,3701,-16,1,-15,17,19
48105,105,48,2011,3655,-62,2,-60,57,45
48105,105,48,2012,3707,20,10,30,61,37
48105,105,48,2013,3765,33,7,40,47,30
48105,105,48,2014,3791,-10,9,-1,60,32
48105,105,48,2015,3736,-84,5,-79,50,27
48105,105,48,2016,3652,-114,1,-113,63,36
48105,105,48,2017,3528,-116,1,-115,28,37
48105,105,48,2018,3448,-72,0,-72,38,45
48105,105,48,2019,3468,18,0,18,32,29
48105,105,48,2020,3513,30,0,30,35,21
48107,107,48,2010,6025,-10,0,-10,19,40
48107,107,48,2011,6041,-3,5,2,87,71
48107,107,48,2012,6033,-18,3,-15,72,67
48107,107,48,2013,5923,-121,2,-119,66,60
48107,107,48,2014,5826,-112,1,-111,74,61
48107,107,48,2015,5918,75,1,76,102,85
48107,107,48,2016,5905,-21,3,-18,72,67
48107,107,48,2017,5850,-46,1,-45,64,73
48107,107,48,2018,5743,-109,1,-108,70,70
48107,107,48,2019,5701,-41,3,-38,74,79
48107,107,48,2020,5567,-144,1,-143,73,63
48109,109,48,2010,2404,-1,1,0,7,2
48109,109,48,2011,2393,-29,6,-23,27,14
48109,109,48,2012,2317,-98,1,-97,33,15
48109,109,48,2013,2305,-22,-1,-23,30,19
48109,109,48,2014,2282,-34,1,-33,26,17
48109,109,48,2015,2252,-52,0,-52,31,9
48109,109,48,2016,2216,-43,0,-43,30,23
48109,109,48,2017,2227,-3,0,-3,36,22
48109,109,48,2018,2176,-62,0,-62,27,17
48109,109,48,2019,2146,-35,0,-35,24,19
48109,109,48,2020,2149,2,0,2,23,21
48111,111,48,2010,6745,16,5,21,25,1
48111,111,48,2011,6887,19,28,47,137,42
48111,111,48,2012,7058,67,29,96,136,60
48111,111,48,2013,7111,-73,22,-51,151,46
48111,111,48,2014,7214,-24,35,11,141,48
48111,111,48,2015,7301,-88,62,-26,152,40
48111,111,48,2016,7321,-169,81,-88,147,39
48111,111,48,2017,7248,-222,55,-167,154,61
48111,111,48,2018,7262,-146,43,-103,151,34
48111,111,48,2019,7255,-187,56,-131,156,32
48111,111,48,2020,7273,-121,40,-81,151,51
48113,113,48,2010,2373711,-2706,2001,-705,9738,3412
48113,113,48,2011,2409257,982,9894,10876,39037,14316
48113,113,48,2012,2456296,12005,10554,22559,38574,14316
48113,113,48,2013,2484675,-5156,10062,4906,38847,15071
48113,113,48,2014,2519407,-2520,13791,11271,39267,15264
48113,113,48,2015,2557615,-1586,15605,14019,40128,15709
48113,113,48,2016,2591488,-5678,15389,9711,40059,15789
48113,113,48,2017,2620425,-8325,13709,5384,39981,16288
48113,113,48,2018,2629764,-22613,9951,-12662,38697,16662
48113,113,48,2019,2635603,-25150,9889,-15261,38072,16965
48113,113,48,2020,2635888,-26911,7924,-18987,37726,18457
48115,115,48,2010,13826,10,1,11,36,53
48115,115,48,2011,13750,-146,14,-132,193,136
48115,115,48,2012,13614,-219,15,-204,198,132
48115,115,48,2013,13224,-476,23,-453,182,142
48115,115,48,2014,13451,166,29,195,172,148
48115,115,48,2015,13000,-537,27,-510,189,141
48115,115,48,2016,13000,-71,11,-60,194,135
48115,115,48,2017,12734,-323,7,-316,180,131
48115,115,48,2018,12551,-231,5,-226,181,140
48115,115,48,2019,12985,342,9,351,198,115
48115,115,48,2020,12974,-86,8,-78,196,128
48117,117,48,2010,19465,1,21,22,83,12
48117,117,48,2011,19519,-227,70,-157,351,141
48117,117,48,2012,19369,-382,27,-355,339,146
48117,117,48,2013,19174,-434,14,-420,369,152
48117,117,48,2014,19116,-235,22,-213,318,168
48117,117,48,2015,18819,-512,11,-501,352,153
48117,117,48,2016,18823,-192,13,-179,325,143
48117,117,48,2017,18742,-241,-2,-243,317,155
48117,117,48,2018,18686,-239,-6,-245,341,152
48117,117,48,2019,18559,-322,2,-320,329,136
48117,117,48,2020,18277,-427,1,-426,314,169
48119,119,48,2010,5242,19,2,21,15,26
48119,119,48,2011,5145,-73,0,-73,57,82
48119,119,48,2012,5240,109,0,109,63,80
48119,119,48,2013,5117,-97,0,-97,54,82
48119,119,48,2014,5137,36,0,36,65,82
48119,119,48,2015,5154,15,0,15,76,73
48119,119,48,2016,5131,-5,0,-5,56,74
48119,119,48,2017,5268,142,0,142,64,69
48119,119,48,2018,5311,46,0,46,72,74
48119,119,48,2019,5327,4,0,4,71,59
48119,119,48,2020,5349,-2,0,-2,75,51
48121,121,48,2010,665833,2150,405,2555,2192,689
48121,121,48,2011,684842,10446,2008,12454,9219,2734
48121,121,48,2012,707027,13433,2112,15545,9109,2891
48121,121,48,2013,727776,12014,2018,14032,9496,3036
48121,121,48,2014,752355,14981,2592,17573,9734,3141
48121,121,48,2015,778799,16614,3047,19661,9916,3350
48121,121,48,2016,807566,19084,2878,21962,10171,3478
48121,121,48,2017,834649,18106,2655,20761,9930,3718
48121,121,48,2018,858148,15496,1878,17374,9902,3852
48121,121,48,2019,888765,23329,1726,25055,9966,4380
48121,121,48,2020,919324,24196,1395,25591,10151,5077
48123,123,48,2010,20055,-6,1,-5,58,91
48123,123,48,2011,20207,184,5,189,223,261
48123,123,48,2012,20360,124,1,125,243,218
48123,123,48,2013,20381,17,1,18,261,254
48123,123,48,2014,20519,102,5,107,278,246
48123,123,48,2015,20632,70,6,76,304,267
48123,123,48,2016,20598,4,-5,-1,243,273
48123,123,48,2017,20164,-407,-5,-412,238,260
48123,123,48,2018,20042,-43,-2,-45,228,306
48123,123,48,2019,20105,59,-11,48,238,221
48123,123,48,2020,20174,68,-5,63,226,221
48125,125,48,2010,2447,6,0,6,2,2
48125,125,48,2011,2402,-47,2,-45,20,21
48125,125,48,2012,2324,-70,3,-67,22,34
48125,125,48,2013,2299,-28,1,-27,25,25
48125,125,48,2014,2214,-72,4,-68,20,39
48125,125,48,2015,2203,0,0,0,14,23
48125,125,48,2016,2191,-7,1,-6,21,28
48125,125,48,2017,2192,1,1,2,23,26
48125,125,48,2018,2200,25,1,26,17,35
48125,125,48,2019,2185,-16,0,-16,16,15
48125,125,48,2020,2140,-41,1,-40,16,21
48127,127,48,2010,10043,21,2,23,32,9
48127,127,48,2011,10109,-5,5,0,149,82
48127,127,48,2012,10472,240,22,262,185,90
48127,127,48,2013,10898,294,18,312,200,93
48127,127,48,2014,10993,-12,8,-4,194,95
48127,127,48,2015,10914,-143,-4,-147,184,116
48127,127,48,2016,10676,-300,-4,-304,161,96
48127,127,48,2017,10281,-455,-6,-461,149,85
48127,127,48,2018,10176,-132,-6,-138,115,84
48127,127,48,2019,10104,-121,-6,-127,136,81
48127,127,48,2020,9925,-222,-6,-228,131,81
48129,129,48,2010,3734,8,1,9,12,13
48129,129,48,2011,3686,-31,3,-28,34,53
48129,129,48,2012,3645,-24,2,-22,29,49
48129,129,48,2013,3561,-60,2,-58,34,61
48129,129,48,2014,3483,-68,1,-67,28,42
48129,129,48,2015,3390,-74,2,-72,35,57
48129,129,48,2016,3387,9,1,10,36,49
48129,129,48,2017,3334,-33,1,-32,29,49
48129,129,48,2018,3292,-29,1,-28,37,51
48129,129,48,2019,3263,-24,1,-23,29,35
48129,129,48,2020,3308,59,1,60,28,43
48131,131,48,2010,11705,-55,1,-54,39,40
48131,131,48,2011,11778,13,0,13,172,112
48131,131,48,2012,11564,-289,0,-289,181,119
48131,131,48,2013,11563,-27,4,-23,161,137
48131,131,48,2014,11487,-118,-1,-119,172,131
48131,131,48,2015,11313,-231,8,-223,178,132
48131,131,48,2016,11411,64,10,74,174,149
48131,131,48,2017,11239,-187,2,-185,152,139
48131,131,48,2018,11124,-131,0,-131,142,126
48131,131,48,2019,11139,-2,5,3,145,133
48131,131,48,2020,11058,-80,3,-77,149,153
48133,133,48,2010,18595,11,2,13,49,47
48133,133,48,2011,18583,24,11,35,220,267
48133,133,48,2012,18461,-97,25,-72,184,230
48133,133,48,2013,18279,-125,23,-102,176,257
48133,133,48,2014,18259,8,14,22,216,256
48133,133,48,2015,18151,-63,21,-42,211,275
48133,133,48,2016,18233,138,3,141,213,271
48133,133,48,2017,18278,95,-4,91,204,248
48133,133,48,2018,18278,70,-4,66,196,262
48133,133,48,2019,18267,35,-4,31,197,239
48133,133,48,2020,18388,207,-3,204,189,270
48135,135,48,2010,137060,-412,-34,-446,576,218
48135,135,48,2011,139631,1387,10,1397,2408,1241
48135,135,48,2012,144472,3136,122,3258,2585,1111
48135,135,48,2013,149629,3232,167,3399,2846,1179
48135,135,48,2014,154553,2640,302,2942,3040,1149
48135,135,48,2015,159859,2886,406,3292,3170,1200
48135,135,48,2016,157748,-4258,401,-3857,2877,1149
48135,135,48,2017,156823,-2782,294,-2488,2744,1197
48135,135,48,2018,161859,3157,221,3378,2890,1244
48135,135,48,2019,166204,2313,232,2545,3015,1218
48135,135,48,2020,167701,-442,186,-256,3059,1324
48137,137,48,2010,1999,-9,0,-9,9,2
48137,137,48,2011,1979,-30,2,-28,25,16
48137,137,48,2012,1990,2,3,5,28,22
48137,137,48,2013,1899,-94,1,-93,18,18
48137,137,48,2014,1904,-6,1,-5,25,16
48137,137,48,2015,1911,17,-1,16,23,31
48137,137,48,2016,1915,5,-1,4,29,30
48137,137,48,2017,1931,24,-1,23,20,25
48137,137,48,2018,1903,-27,-1,-28,24,24
48137,137,48,2019,1915,14,-2,12,20,19
48137,137,48,2020,1923,-3,-1,-4,22,9
48139,139,48,2010,150408,452,1,453,483,194
48139,139,48,2011,152419,950,44,994,2001,984
48139,139,48,2012,153779,495,119,614,1887,1112
48139,139,48,2013,155972,1319,63,1382,1913,1100
48139,139,48,2014,159239,2141,138,2279,2108,1145
48139,139,48,2015,163331,2943,128,3071,2153,1153
48139,139,48,2016,168367,3908,162,4070,2163,1208
48139,139,48,2017,173434,4094,69,4163,2191,1295
48139,139,48,2018,179094,4628,35,4663,2278,1290
48139,139,48,2019,184765,4842,60,4902,2230,1447
48139,139,48,2020,191760,6279,45,6324,2262,1546
48141,141,48,2010,803548,477,321,798,3289,1131
48141,141,48,2011,819796,5240,1958,7198,13816,4778
48141,141,48,2012,832118,-303,3706,3403,13929,4821
48141,141,48,2013,830585,-12761,2136,-10625,13678,4843
48141,141,48,2014,833370,-8496,2559,-5937,13563,4920
48141,141,48,2015,831382,-13194,2680,-10514,13695,5302
48141,141,48,2016,834112,-7506,2096,-5410,13372,5234
48141,141,48,2017,836087,-5943,560,-5383,12615,5252
48141,141,48,2018,835590,-6819,-118,-6937,11865,5433
48141,141,48,2019,837501,-4157,100,-4057,11461,5521
48141,141,48,2020,841286,-2283,289,-1994,11572,5844
48143,143,48,2010,37913,-27,7,-20,119,81
48143,143,48,2011,38925,843,27,870,457,321
48143,143,48,2012,39408,273,28,301,488,309
48143,143,48,2013,39893,241,3,244,504,273
48143,143,48,2014,40525,404,6,410,532,322
48143,143,48,2015,41200,485,23,508,470,308
48143,143,48,2016,41375,61,19,80,455,359
48143,143,48,2017,41744,218,10,228,505,365
48143,143,48,2018,42251,383,-2,381,475,349
48143,143,48,2019,42536,157,-2,155,477,347
48143,143,48,2020,43224,597,1,598,478,387
48145,145,48,2010,17895,1,0,1,50,22
48145,145,48,2011,17853,-47,13,-34,193,198
48145,145,48,2012,17572,-297,11,-286,207,208
48145,145,48,2013,17244,-380,12,-368,200,171
48145,145,48,2014,17211,-67,12,-55,212,188
48145,145,48,2015,17215,-5,-2,-7,211,198
48145,145,48,2016,17279,26,1,27,225,188
48145,145,48,2017,17342,44,-1,43,207,186
48145,145,48,2018,17225,-114,-2,-116,189,189
48145,145,48,2019,17282,39,-2,37,204,184
48145,145,48,2020,17275,-22,-1,-23,201,186
48147,147,48,2010,33922,4,2,6,88,78
48147,147,48,2011,33884,-2,8,6,361,404
48147,147,48,2012,33601,-184,15,-169,302,410
48147,147,48,2013,33509,-47,14,-33,356,408
48147,147,48,2014,33606,121,42,163,318,379
48147,147,48,2015,33501,-39,61,22,333,455
48147,147,48,2016,33937,467,68,535,353,453
48147,147,48,2017,34570,674,55,729,345,442
48147,147,48,2018,35258,751,47,798,331,441
48147,147,48,2019,35554,382,45,427,306,437
48147,147,48,2020,35913,502,40,542,303,483
48149,149,48,2010,24545,-9,0,-9,53,38
48149,149,48,2011,24734,233,2,235,247,292
48149,149,48,2012,24645,-31,1,-30,226,280
48149,149,48,2013,24705,147,20,167,240,345
48149,149,48,2014,24761,124,18,142,241,322
48149,149,48,2015,24923,211,10,221,263,324
48149,149,48,2016,24999,114,17,131,247,299
48149,149,48,2017,25110,195,18,213,223,323
48149,149,48,2018,25272,246,12,258,252,348
48149,149,48,2019,25308,89,13,102,233,297
48149,149,48,2020,25547,307,14,321,242,323
48151,151,48,2010,3959,-13,0,-13,11,18
48151,151,48,2011,3947,-7,1,-6,37,44
48151,151,48,2012,3837,-85,1,-84,34,62
48151,151,48,2013,3857,40,1,41,30,51
48151,151,48,2014,3873,17,10,27,43,54
48151,151,48,2015,3876,20,8,28,41,65
48151,151,48,2016,3874,-5,6,1,43,46
48151,151,48,2017,3869,2,4,6,34,44
48151,151,48,2018,3798,-75,3,-72,44,45
48151,151,48,2019,3810,18,5,23,32,42
48151,151,48,2020,3784,7,4,11,32,68
48153,153,48,2010,6404,-32,1,-31,23,34
48153,153,48,2011,6371,-71,9,-62,91,64
48153,153,48,2012,6352,-42,12,-30,81,70
48153,153,48,2013,6248,-158,11,-147,101,59
48153,153,48,2014,5950,-309,7,-302,66,73
48153,153,48,2015,5845,-103,2,-101,63,68
48153,153,48,2016,5849,-6,0,-6,77,66
48153,153,48,2017,5832,-46,0,-46,84,55
48153,153,48,2018,5801,-45,0,-45,82,68
48153,153,48,2019,5754,-58,0,-58,58,46
48153,153,48,2020,5672,-90,0,-90,62,54
48155,155,48,2010,1344,7,0,7,3,3
48155,155,48,2011,1359,18,0,18,16,19
48155,155,48,2012,1309,-55,1,-54,16,15
48155,155,48,2013,1285,-14,1,-13,13,23
48155,155,48,2014,1273,10,0,10,5,28
48155,155,48,2015,1223,-39,0,-39,10,21
48155,155,48,2016,1196,-15,0,-15,9,22
48155,155,48,2017,1197,11,0,11,11,20
48155,155,48,2018,1183,-1,0,-1,7,21
48155,155,48,2019,1156,-22,0,-22,9,14
48155,155,48,2020,1135,-19,0,-19,8,10
48157,157,48,2010,590177,3327,691,4018,1934,652
48157,157,48,2011,605979,7317,3047,10364,7734,2330
48157,157,48,2012,624737,9553,3492,13045,7906,2361
48157,157,48,2013,651770,17008,4047,21055,8143,2569
48157,157,48,2014,683977,19820,5479,25299,9092,2720
48157,157,48,2015,715260,17946,6411,24357,9654,2946
48157,157,48,2016,744489,15894,6353,22247,9974,3036
48157,157,48,2017,768258,10868,6309,17177,9788,3188
48157,157,48,2018,789269,10290,4599,14889,9587,3442
48157,157,48,2019,812737,13505,4569,18074,9334,3899
48157,157,48,2020,839706,18398,3526,21924,9482,4331
48159,159,48,2010,10605,2,3,5,26,24
48159,159,48,2011,10561,-63,11,-52,114,107
48159,159,48,2012,10633,83,0,83,101,112
48159,159,48,2013,10612,-11,-1,-12,103,110
48159,159,48,2014,10561,-38,-5,-43,100,105
48159,159,48,2015,10600,55,-2,53,111,127
48159,159,48,2016,10686,70,8,78,123,114
48159,159,48,2017,10801,118,2,120,107,114
48159,159,48,2018,10776,6,1,7,101,132
48159,159,48,2019,10749,-43,3,-40,151,137
48159,159,48,2020,10821,82,2,84,134,144
48161,161,48,2010,19802,-5,0,-5,53,62
48161,161,48,2011,19602,-226,-2,-228,231,203
48161,161,48,2012,19484,-104,2,-102,217,232
48161,161,48,2013,19599,85,5,90,245,217
48161,161,48,2014,19678,104,21,125,195,236
48161,161,48,2015,19745,51,19,70,218,219
48161,161,48,2016,19658,-115,29,-86,201,201
48161,161,48,2017,19651,-60,20,-40,221,188
48161,161,48,2018,19786,156,16,172,203,239
48161,161,48,2019,19753,-83,20,-63,240,210
48161,161,48,2020,19874,98,17,115,230,223
48163,163,48,2010,17255,-8,8,0,52,11
48163,163,48,2011,17491,52,30,82,260,108
48163,163,48,2012,17924,241,90,331,235,140
48163,163,48,2013,18397,192,153,345,253,131
48163,163,48,2014,18930,229,173,402,261,134
48163,163,48,2015,19348,-1,286,285,282,148
48163,163,48,2016,19547,-183,282,99,243,143
48163,163,48,2017,19818,-97,256,159,239,128
48163,163,48,2018,20121,-28,213,185,255,136
48163,163,48,2019,20199,-228,227,-1,249,170
48163,163,48,2020,20379,-91,177,86,255,163
48165,165,48,2010,17588,5,11,16,87,42
48165,165,48,2011,17907,66,14,80,340,99
48165,165,48,2012,18305,111,30,141,371,112
48165,165,48,2013,18798,163,77,240,370,114
48165,165,48,2014,19319,143,108,251,391,122
48165,165,48,2015,20204,441,123,564,437,119
48165,165,48,2016,20477,-218,164,-54,466,139
48165,165,48,2017,20575,-319,99,-220,425,110
48165,165,48,2018,20799,-156,73,-83,424,117
48165,165,48,2019,21540,297,90,387,457,101
48165,165,48,2020,21996,83,82,165,449,159
48167,167,48,2010,292492,646,133,779,963,596
48167,167,48,2011,295632,943,530,1473,3880,2207
48167,167,48,2012,301099,3166,521,3687,3937,2232
48167,167,48,2013,306652,3471,549,4020,3862,2378
48167,167,48,2014,313451,4536,563,5099,4054,2437
48167,167,48,2015,321074,5492,661,6153,4121,2705
48167,167,48,2016,329038,5631,609,6240,4313,2606
48167,167,48,2017,334691,3860,506,4366,4091,2813
48167,167,48,2018,337639,1539,362,1901,3940,2889
48167,167,48,2019,341541,2613,344,2957,3936,2990
48167,167,48,2020,345089,2598,281,2879,3930,3265
48169,169,48,2010,6466,-1,6,5,27,26
48169,169,48,2011,6556,59,21,80,68,59
48169,169,48,2012,6413,-188,26,-162,58,45
48169,169,48,2013,6364,-73,14,-59,58,49
48169,169,48,2014,6409,-15,54,39,65,60
48169,169,48,2015,6384,-89,60,-29,64,61
48169,169,48,2016,6197,-278,71,-207,64,45
48169,169,48,2017,6480,212,46,258,65,43
48169,169,48,2018,6227,-298,34,-264,56,49
48169,169,48,2019,6238,-43,42,-1,48,35
48169,169,48,2020,6222,-68,45,-23,45,38
48171,171,48,2010,24875,64,5,69,66,88
48171,171,48,2011,25041,235,32,267,253,353
48171,171,48,2012,25177,184,54,238,237,337
48171,171,48,2013,25364,243,42,285,252,353
48171,171,48,2014,25476,171,41,212,240,338
48171,171,48,2015,25913,460,21,481,257,305
48171,171,48,2016,26225,347,58,405,254,345
48171,171,48,2017,26520,352,28,380,281,364
48171,171,48,2018,26706,320,17,337,232,381
48171,171,48,2019,26927,327,31,358,237,375
48171,171,48,2020,26960,178,26,204,235,405
48173,173,48,2010,1232,2,1,3,5,2
48173,173,48,2011,1238,0,3,3,11,8
48173,173,48,2012,1280,18,10,28,16,1
48173,173,48,2013,1271,-16,6,-10,11,12
48173,173,48,2014,1326,33,10,43,17,5
48173,173,48,2015,1379,34,11,45,17,9
48173,173,48,2016,1365,-41,16,-25,14,4
48173,173,48,2017,1366,-23,11,-12,18,5
48173,173,48,2018,1397,14,11,25,14,7
48173,173,48,2019,1430,12,11,23,21,11
48173,173,48,2020,1439,-13,12,-1,25,14
48175,175,48,2010,7219,19,0,19,20,29
48175,175,48,2011,7208,-9,0,-9,66,68
48175,175,48,2012,7329,143,-1,142,52,76
48175,175,48,2013,7454,108,-1,107,74,59
48175,175,48,2014,7509,92,-1,91,56,91
48175,175,48,2015,7517,19,-1,18,78,88
48175,175,48,2016,7516,9,1,10,79,88
48175,175,48,2017,7559,48,0,48,88,94
48175,175,48,2018,7583,34,-1,33,69,77
48175,175,48,2019,7607,31,0,31,67,74
48175,175,48,2020,7626,19,0,19,72,73
48177,177,48,2010,19797,0,4,4,55,70
48177,177,48,2011,19753,-116,4,-112,278,211
48177,177,48,2012,19923,69,-8,61,280,169
48177,177,48,2013,20135,124,-9,115,278,182
48177,177,48,2014,20331,135,-9,126,294,226
48177,177,48,2015,20492,18,-6,12,329,179
48177,177,48,2016,20784,185,8,193,327,227
48177,177,48,2017,20743,-106,-9,-115,283,207
48177,177,48,2018,20768,-21,-13,-34,284,224
48177,177,48,2019,20899,43,-8,35,277,182
48177,177,48,2020,20948,-8,-2,-10,276,216
48179,179,48,2010,22474,-113,1,-112,87,44
48179,179,48,2011,22663,125,5,130,306,247
48179,179,48,2012,22922,161,17,178,341,261
48179,179,48,2013,22994,-8,3,-5,341,259
48179,179,48,2014,23425,371,0,371,329,287
48179,179,48,2015,23262,-274,25,-249,352,268
48179,179,48,2016,22713,-605,16,-589,301,264
48179,179,48,2017,22089,-649,-2,-651,307,286
48179,179,48,2018,22006,-66,-4,-70,258,270
48179,179,48,2019,21849,-168,-4,-172,250,234
48179,179,48,2020,21658,-182,0,-182,243,251
48181,181,48,2010,121029,103,30,133,334,295
48181,181,48,2011,121429,55,157,212,1550,1356
48181,181,48,2012,121866,215,162,377,1437,1350
48181,181,48,2013,122385,276,130,406,1531,1397
48181,181,48,2014,123628,856,191,1047,1542,1347
48181,181,48,2015,125672,1670,204,1874,1563,1403
48181,181,48,2016,128309,2328,119,2447,1587,1401
48181,181,48,2017,131085,2532,84,2616,1544,1391
48181,181,48,2018,133780,2578,47,2625,1639,1574
48181,181,48,2019,136143,2153,49,2202,1631,1465
48181,181,48,2020,138318,2003,48,2051,1676,1545
48183,183,48,2010,122044,-62,52,-10,492,233
48183,183,48,2011,122719,-142,218,76,1887,1282
48183,183,48,2012,123154,-528,216,-312,1954,1196
48183,183,48,2013,123313,-594,155,-439,1865,1264
48183,183,48,2014,123225,-900,185,-715,1926,1303
48183,183,48,2015,123887,-113,131,18,1938,1279
48183,183,48,2016,123493,-1124,169,-955,1820,1260
48183,183,48,2017,122985,-954,99,-855,1656,1310
48183,183,48,2018,123362,76,61,137,1635,1390
48183,183,48,2019,124098,316,74,390,1641,1298
48183,183,48,2020,124229,-184,68,-116,1625,1385
48185,185,48,2010,26624,35,5,40,92,94
48185,185,48,2011,26663,32,8,40,297,297
48185,185,48,2012,26686,-27,4,-23,281,235
48185,185,48,2013,26796,62,13,75,316,280
48185,185,48,2014,26998,139,15,154,343,291
48185,185,48,2015,27302,275,15,290,320,307
48185,185,48,2016,27479,110,3,113,338,273
48185,185,48,2017,27924,383,-4,379,333,269
48185,185,48,2018,28280,350,-5,345,308,296
48185,185,48,2019,28940,592,-5,587,311,236
48185,185,48,2020,29614,625,-8,617,319,258
48187,187,48,2010,132581,727,30,757,413,162
48187,187,48,2011,135816,2302,140,2442,1644,864
48187,187,48,2012,139657,2769,168,2937,1709,879
48187,187,48,2013,142895,2352,81,2433,1737,974
48187,187,48,2014,146832,2879,129,3008,1777,913
48187,187,48,2015,150608,2924,94,3018,1782,1052
48187,187,48,2016,154510,3037,70,3107,1831,1044
48187,187,48,2017,159666,4339,51,4390,1811,1063
48187,187,48,2018,163397,3009,13,3022,1862,1159
48187,187,48,2019,166970,2939,5,2944,1837,1202
48187,187,48,2020,170608,3004,20,3024,1874,1246
48189,189,48,2010,36271,-5,6,1,165,99
48189,189,48,2011,36383,-153,26,-127,556,317
48189,189,48,2012,36248,-441,16,-425,556,273
48189,189,48,2013,35660,-848,13,-835,533,303
48189,189,48,2014,34435,-1489,27,-1462,496,302
48189,189,48,2015,34010,-587,15,-572,458,317
48189,189,48,2016,34062,-80,-1,-81,452,318
48189,189,48,2017,33901,-280,-9,-289,437,310
48189,189,48,2018,33501,-466,-23,-489,405,317
48189,189,48,2019,33098,-533,-20,-553,455,305
48189,189,48,2020,32754,-443,-10,-453,428,318
48191,191,48,2010,3359,3,3,6,6,5
48191,191,48,2011,3312,-50,4,-46,38,39
48191,191,48,2012,3269,-20,-1,-21,39,62
48191,191,48,2013,3163,-70,-1,-71,21,58
48191,191,48,2014,3072,-86,1,-85,37,45
48191,191,48,2015,3093,57,1,58,26,60
48191,191,48,2016,3112,33,1,34,23,39
48191,191,48,2017,3043,-34,1,-33,21,57
48191,191,48,2018,3038,6,1,7,22,34
48191,191,48,2019,2992,-42,0,-42,29,33
48191,191,48,2020,2939,-48,1,-47,26,32
48193,193,48,2010,8468,-15,1,-14,21,54
48193,193,48,2011,8393,-28,0,-28,99,144
48193,193,48,2012,8251,-111,2,-109,82,117
48193,193,48,2013,8244,9,8,17,103,125
48193,193,48,2014,8164,-18,9,-9,76,148
48193,193,48,2015,8084,-28,10,-18,84,145
48193,193,48,2016,8245,194,13,207,94,141
48193,193,48,2017,8413,195,9,204,99,134
48193,193,48,2018,8492,131,7,138,83,141
48193,193,48,2019,8465,-9,10,1,85,113
48193,193,48,2020,8557,125,9,134,80,121
48195,195,48,2010,5599,-17,1,-16,18,17
48195,195,48,2011,5580,-70,19,-51,89,59
48195,195,48,2012,5532,-92,18,-74,74,50
48195,195,48,2013,5543,-32,13,-19,82,53
48195,195,48,2014,5560,-45,35,-10,76,48
48195,195,48,2015,5652,16,38,54,95,56
48195,195,48,2016,5572,-123,35,-88,58,49
48195,195,48,2017,5470,-144,21,-123,73,53
48195,195,48,2018,5456,-53,18,-35,67,46
48195,195,48,2019,5380,-132,24,-108,71,39
48195,195,48,2020,5279,-140,17,-123,64,41
48197,197,48,2010,4159,14,0,14,14,10
48197,197,48,2011,4160,-20,3,-17,46,28
48197,197,48,2012,4098,-49,1,-48,30,45
48197,197,48,2013,4067,-39,5,-34,42,39
48197,197,48,2014,3992,-56,5,-51,45,71
48197,197,48,2015,3922,-73,14,-59,44,57
48197,197,48,2016,3981,51,13,64,44,47
48197,197,48,2017,3956,-13,10,-3,28,50
48197,197,48,2018,3914,-40,8,-32,38,47
48197,197,48,2019,3927,-2,10,8,38,33
48197,197,48,2020,4011,82,8,90,38,44
48199,199,48,2010,54785,76,2,78,177,103
48199,199,48,2011,55074,142,-2,140,660,509
48199,199,48,2012,55129,-78,-2,-80,684,542
48199,199,48,2013,55311,48,5,53,692,553
48199,199,48,2014,55516,65,10,75,729,587
48199,199,48,2015,55767,106,10,116,687,546
48199,199,48,2016,56310,378,37,415,725,593
48199,199,48,2017,57194,759,32,791,665,570
48199,199,48,2018,57175,-100,22,-78,715,654
48199,199,48,2019,57796,499,28,527,652,556
48199,199,48,2020,58305,428,23,451,671,614
48201,201,48,2010,4107542,-142,4250,4108,16102,5385
48201,201,48,2011,4179279,6213,20546,26759,66921,21867
48201,201,48,2012,4262549,15706,24053,39759,66375,22706
48201,201,48,2013,4352419,20568,25597,46165,67609,23933
48201,201,48,2014,4454951,22245,34207,56452,70224,24173
48201,201,48,2015,4556559,17702,36830,54532,72303,25089
48201,201,48,2016,4622836,-16690,35123,18433,73570,25639
48201,201,48,2017,4655798,-45394,33789,-11605,70369,25966
48201,201,48,2018,4676913,-45050,25591,-19459,67758,27332
48201,201,48,2019,4709243,-31102,24967,-6135,66594,28267
48201,201,48,2020,4738253,-26091,19679,-6412,66344,31172
48203,203,48,2010,65770,21,10,31,207,100
48203,203,48,2011,66350,294,37,331,873,623
48203,203,48,2012,66273,-463,65,-398,861,550
48203,203,48,2013,66287,-222,85,-137,825,665
48203,203,48,2014,66605,10,58,68,883,618
48203,203,48,2015,66710,-137,78,-59,814,647
48203,203,48,2016,66657,-303,80,-223,854,683
48203,203,48,2017,66516,-353,75,-278,803,667
48203,203,48,2018,66693,66,52,118,763,701
48203,203,48,2019,66484,-268,56,-212,687,686
48203,203,48,2020,66386,-102,47,-55,709,755
48205,205,48,2010,6067,-4,1,-3,10,5
48205,205,48,2011,6035,-70,17,-53,55,34
48205,205,48,2012,6092,23,12,35,58,38
48205,205,48,2013,6011,-126,11,-115,65,35
48205,205,48,2014,6059,9,17,26,66,44
48205,205,48,2015,5705,-405,22,-383,61,43
48205,205,48,2016,5733,15,11,26,57,55
48205,205,48,2017,5701,-54,9,-45,62,50
48205,205,48,2018,5556,-169,4,-165,67,47
48205,205,48,2019,5507,-95,4,-91,73,31
48205,205,48,2020,5443,-116,6,-110,71,25
48207,207,48,2010,5878,-8,2,-6,15,34
48207,207,48,2011,5956,102,17,119,37,78
48207,207,48,2012,5883,-66,33,-33,51,92
48207,207,48,2013,5899,21,41,62,45,92
48207,207,48,2014,5811,-107,60,-47,48,91
48207,207,48,2015,5819,-5,38,33,59,84
48207,207,48,2016,5749,-83,37,-46,49,73
48207,207,48,2017,5696,-51,39,-12,43,83
48207,207,48,2018,5689,2,31,33,42,82
48207,207,48,2019,5665,-39,33,-6,34,52
48207,207,48,2020,5754,86,25,111,37,58
48209,209,48,2010,158086,758,25,783,498,238
48209,209,48,2011,163161,3690,92,3782,2108,845
48209,209,48,2012,168406,3722,143,3865,2018,769
48209,209,48,2013,175933,5937,180,6117,2089,867
48209,209,48,2014,184764,6963,258,7221,2244,886
48209,209,48,2015,194588,7687,439,8126,2450,886
48209,209,48,2016,204581,7985,520,8505,2484,1051
48209,209,48,2017,214863,8421,447,8868,2462,1112
48209,209,48,2018,222928,6220,352,6572,2654,1187
48209,209,48,2019,230400,5753,308,6061,2611,1196
48209,209,48,2020,241365,9392,264,9656,2642,1277
48211,211,48,2010,3800,-20,4,-16,16,12
48211,211,48,2011,3961,111,10,121,72,33
48211,211,48,2012,4098,92,13,105,67,36
48211,211,48,2013,4158,26,5,31,66,37
48211,211,48,2014,4171,-19,5,-14,61,35
48211,211,48,2015,4283,49,6,55,81,25
48211,211,48,2016,4104,-204,10,-194,54,41
48211,211,48,2017,3944,-171,6,-165,52,47
48211,211,48,2018,3850,-112,4,-108,45,31
48211,211,48,2019,3831,-46,6,-40,43,23
48211,211,48,2020,3777,-69,5,-64,43,32
48213,213,48,2010,78652,129,6,135,220,269
48213,213,48,2011,78829,178,3,181,931,930
48213,213,48,2012,78989,185,8,193,921,938
48213,213,48,2013,78679,-159,26,-133,886,1046
48213,213,48,2014,79331,677,80,757,891,1002
48213,213,48,2015,79509,316,59,375,887,1078
48213,213,48,2016,80099,692,56,748,917,1075
48213,213,48,2017,80976,1075,21,1096,857,1080
48213,213,48,2018,82155,1448,0,1448,913,1184
48213,213,48,2019,82822,845,9,854,900,1085
48213,213,48,2020,83792,1286,11,1297,903,1222
48215,215,48,2010,779091,1208,263,1471,3769,909
48215,215,48,2011,795305,1326,2118,3444,16375,3564
48215,215,48,2012,807930,-1543,1834,291,16131,3700
48215,215,48,2013,818047,-3442,1103,-2339,16311,3845
48215,215,48,2014,829065,-2428,1425,-1003,16175,4077
48215,215,48,2015,838741,-3964,1497,-2467,16332,4151
48215,215,48,2016,847759,-4132,1714,-2418,15567,4116
48215,215,48,2017,854739,-3647,253,-3394,14673,4297
48215,215,48,2018,860765,-3308,-240,-3548,14048,4487
48215,215,48,2019,867221,-3073,83,-2990,14070,4657
48215,215,48,2020,875200,-1271,211,-1060,14081,5110
48217,217,48,2010,35153,4,11,15,108,61
48217,217,48,2011,35210,-11,29,18,430,388
48217,217,48,2012,35165,-73,22,-51,415,401
48217,217,48,2013,34859,-317,21,-296,414,430
48217,217,48,2014,34778,-105,32,-73,399,405
48217,217,48,2015,34841,95,8,103,398,434
48217,217,48,2016,35101,312,10,322,389,450
48217,217,48,2017,35722,638,4,642,426,447
48217,217,48,2018,36178,497,-2,495,409,448
48217,217,48,2019,36536,391,-2,389,397,427
48217,217,48,2020,37006,484,4,488,419,434
48219,219,48,2010,22827,-115,9,-106,102,73
48219,219,48,2011,22907,-48,22,-26,322,215
48219,219,48,2012,23053,-30,25,-5,341,185
48219,219,48,2013,23387,176,5,181,328,176
48219,219,48,2014,23446,-17,7,-10,322,248
48219,219,48,2015,23291,-259,5,-254,308,209
48219,219,48,2016,23051,-356,18,-338,323,226
48219,219,48,2017,22974,-162,9,-153,277,201
48219,219,48,2018,22929,-121,7,-114,306,237
48219,219,48,2019,23055,-5,10,5,309,188
48219,219,48,2020,22921,-209,14,-195,302,241
48221,221,48,2010,51268,70,19,89,130,110
48221,221,48,2011,51564,224,81,305,566,572
48221,221,48,2012,52132,568,86,654,525,623
48221,221,48,2013,52872,671,76,747,605,615
48221,221,48,2014,53827,933,58,991,586,648
48221,221,48,2015,55246,1516,14,1530,633,762
48221,221,48,2016,56595,1379,8,1387,650,693
48221,221,48,2017,57994,1433,9,1442,610,658
48221,221,48,2018,60249,2405,0,2405,597,754
48221,221,48,2019,61762,1701,-2,1699,564,745
48221,221,48,2020,63527,1949,1,1950,575,747
48223,223,48,2010,35211,47,3,50,122,125
48223,223,48,2011,35261,-77,-2,-79,497,367
48223,223,48,2012,35309,-31,-18,-49,458,361
48223,223,48,2013,35297,-31,-16,-47,428,392
48223,223,48,2014,35686,283,1,284,474,369
48223,223,48,2015,35970,235,-4,231,451,396
48223,223,48,2016,36163,137,6,143,436,384
48223,223,48,2017,36456,219,-5,214,481,400
48223,223,48,2018,36690,278,-8,270,426,462
48223,223,48,2019,37063,271,-5,266,476,368
48223,223,48,2020,37170,69,-1,68,471,432
48225,225,48,2010,23683,1,5,6,61,112
48225,225,48,2011,23433,-208,11,-197,228,281
48225,225,48,2012,23212,-189,15,-174,229,277
48225,225,48,2013,22806,-325,11,-314,232,327
48225,225,48,2014,22807,58,20,78,244,320
48225,225,48,2015,22743,-13,15,2,218,280
48225,225,48,2016,22892,180,9,189,244,284
48225,225,48,2017,23073,237,7,244,235,297
48225,225,48,2018,23033,59,4,63,200,301
48225,225,48,2019,22877,-74,7,-67,207,297
48225,225,48,2020,22835,97,-1,96,191,327
48227,227,48,2010,34983,-28,22,-6,104,117
48227,227,48,2011,34967,-123,90,-33,408,390
48227,227,48,2012,35485,384,64,448,427,365
48227,227,48,2013,36170,543,46,589,455,374
48227,227,48,2014,36513,178,97,275,493,426
48227,227,48,2015,37114,364,117,481,507,389
48227,227,48,2016,36202,-1157,119,-1038,498,379
48227,227,48,2017,35778,-555,91,-464,431,392
48227,227,48,2018,35813,-112,67,-45,466,387
48227,227,48,2019,36732,742,86,828,438,345
48227,227,48,2020,36540,-370,73,-297,454,351
48229,229,48,2010,3472,-14,0,-14,11,0
48229,229,48,2011,3409,-101,3,-98,54,19
48229,229,48,2012,3353,-105,14,-91,49,16
48229,229,48,2013,3333,-60,11,-49,45,18
48229,229,48,2014,3300,-119,63,-56,39,19
48229,229,48,2015,3534,129,73,202,43,14
48229,229,48,2016,4259,613,87,700,39,18
48229,229,48,2017,4615,280,72,352,26,24
48229,229,48,2018,4782,98,61,159,35,29
48229,229,48,2019,4875,2,60,62,49,20
48229,229,48,2020,4906,-46,59,13,39,19
48231,231,48,2010,86367,146,28,174,285,243
48231,231,48,2011,86688,-38,95,57,1089,821
48231,231,48,2012,86992,-9,98,89,1052,815
48231,231,48,2013,87447,189,72,261,1059,853
48231,231,48,2014,88664,901,127,1028,1075,900
48231,231,48,2015,89708,678,127,805,1162,921
48231,231,48,2016,91920,1934,111,2045,1119,959
48231,231,48,2017,94058,1847,104,1951,1147,967
48231,231,48,2018,96667,2288,64,2352,1207,956
48231,231,48,2019,98559,1661,67,1728,1173,1006
48231,231,48,2020,99807,1097,59,1156,1187,1093
48233,233,48,2010,22211,-57,3,-54,62,49
48233,233,48,2011,22023,-254,16,-238,285,237
48233,233,48,2012,22024,-110,22,-88,313,224
48233,233,48,2013,21924,-151,10,-141,301,261
48233,233,48,2014,21917,-106,18,-88,315,231
48233,233,48,2015,21798,-138,5,-133,285,272
48233,233,48,2016,21540,-308,3,-305,305,258
48233,233,48,2017,21339,-287,1,-286,308,224
48233,233,48,2018,21068,-251,0,-251,237,259
48233,233,48,2019,20899,-217,-2,-219,253,203
48233,233,48,2020,20677,-225,-1,-226,235,229
48235,235,48,2010,1615,9,0,9,5,4
48235,235,48,2011,1601,-4,0,-4,12,22
48235,235,48,2012,1582,-32,0,-32,22,9
48235,235,48,2013,1621,41,0,41,10,13
48235,235,48,2014,1586,-40,0,-40,19,16
48235,235,48,2015,1555,-28,0,-28,12,15
48235,235,48,2016,1575,19,0,19,15,13
48235,235,48,2017,1523,-60,0,-60,19,11
48235,235,48,2018,1541,18,0,18,13,13
48235,235,48,2019,1565,25,0,25,12,13
48235,235,48,2020,1564,-4,0,-4,14,10
48237,237,48,2010,9004,-27,2,-25,23,35
48237,237,48,2011,9031,-7,13,6,102,82
48237,237,48,2012,8992,-57,1,-56,97,80
48237,237,48,2013,8950,-53,0,-53,95,85
48237,237,48,2014,8881,-59,-3,-62,96,102
48237,237,48,2015,8886,-10,4,-6,103,91
48237,237,48,2016,8785,-100,4,-96,94,100
48237,237,48,2017,8829,39,2,41,101,97
48237,237,48,2018,8826,4,0,4,84,90
48237,237,48,2019,8945,130,2,132,76,88
48237,237,48,2020,9056,107,2,109,80,76
48239,239,48,2010,14091,-17,1,-16,54,20
48239,239,48,2011,14050,-85,2,-83,176,133
48239,239,48,2012,14271,170,5,175,183,137
48239,239,48,2013,14609,299,7,306,199,173
48239,239,48,2014,14723,59,11,70,201,155
48239,239,48,2015,14807,13,19,32,211,160
48239,239,48,2016,14871,-26,15,-11,204,129
48239,239,48,2017,14798,-130,10,-120,200,153
48239,239,48,2018,14826,-2,3,1,225,198
48239,239,48,2019,14760,-159,9,-150,221,136
48239,239,48,2020,14854,13,6,19,215,141
48241,241,48,2010,35775,82,6,88,108,132
48241,241,48,2011,36201,331,38,369,470,412
48241,241,48,2012,35855,-510,44,-466,448,343
48241,241,48,2013,35615,-249,-8,-257,455,438
48241,241,48,2014,35425,-192,-5,-197,409,401
48241,241,48,2015,35268,-122,-4,-126,429,455
48241,241,48,2016,35443,135,9,144,451,417
48241,241,48,2017,35580,119,5,124,430,417
48241,241,48,2018,35802,259,-1,258,422,456
48241,241,48,2019,35610,-155,1,-154,384,420
48241,241,48,2020,35375,-154,0,-154,374,455
48243,243,48,2010,2344,-2,0,-2,4,1
48243,243,48,2011,2282,-52,-2,-54,14,23
48243,243,48,2012,2296,6,1,7,21,13
48243,243,48,2013,2231,-58,3,-55,10,22
48243,243,48,2014,2216,-7,2,-5,11,22
48243,243,48,2015,2197,-22,6,-16,12,13
48243,243,48,2016,2229,31,6,37,13,18
48243,243,48,2017,2257,28,3,31,16,20
48243,243,48,2018,2243,-10,4,-6,14,22
48243,243,48,2019,2275,28,4,32,21,21
48243,243,48,2020,2220,-44,3,-41,17,31
48245,245,48,2010,252457,-246,99,-147,875,538
48245,245,48,2011,253500,-511,471,-40,3433,2342
48245,245,48,2012,251617,-3608,523,-3085,3357,2281
48245,245,48,2013,253091,-140,538,398,3553,2436
48245,245,48,2014,252896,-1949,738,-1211,3535,2531
48245,245,48,2015,255115,289,760,1049,3705,2507
48245,245,48,2016,255696,-1224,638,-586,3711,2539
48245,245,48,2017,255889,-1362,562,-800,3523,2531
48245,245,48,2018,252655,-4615,452,-4163,3523,2617
48245,245,48,2019,251315,-2557,271,-2286,3392,2448
48245,245,48,2020,250127,-2094,273,-1821,3346,2718
48247,247,48,2010,5289,-6,-2,-8,18,22
48247,247,48,2011,5287,-43,5,-38,88,52
48247,247,48,2012,5275,-65,0,-65,100,49
48247,247,48,2013,5262,-66,14,-52,82,44
48247,247,48,2014,5328,2,24,26,111,70
48247,247,48,2015,5295,-88,24,-64,82,52
48247,247,48,2016,5245,-96,13,-83,87,54
48247,247,48,2017,5186,-101,13,-88,73,43
48247,247,48,2018,5160,-48,12,-36,71,62
48247,247,48,2019,5161,-8,12,4,45,47
48247,247,48,2020,5184,26,9,35,49,61
48249,249,48,2010,40914,1,2,3,163,116
48249,249,48,2011,41245,52,8,60,657,385
48249,249,48,2012,41673,197,22,219,595,384
48249,249,48,2013,41706,-235,23,-212,675,431
48249,249,48,2014,41525,-532,50,-482,694,398
48249,249,48,2015,41540,-311,59,-252,673,409
48249,249,48,2016,41206,-652,72,-580,634,389
48249,249,48,2017,40952,-511,65,-446,567,378
48249,249,48,2018,40799,-310,45,-265,514,402
48249,249,48,2019,40573,-388,45,-343,528,410
48249,249,48,2020,40452,-270,44,-226,514,409
48251,251,48,2010,151251,42,17,59,485,228
48251,251,48,2011,152084,140,64,204,1918,1284
48251,251,48,2012,153406,541,23,564,1963,1172
48251,251,48,2013,154531,474,5,479,1941,1269
48251,251,48,2014,156735,1568,-10,1558,1954,1310
48251,251,48,2015,159346,1803,26,1829,2107,1331
48251,251,48,2016,162816,2665,80,2745,2088,1367
48251,251,48,2017,167114,3537,53,3590,2098,1396
48251,251,48,2018,171294,3437,39,3476,2157,1455
48251,251,48,2019,175997,4062,11,4073,2124,1482
48251,251,48,2020,179575,3007,8,3015,2158,1579
48253,253,48,2010,20237,35,4,39,25,20
48253,253,48,2011,20271,76,13,89,155,213
48253,253,48,2012,19873,-439,10,-429,191,174
48253,253,48,2013,20041,168,12,180,190,206
48253,253,48,2014,19851,-185,7,-178,181,195
48253,253,48,2015,19965,157,0,157,157,201
48253,253,48,2016,19968,31,6,37,154,187
48253,253,48,2017,19829,-103,4,-99,167,207
48253,253,48,2018,19833,10,2,12,164,172
48253,253,48,2019,19867,48,4,52,154,170
48253,253,48,2020,19875,46,2,48,154,194
48255,255,48,2010,14886,28,6,34,35,11
48255,255,48,2011,14955,74,16,90,135,157
48255,255,48,2012,14857,-114,4,-110,165,159
48255,255,48,2013,14729,-126,15,-111,162,186
48255,255,48,2014,14907,48,82,130,190,138
48255,255,48,2015,15407,360,103,463,174,147
48255,255,48,2016,15513,-83,124,41,193,128
48255,255,48,2017,15590,-96,122,26,174,123
48255,255,48,2018,15715,17,106,123,167,164
48255,255,48,2019,15356,-464,113,-351,141,150
48255,255,48,2020,15562,134,89,223,144,160
48257,257,48,2010,103880,381,17,398,358,247
48257,257,48,2011,105212,664,64,728,1391,787
48257,257,48,2012,106569,672,56,728,1413,779
48257,257,48,2013,108269,1038,37,1075,1476,854
48257,257,48,2014,110895,1865,89,1954,1518,888
48257,257,48,2015,114083,2473,54,2527,1534,897
48257,257,48,2016,118040,3069,119,3188,1643,886
48257,257,48,2017,122753,4011,57,4068,1603,977
48257,257,48,2018,128512,4970,26,4996,1731,979
48257,257,48,2019,136459,7207,22,7229,1870,1127
48257,257,48,2020,143198,5978,30,6008,1953,1174
48259,259,48,2010,33594,192,12,204,86,90
48259,259,48,2011,34424,776,48,824,313,310
48259,259,48,2012,35563,997,72,1069,343,299
48259,259,48,2013,37151,1539,39,1578,320,346
48259,259,48,2014,38379,1161,45,1206,347,349
48259,259,48,2015,39959,1491,64,1555,358,352
48259,259,48,2016,41916,1890,60,1950,366,366
48259,259,48,2017,43985,1981,60,2041,391,372
48259,259,48,2018,45614,1582,60,1642,378,394
48259,259,48,2019,47418,1792,16,1808,406,401
48259,259,48,2020,48523,1179,21,1200,396,484
48261,261,48,2010,417,4,0,4,0,0
48261,261,48,2011,438,9,7,16,5,0
48261,261,48,2012,447,3,7,10,1,3
48261,261,48,2013,438,-24,8,-16,9,3
48261,261,48,2014,437,-14,11,-3,4,3
48261,261,48,2015,441,-8,10,2,3,1
48261,261,48,2016,427,-15,1,-14,3,4
48261,261,48,2017,408,-21,1,-20,5,4
48261,261,48,2018,419,16,1,17,1,9
48261,261,48,2019,385,-35,1,-34,3,1
48261,261,48,2020,379,-9,1,-8,2,0
48263,263,48,2010,812,5,0,5,1,1
48263,263,48,2011,813,6,0,6,6,12
48263,263,48,2012,825,18,0,18,5,11
48263,263,48,2013,782,-38,0,-38,9,16
48263,263,48,2014,747,-27,0,-27,11,19
48263,263,48,2015,746,4,0,4,9,15
48263,263,48,2016,748,1,0,1,8,7
48263,263,48,2017,758,15,0,15,5,10
48263,263,48,2018,724,-31,0,-31,8,12
48263,263,48,2019,758,39,0,39,4,9
48263,263,48,2020,786,34,0,34,8,14
48265,265,48,2010,49640,38,14,52,134,185
48265,265,48,2011,49635,174,26,200,473,675
48265,265,48,2012,49712,269,5,274,486,684
48265,265,48,2013,49781,319,-4,315,507,748
48265,265,48,2014,50333,700,44,744,504,706
48265,265,48,2015,50869,677,63,740,538,746
48265,265,48,2016,51442,670,72,742,566,735
48265,265,48,2017,51883,561,49,610,558,727
48265,265,48,2018,52359,688,31,719,524,767
48265,265,48,2019,52422,243,35,278,500,713
48265,265,48,2020,52869,699,28,727,504,783
48267,267,48,2010,4600,-10,0,-10,11,6
48267,267,48,2011,4592,25,0,25,36,70
48267,267,48,2012,4522,-55,-2,-57,43,58
48267,267,48,2013,4457,-58,-2,-60,44,49
48267,267,48,2014,4460,13,0,13,43,53
48267,267,48,2015,4387,-61,0,-61,41,53
48267,267,48,2016,4405,40,0,40,33,53
48267,267,48,2017,4380,-3,0,-3,38,60
48267,267,48,2018,4332,-25,0,-25,52,73
48267,267,48,2019,4362,25,0,25,54,50
48267,267,48,2020,4396,37,0,37,56,59
48269,269,48,2010,288,2,0,2,1,0
48269,269,48,2011,258,-34,0,-34,4,0
48269,269,48,2012,269,11,0,11,2,2
48269,269,48,2013,272,2,0,2,2,2
48269,269,48,2014,262,-8,0,-8,1,2
48269,269,48,2015,280,18,0,18,2,1
48269,269,48,2016,289,9,0,9,2,1
48269,269,48,2017,287,-3,0,-3,1,2
48269,269,48,2018,275,-11,0,-11,3,3
48269,269,48,2019,267,-11,0,-11,3,0
48269,269,48,2020,283,14,0,14,2,0
48271,271,48,2010,3591,7,2,9,6,22
48271,271,48,2011,3613,2,17,19,33,29
48271,271,48,2012,3646,5,20,25,35,28
48271,271,48,2013,3640,-31,29,-2,33,37
48271,271,48,2014,3563,-112,37,-75,30,36
48271,271,48,2015,3599,30,23,53,38,55
48271,271,48,2016,3634,1,21,22,36,23
48271,271,48,2017,3709,58,18,76,33,35
48271,271,48,2018,3690,-27,14,-13,40,45
48271,271,48,2019,3668,-43,18,-25,41,39
48271,271,48,2020,3670,-7,12,5,37,41
48273,273,48,2010,32037,-65,28,-37,99,86
48273,273,48,2011,32034,-311,91,-220,472,258
48273,273,48,2012,32093,-313,126,-187,492,244
48273,273,48,2013,32012,-471,93,-378,501,214
48273,273,48,2014,31884,-518,145,-373,481,249
48273,273,48,2015,31406,-766,101,-665,432,255
48273,273,48,2016,31309,-353,81,-272,433,260
48273,273,48,2017,30756,-708,62,-646,395,309
48273,273,48,2018,30718,-217,38,-179,417,276
48273,273,48,2019,30502,-432,48,-384,419,253
48273,273,48,2020,30338,-349,32,-317,406,253
48275,275,48,2010,3723,16,0,16,10,22
48275,275,48,2011,3721,0,4,4,44,51
48275,275,48,2012,3729,4,2,6,55,53
48275,275,48,2013,3719,-2,3,1,47,58
48275,275,48,2014,3797,68,5,73,61,57
48275,275,48,2015,3790,-13,5,-8,55,54
48275,275,48,2016,3729,-50,5,-45,41,57
48275,275,48,2017,3669,-37,5,-32,35,63
48275,275,48,2018,3651,-14,5,-9,40,50
48275,275,48,2019,3663,-7,5,-2,52,36
48275,275,48,2020,3683,6,4,10,47,37
48277,277,48,2010,49822,23,4,27,152,143
48277,277,48,2011,49869,-49,-5,-54,651,548
48277,277,48,2012,49673,-288,9,-279,672,588
48277,277,48,2013,49113,-540,2,-538,616,647
48277,277,48,2014,49435,227,11,238,726,636
48277,277,48,2015,49399,-52,10,-42,654,646
48277,277,48,2016,49555,33,24,57,670,568
48277,277,48,2017,49610,-23,19,-4,689,627
48277,277,48,2018,49672,105,6,111,611,658
48277,277,48,2019,49781,100,9,109,630,630
48277,277,48,2020,49905,207,12,219,628,723
48279,279,48,2010,13995,29,4,33,51,63
48279,279,48,2011,14064,-4,13,9,218,160
48279,279,48,2012,13870,-254,0,-254,203,149
48279,279,48,2013,13671,-237,6,-231,183,157
48279,279,48,2014,13491,-220,9,-211,190,162
48279,279,48,2015,13267,-274,6,-268,205,164
48279,279,48,2016,13205,-122,15,-107,187,140
48279,279,48,2017,13186,-71,10,-61,190,151
48279,279,48,2018,13087,-111,1,-110,159,148
48279,279,48,2019,12904,-227,5,-222,172,132
48279,279,48,2020,12710,-204,5,-199,157,153
48281,281,48,2010,19759,40,10,50,60,27
48281,281,48,2011,19920,92,43,135,220,193
48281,281,48,2012,20050,50,48,98,234,202
48281,281,48,2013,20138,35,39,74,231,213
48281,281,48,2014,20106,-91,22,-69,257,223
48281,281,48,2015,20362,187,13,200,231,174
48281,281,48,2016,20532,173,10,183,222,235
48281,281,48,2017,20867,302,9,311,221,198
48281,281,48,2018,21144,272,2,274,218,216
48281,281,48,2019,21429,296,4,300,188,202
48281,281,48,2020,21789,362,4,366,209,212
48283,283,48,2010,6913,8,0,8,20,3
48283,283,48,2011,7000,45,15,60,92,64
48283,283,48,2012,7154,85,17,102,104,55
48283,283,48,2013,7442,217,28,245,90,55
48283,283,48,2014,7482,-32,28,-4,104,59
48283,283,48,2015,7635,75,24,99,108,55
48283,283,48,2016,7600,-99,28,-71,96,61
48283,283,48,2017,7537,-106,27,-79,80,65
48283,283,48,2018,7507,-97,22,-75,96,52
48283,283,48,2019,7546,-25,24,-1,84,43
48283,283,48,2020,7500,-117,18,-99,92,40
48285,285,48,2010,19266,-3,3,0,45,51
48285,285,48,2011,19317,38,7,45,198,191
48285,285,48,2012,19532,243,-3,240,223,250
48285,285,48,2013,19630,108,4,112,232,246
48285,285,48,2014,19777,208,6,214,215,283
48285,285,48,2015,19920,160,15,175,237,267
48285,285,48,2016,19886,-4,11,7,232,272
48285,285,48,2017,20015,153,7,160,228,257
48285,285,48,2018,20086,113,5,118,229,274
48285,285,48,2019,20156,76,6,82,223,236
48285,285,48,2020,20216,89,9,98,222,259
48287,287,48,2010,16594,-13,0,-13,52,53
48287,287,48,2011,16555,-63,-9,-72,196,163
48287,287,48,2012,16504,-88,-8,-96,181,135
48287,287,48,2013,16542,-15,-4,-19,207,147
48287,287,48,2014,16614,67,-4,63,188,178
48287,287,48,2015,16859,188,-5,183,221,159
48287,287,48,2016,16961,99,-2,97,204,198
48287,287,48,2017,17104,137,-5,132,199,187
48287,287,48,2018,17113,-12,-6,-18,218,191
48287,287,48,2019,17295,138,-4,134,220,171
48287,287,48,2020,17397,42,-6,36,228,162
48289,289,48,2010,16724,-33,1,-32,42,85
48289,289,48,2011,16829,102,0,102,203,199
48289,289,48,2012,16740,-113,2,-111,223,197
48289,289,48,2013,16619,-90,2,-88,202,235
48289,289,48,2014,16731,117,3,120,207,216
48289,289,48,2015,17030,300,5,305,213,221
48289,289,48,2016,17200,160,3,163,214,207
48289,289,48,2017,17224,43,1,44,200,218
48289,289,48,2018,17289,73,0,73,207,215
48289,289,48,2019,17421,166,1,167,186,219
48289,289,48,2020,17493,120,2,122,192,240
48291,291,48,2010,75870,126,11,137,249,172
48291,291,48,2011,76005,-217,30,-187,1034,711
48291,291,48,2012,76378,-52,39,-13,1028,637
48291,291,48,2013,76847,137,41,178,1076,776
48291,291,48,2014,78047,785,68,853,1105,761
48291,291,48,2015,79537,1137,30,1167,1078,763
48291,291,48,2016,81381,1446,63,1509,1113,780
48291,291,48,2017,83648,1992,20,2012,1090,838
48291,291,48,2018,85834,1910,6,1916,1189,914
48291,291,48,2019,88453,2117,15,2132,1307,810
48291,291,48,2020,91547,2652,10,2662,1314,858
48293,293,48,2010,23490,34,18,52,84,33
48293,293,48,2011,23587,52,43,95,280,278
48293,293,48,2012,23679,-17,46,29,320,250
48293,293,48,2013,23433,-292,23,-269,298,280
48293,293,48,2014,23521,6,30,36,313,256
48293,293,48,2015,23433,-138,13,-125,319,281
48293,293,48,2016,23466,-33,15,-18,318,265
48293,293,48,2017,23376,-114,8,-106,277,260
48293,293,48,2018,23251,-72,1,-71,249,301
48293,293,48,2019,23389,131,3,134,263,259
48293,293,48,2020,23340,-1,6,5,244,298
48295,295,48,2010,3283,-24,1,-23,14,10
48295,295,48,2011,3334,5,12,17,59,25
48295,295,48,2012,3448,103,6,109,35,31
48295,295,48,2013,3489,22,5,27,44,32
48295,295,48,2014,3551,39,6,45,48,30
48295,295,48,2015,3557,-20,5,-15,43,22
48295,295,48,2016,3502,-93,7,-86,58,29
48295,295,48,2017,3361,-160,7,-153,36,25
48295,295,48,2018,3315,-58,7,-51,40,34
48295,295,48,2019,3214,-113,8,-105,32,27
48295,295,48,2020,3111,-100,5,-95,36,43
48297,297,48,2010,11550,22,1,23,35,34
48297,297,48,2011,11504,-44,6,-38,103,110
48297,297,48,2012,11671,142,9,151,120,111
48297,297,48,2013,11831,158,8,166,124,135
48297,297,48,2014,12063,194,15,209,130,109
48297,297,48,2015,12177,98,18,116,137,138
48297,297,48,2016,12038,-156,17,-139,133,133
48297,297,48,2017,12157,124,9,133,118,131
48297,297,48,2018,12120,-56,5,-51,141,126
48297,297,48,2019,12236,63,7,70,147,100
48297,297,48,2020,12324,51,7,58,143,113
48299,299,48,2010,19336,47,3,50,36,52
48299,299,48,2011,19073,-113,16,-97,136,301
48299,299,48,2012,19266,303,19,322,157,294
48299,299,48,2013,19509,392,-1,391,154,313
48299,299,48,2014,19666,265,5,270,163,283
48299,299,48,2015,20080,539,-4,535,167,298
48299,299,48,2016,20621,640,12,652,186,298
48299,299,48,2017,21199,742,11,753,151,328
48299,299,48,2018,21670,635,7,642,158,330
48299,299,48,2019,21810,315,7,322,170,353
48299,299,48,2020,21958,358,7,365,167,381
48301,301,48,2010,84,2,0,2,0,0
48301,301,48,2011,95,11,0,11,2,1
48301,301,48,2012,86,-9,0,-9,2,2
48301,301,48,2013,106,20,0,20,2,2
48301,301,48,2014,89,-17,0,-17,2,1
48301,301,48,2015,119,29,0,29,2,2
48301,301,48,2016,117,-4,0,-4,3,1
48301,301,48,2017,133,19,0,19,0,3
48301,301,48,2018,149,13,0,13,2,1
48301,301,48,2019,165,16,0,16,0,1
48301,301,48,2020,181,16,0,16,0,0
48303,303,48,2010,280332,696,79,775,1077,510
48303,303,48,2011,283476,1087,329,1416,3952,2221
48303,303,48,2012,286062,575,382,957,3853,2202
48303,303,48,2013,289646,1520,394,1914,3969,2298
48303,303,48,2014,294591,2483,452,2935,4242,2264
48303,303,48,2015,298509,1666,511,2177,4212,2466
48303,303,48,2016,302326,1525,486,2011,4194,2387
48303,303,48,2017,305689,1266,468,1734,4089,2465
48303,303,48,2018,308084,683,341,1024,4039,2668
48303,303,48,2019,311087,1406,311,1717,3857,2582
48303,303,48,2020,314772,2324,245,2569,3865,2762
48305,305,48,2010,5912,-21,0,-21,21,4
48305,305,48,2011,5883,-45,-1,-46,70,53
48305,305,48,2012,5793,-114,-1,-115,81,59
48305,305,48,2013,5726,-79,-1,-80,78,66
48305,305,48,2014,5798,35,0,35,80,44
48305,305,48,2015,5746,-58,2,-56,60,57
48305,305,48,2016,5775,5,1,6,78,54
48305,305,48,2017,5828,32,1,33,87,67
48305,305,48,2018,5846,15,2,17,65,63
48305,305,48,2019,5956,92,1,93,64,47
48305,305,48,2020,6025,55,1,56,67,53
48307,307,48,2010,8232,-44,0,-44,31,41
48307,307,48,2011,8256,50,-4,46,96,118
48307,307,48,2012,8241,-10,-3,-13,102,103
48307,307,48,2013,8244,8,2,10,103,109
48307,307,48,2014,8152,-52,7,-45,68,113
48307,307,48,2015,8253,111,6,117,93,112
48307,307,48,2016,8121,-126,1,-125,88,94
48307,307,48,2017,7934,-162,1,-161,78,104
48307,307,48,2018,7960,43,1,44,96,113
48307,307,48,2019,8011,76,1,77,81,106
48307,307,48,2020,7823,-154,1,-153,86,119
48309,309,48,2010,235904,517,37,554,848,413
48309,309,48,2011,237847,336,176,512,3401,1960
48309,309,48,2012,239369,-167,241,74,3440,1949
48309,309,48,2013,241447,599,253,852,3412,2165
48309,309,48,2014,243182,-194,399,205,3594,2031
48309,309,48,2015,245471,466,415,881,3628,2189
48309,309,48,2016,247573,321,414,735,3448,2068
48309,309,48,2017,251638,2489,290,2779,3364,2088
48309,309,48,2018,254204,1222,202,1424,3493,2342
48309,309,48,2019,257080,1397,196,1593,3455,2180
48309,309,48,2020,259730,1357,171,1528,3456,2345
48311,311,48,2010,711,3,0,3,1,1
48311,311,48,2011,697,-17,1,-16,10,7
48311,311,48,2012,731,31,1,32,7,6
48311,311,48,2013,762,37,3,40,8,18
48311,311,48,2014,801,29,9,38,7,8
48311,311,48,2015,831,18,3,21,13,5
48311,311,48,2016,810,-24,2,-22,10,8
48311,311,48,2017,766,-45,1,-44,8,8
48311,311,48,2018,727,-40,0,-40,9,9
48311,311,48,2019,733,6,0,6,6,6
48311,311,48,2020,721,-9,0,-9,9,12
48313,313,48,2010,13737,54,7,61,44,42
48313,313,48,2011,13747,-64,42,-22,144,111
48313,313,48,2012,13739,-54,26,-28,148,127
48313,313,48,2013,13812,54,4,58,154,138
48313,313,48,2014,13857,4,17,21,166,138
48313,313,48,2015,13954,49,17,66,157,124
48313,313,48,2016,14127,115,51,166,144,138
48313,313,48,2017,14292,74,40,114,174,122
48313,313,48,2018,14417,95,34,129,160,165
48313,313,48,2019,14382,-132,41,-91,189,134
48313,313,48,2020,14427,-25,28,3,181,139
48315,315,48,2010,10491,-11,0,-11,23,62
48315,315,48,2011,10485,58,0,58,90,154
48315,315,48,2012,10387,-57,0,-57,110,153
48315,315,48,2013,10293,-40,-1,-41,110,162
48315,315,48,2014,10168,-33,1,-32,80,171
48315,315,48,2015,10152,64,1,65,100,181
48315,315,48,2016,10134,60,3,63,87,167
48315,315,48,2017,10076,32,2,34,85,175
48315,315,48,2018,9915,-79,1,-78,83,167
48315,315,48,2019,9848,-8,2,-6,72,132
48315,315,48,2020,9960,195,0,195,73,154
48317,317,48,2010,4809,10,0,10,20,19
48317,317,48,2011,4885,44,-2,42,71,37
48317,317,48,2012,4976,31,9,40,85,37
48317,317,48,2013,5268,223,22,245,85,45
48317,317,48,2014,5457,100,16,116,107,36
48317,317,48,2015,5639,108,10,118,112,50
48317,317,48,2016,5627,-90,7,-83,114,42
48317,317,48,2017,5526,-147,-1,-148,88,44
48317,317,48,2018,5668,127,-1,126,75,58
48317,317,48,2019,5743,35,2,37,82,43
48317,317,48,2020,5816,27,1,28,88,43
48319,319,48,2010,4010,7,3,10,8,20
48319,319,48,2011,4034,7,20,27,34,37
48319,319,48,2012,4056,14,13,27,42,45
48319,319,48,2013,4122,61,12,73,32,41
48319,319,48,2014,4101,-37,18,-19,45,47
48319,319,48,2015,4063,-44,14,-30,42,51
48319,319,48,2016,4159,93,13,106,34,43
48319,319,48,2017,4185,35,8,43,36,54
48319,319,48,2018,4263,94,4,98,35,54
48319,319,48,2019,4287,25,7,32,27,35
48319,319,48,2020,4344,78,3,81,24,47
48321,321,48,2010,36706,-15,2,-13,121,100
48321,321,48,2011,36675,-226,-12,-238,546,339
48321,321,48,2012,36534,-341,7,-334,522,332
48321,321,48,2013,36483,-135,-6,-141,481,388
48321,321,48,2014,36463,-192,-3,-195,545,371
48321,321,48,2015,36747,108,25,133,538,386
48321,321,48,2016,37143,154,70,224,577,403
48321,321,48,2017,36848,-458,37,-421,545,421
48321,321,48,2018,36583,-420,18,-402,549,413
48321,321,48,2019,36655,-135,33,-102,514,339
48321,321,48,2020,36725,-86,28,-58,517,390
48323,323,48,2010,54424,64,-28,36,232,100
48323,323,48,2011,55233,7,111,118,1018,324
48323,323,48,2012,55723,-326,120,-206,1035,340
48323,323,48,2013,56475,-177,143,-34,1136,348
48323,323,48,2014,57044,-398,235,-163,1092,362
48323,323,48,2015,57643,-458,265,-193,1193,402
48323,323,48,2016,57901,-692,227,-465,1131,409
48323,323,48,2017,57883,-789,82,-707,1074,389
48323,323,48,2018,57970,-615,53,-562,1020,372
48323,323,48,2019,58357,-306,61,-245,1038,410
48323,323,48,2020,58378,-647,61,-586,1019,410
48325,325,48,2010,46130,59,8,67,120,67
48325,325,48,2011,46521,189,3,192,547,347
48325,325,48,2012,46812,160,1,161,487,350
48325,325,48,2013,47257,347,-1,346,495,396
48325,325,48,2014,47851,408,25,433,576,416
48325,325,48,2015,48419,372,15,387,605,421
48325,325,48,2016,49239,643,19,662,553,395
48325,325,48,2017,50205,744,8,752,631,420
48325,325,48,2018,50933,563,6,569,610,450
48325,325,48,2019,51608,544,7,551,576,451
48325,325,48,2020,52358,660,9,669,576,491
48327,327,48,2010,2230,1,0,1,3,16
48327,327,48,2011,2215,13,3,16,11,42
48327,327,48,2012,2205,4,3,7,18,34
48327,327,48,2013,2138,-67,2,-65,26,30
48327,327,48,2014,2129,-7,3,-4,23,29
48327,327,48,2015,2135,30,2,32,16,42
48327,327,48,2016,2097,-24,4,-20,17,35
48327,327,48,2017,2115,35,2,37,13,32
48327,327,48,2018,2103,2,1,3,22,37
48327,327,48,2019,2099,10,3,13,13,29
48327,327,48,2020,2124,31,2,33,16,24
48329,329,48,2010,136987,-226,12,-214,545,228
48329,329,48,2011,140247,1921,96,2017,2261,1029
48329,329,48,2012,147365,5273,201,5474,2408,983
48329,329,48,2013,152387,3058,284,3342,2637,1055
48329,329,48,2014,156767,2095,495,2590,2750,1032
48329,329,48,2015,162381,3163,554,3717,2918,1078
48329,329,48,2016,163928,-878,564,-314,2968,1107
48329,329,48,2017,165417,-755,464,-291,2872,1091
48329,329,48,2018,172537,4910,334,5244,2967,1112
48329,329,48,2019,176444,1694,358,2052,2970,1122
48329,329,48,2020,177863,-696,295,-401,3025,1222
48331,331,48,2010,24683,-66,3,-63,70,84
48331,331,48,2011,24610,-114,29,-85,297,284
48331,331,48,2012,24116,-560,19,-541,299,269
48331,331,48,2013,24096,-56,19,-37,305,286
48331,331,48,2014,24147,18,10,28,320,291
48331,331,48,2015,24364,188,10,198,326,304
48331,331,48,2016,24678,301,-4,297,326,308
48331,331,48,2017,24907,259,-6,253,283,305
48331,331,48,2018,24970,85,-7,78,297,310
48331,331,48,2019,24721,-215,-6,-221,246,273
48331,331,48,2020,24708,42,-3,39,250,303
48333,333,48,2010,4969,19,0,19,15,7
48333,333,48,2011,4883,-66,5,-61,39,65
48333,333,48,2012,4833,-19,2,-17,40,71
48333,333,48,2013,4873,65,1,66,41,66
48333,333,48,2014,4871,17,4,21,45,68
48333,333,48,2015,4887,16,1,17,56,57
48333,333,48,2016,4886,27,5,32,38,71
48333,333,48,2017,4923,63,3,66,36,65
48333,333,48,2018,4865,-26,2,-24,33,66
48333,333,48,2019,4872,38,3,41,37,70
48333,333,48,2020,4840,7,4,11,35,78
48335,335,48,2010,9411,6,0,6,31,29
48335,335,48,2011,9397,4,-2,2,90,105
48335,335,48,2012,9332,-79,0,-79,99,86
48335,335,48,2013,9002,-342,-2,-344,104,105
48335,335,48,2014,9075,74,1,75,95,99
48335,335,48,2015,8863,-212,0,-212,99,104
48335,335,48,2016,8481,-370,4,-366,90,110
48335,335,48,2017,8234,-266,4,-262,112,99
48335,335,48,2018,8201,-44,4,-40,95,87
48335,335,48,2019,8161,-69,6,-63,92,70
48335,335,48,2020,8202,24,4,28,88,75
48337,337,48,2010,19719,-16,1,-15,63,50
48337,337,48,2011,19760,65,3,68,250,275
48337,337,48,2012,19477,-252,13,-239,211,257
48337,337,48,2013,19386,-28,6,-22,228,297
48337,337,48,2014,19366,-4,2,-2,220,234
48337,337,48,2015,19254,-57,1,-56,233,287
48337,337,48,2016,19387,163,11,174,232,273
48337,337,48,2017,19408,65,-1,64,238,281
48337,337,48,2018,19596,264,-2,262,190,263
48337,337,48,2019,19848,320,2,322,200,269
48337,337,48,2020,19962,222,-2,220,189,293
48339,339,48,2010,459223,2229,348,2577,1521,766
48339,339,48,2011,471456,7278,1493,8771,6350,2924
48339,339,48,2012,484627,8223,1341,9564,6402,2995
48339,339,48,2013,498488,9419,967,10386,6418,3131
48339,339,48,2014,517262,13383,1589,14972,6772,3324
48339,339,48,2015,535913,13135,1687,14822,7101,3434
48339,339,48,2016,555338,14059,1516,15575,7461,3668
48339,339,48,2017,571542,11216,1404,12620,7266,3712
48339,339,48,2018,590127,14287,1029,15316,7265,4028
48339,339,48,2019,607583,13414,930,14344,7404,4262
48339,339,48,2020,626351,15305,764,16069,7586,4800
48341,341,48,2010,22008,-14,42,28,96,19
48341,341,48,2011,22075,-380,179,-201,406,139
48341,341,48,2012,22431,-103,196,93,411,148
48341,341,48,2013,22139,-754,142,-612,429,129
48341,341,48,2014,21975,-606,140,-466,431,142
48341,341,48,2015,21709,-603,65,-538,429,166
48341,341,48,2016,21638,-453,69,-384,462,151
48341,341,48,2017,21571,-353,37,-316,399,153
48341,341,48,2018,21053,-770,19,-751,372,140
48341,341,48,2019,20931,-413,28,-385,400,138
48341,341,48,2020,20654,-552,26,-526,388,135
48343,343,48,2010,12918,0,2,2,39,55
48343,343,48,2011,12769,-137,2,-135,150,164
48343,343,48,2012,12698,-66,7,-59,159,172
48343,343,48,2013,12674,-16,7,-9,159,172
48343,343,48,2014,12599,-77,0,-77,153,151
48343,343,48,2015,12360,-206,1,-205,138,172
48343,343,48,2016,12420,82,0,82,158,178
48343,343,48,2017,12360,-36,-2,-38,160,183
48343,343,48,2018,12269,-42,-2,-44,136,182
48343,343,48,2019,12343,99,-2,97,146,168
48343,343,48,2020,12393,59,-1,58,148,156
48345,345,48,2010,1205,2,0,2,5,7
48345,345,48,2011,1200,7,0,7,9,22
48345,345,48,2012,1197,5,0,5,9,15
48345,345,48,2013,1192,-3,0,-3,11,15
48345,345,48,2014,1149,-28,0,-28,5,20
48345,345,48,2015,1146,4,0,4,5,12
48345,345,48,2016,1169,32,0,32,6,16
48345,345,48,2017,1226,64,0,64,14,21
48345,345,48,2018,1234,13,0,13,11,17
48345,345,48,2019,1200,-27,0,-27,8,15
48345,345,48,2020,1185,-8,0,-8,14,20
48347,347,48,2010,64684,5,17,22,239,99
48347,347,48,2011,65656,544,74,618,934,582
48347,347,48,2012,65868,-267,122,-145,903,543
48347,347,48,2013,65188,-1138,80,-1058,906,555
48347,347,48,2014,65235,-375,107,-268,884,574
48347,347,48,2015,65456,-63,47,-16,861,616
48347,347,48,2016,65532,-247,-4,-251,870,540
48347,347,48,2017,65231,-518,-14,-532,778,550
48347,347,48,2018,65039,-346,-26,-372,788,608
48347,347,48,2019,64846,-377,-28,-405,804,593
48347,347,48,2020,64753,-224,-23,-247,794,643
48349,349,48,2010,47870,-6,1,-5,168,126
48349,349,48,2011,48072,0,5,5,666,467
48349,349,48,2012,48157,-91,4,-87,668,491
48349,349,48,2013,48036,-316,0,-316,687,492
48349,349,48,2014,47907,-395,4,-391,765,507
48349,349,48,2015,48167,90,25,115,699,550
48349,349,48,2016,48403,41,56,97,694,551
48349,349,48,2017,48744,196,25,221,709,587
48349,349,48,2018,49556,638,14,652,686,525
48349,349,48,2019,49978,320,20,340,636,553
48349,349,48,2020,50694,671,18,689,645,614
48351,351,48,2010,14447,-4,1,-3,25,19
48351,351,48,2011,14562,118,5,123,147,155
48351,351,48,2012,14433,-130,8,-122,157,166
48351,351,48,2013,14343,-64,7,-57,133,167
48351,351,48,2014,14294,-18,0,-18,141,169
48351,351,48,2015,14161,-135,0,-135,157,155
48351,351,48,2016,14162,24,0,24,133,154
48351,351,48,2017,13909,-201,0,-201,114,167
48351,351,48,2018,13784,-91,0,-91,121,155
48351,351,48,2019,13673,-42,0,-42,106,175
48351,351,48,2020,13414,-153,0,-153,106,211
48353,353,48,2010,15247,4,0,4,54,23
48353,353,48,2011,15147,-74,5,-69,172,202
48353,353,48,2012,14939,-249,7,-242,201,173
48353,353,48,2013,15076,98,8,106,209,180
48353,353,48,2014,15139,9,16,25,236,196
48353,353,48,2015,15128,-61,23,-38,204,177
48353,353,48,2016,15082,-125,50,-75,204,174
48353,353,48,2017,14912,-225,38,-187,192,176
48353,353,48,2018,14845,-100,29,-71,190,186
48353,353,48,2019,14833,-90,38,-52,201,162
48353,353,48,2020,14835,-50,31,-19,195,174
48355,355,48,2010,340251,-537,121,-416,1140,693
48355,355,48,2011,343278,506,469,975,4683,2624
48355,355,48,2012,347966,1925,744,2669,4651,2630
48355,355,48,2013,352987,2315,622,2937,4894,2826
48355,355,48,2014,356717,712,753,1465,5105,2793
48355,355,48,2015,360587,804,814,1618,5138,2861
48355,355,48,2016,361753,-1638,710,-928,4928,2826
48355,355,48,2017,361328,-2675,565,-2110,4590,2907
48355,355,48,2018,362177,-1157,375,-782,4596,2965
48355,355,48,2019,362347,-1710,389,-1321,4476,2997
48355,355,48,2020,363148,-790,328,-462,4467,3227
48357,357,48,2010,10171,-68,5,-63,33,28
48357,357,48,2011,10444,125,24,149,187,63
48357,357,48,2012,10611,66,12,78,174,85
48357,357,48,2013,10701,17,9,26,168,103
48357,357,48,2014,10709,-117,18,-99,195,90
48357,357,48,2015,10690,-125,11,-114,196,102
48357,357,48,2016,10259,-561,23,-538,188,84
48357,357,48,2017,10004,-357,2,-355,178,81
48357,357,48,2018,9861,-224,-4,-228,153,70
48357,357,48,2019,9815,-119,2,-117,123,51
48357,357,48,2020,9598,-289,7,-282,139,73
48359,359,48,2010,2050,-2,0,-2,5,5
48359,359,48,2011,2072,23,0,23,15,15
48359,359,48,2012,2046,-33,0,-33,19,13
48359,359,48,2013,2087,40,0,40,20,20
48359,359,48,2014,2068,-39,0,-39,33,14
48359,359,48,2015,2064,-7,0,-7,22,19
48359,359,48,2016,2071,1,1,2,19,15
48359,359,48,2017,2106,24,1,25,27,16
48359,359,48,2018,2122,2,0,2,25,13
48359,359,48,2019,2115,-11,1,-10,19,15
48359,359,48,2020,2135,8,0,8,20,8
48361,361,48,2010,82015,91,7,98,264,180
48361,361,48,2011,82350,230,7,237,986,885
48361,361,48,2012,82908,361,7,368,1098,892
48361,361,48,2013,82853,-233,7,-226,1134,955
48361,361,48,2014,83301,292,7,299,1129,960
48361,361,48,2015,84026,443,24,467,1202,937
48361,361,48,2016,84652,356,22,378,1191,938
48361,361,48,2017,85056,325,10,335,1127,1054
48361,361,48,2018,83207,-1814,8,-1806,1046,1093
48361,361,48,2019,83086,-262,6,-256,1040,906
48361,361,48,2020,82878,-258,10,-248,1019,982
48363,363,48,2010,28093,-21,2,-19,75,94
48363,363,48,2011,28059,-68,0,-68,337,304
48363,363,48,2012,27862,-318,9,-309,388,283
48363,363,48,2013,27878,-50,11,-39,384,325
48363,363,48,2014,28033,62,17,79,374,293
48363,363,48,2015,27963,-99,18,-81,354,339
48363,363,48,2016,28131,159,20,179,349,359
48363,363,48,2017,28554,405,14,419,338,333
48363,363,48,2018,28843,253,6,259,373,344
48363,363,48,2019,29114,271,6,277,338,344
48363,363,48,2020,29320,263,5,268,344,407
48365,365,48,2010,23770,15,4,19,60,100
48365,365,48,2011,24008,166,27,193,316,270
48365,365,48,2012,24000,-55,15,-40,296,265
48365,365,48,2013,23791,-245,18,-227,295,278
48365,365,48,2014,23749,-49,18,-31,277,286
48365,365,48,2015,23661,-149,23,-126,302,262
48365,365,48,2016,23407,-271,4,-267,287,275
48365,365,48,2017,23165,-226,-2,-228,263,278
48365,365,48,2018,23069,-60,-3,-63,254,285
48365,365,48,2019,23103,22,-2,20,264,250
48365,365,48,2020,23187,103,-1,102,261,280
48367,367,48,2010,117324,257,22,279,350,268
48367,367,48,2011,118326,668,29,697,1262,955
48367,367,48,2012,119494,773,25,798,1291,912
48367,367,48,2013,119807,-79,30,-49,1317,984
48367,367,48,2014,122185,1859,107,1966,1423,1026
48367,367,48,2015,125691,3038,87,3125,1435,1082
48367,367,48,2016,129016,2786,101,2887,1487,1056
48367,367,48,2017,133616,4156,104,4260,1482,1158
48367,367,48,2018,138254,4159,78,4237,1566,1172
48367,367,48,2019,143149,4443,82,4525,1565,1182
48367,367,48,2020,148198,4729,70,4799,1600,1320
48369,369,48,2010,10266,2,5,7,29,38
48369,369,48,2011,10280,-99,49,-50,152,86
48369,369,48,2012,10188,-227,46,-181,151,71
48369,369,48,2013,9989,-319,40,-279,150,79
48369,369,48,2014,9954,-187,47,-140,158,57
48369,369,48,2015,9791,-269,32,-237,153,84
48369,369,48,2016,9764,-159,31,-128,181,79
48369,369,48,2017,9688,-173,14,-159,150,69
48369,369,48,2018,9666,-89,7,-82,147,87
48369,369,48,2019,9555,-204,13,-191,130,50
48369,369,48,2020,9522,-144,13,-131,135,37
48371,371,48,2010,15521,-1,4,3,48,35
48371,371,48,2011,15638,-26,19,-7,232,108
48371,371,48,2012,15563,-170,7,-163,217,128
48371,371,48,2013,15656,-10,-3,-13,224,116
48371,371,48,2014,15818,38,-3,35,235,104
48371,371,48,2015,16022,86,22,108,223,127
48371,371,48,2016,15852,-253,19,-234,184,121
48371,371,48,2017,15626,-295,14,-281,189,134
48371,371,48,2018,15673,-48,13,-35,208,126
48371,371,48,2019,15757,-26,11,-15,200,102
48371,371,48,2020,15718,-153,12,-141,204,102
48373,373,48,2010,45444,36,14,50,137,162
48373,373,48,2011,45582,162,60,222,473,560
48373,373,48,2012,45517,-36,72,36,494,602
48373,373,48,2013,45527,15,111,126,509,625
48373,373,48,2014,45815,280,129,409,497,641
48373,373,48,2015,46617,805,144,949,514,681
48373,373,48,2016,47654,1032,113,1145,557,673
48373,373,48,2017,48938,1305,103,1408,495,630
48373,373,48,2018,49933,1091,82,1173,508,695
48373,373,48,2019,51254,1359,93,1452,497,626
48373,373,48,2020,52995,1838,66,1904,515,663
48375,375,48,2010,121329,1,84,85,534,316
48375,375,48,2011,122268,-430,463,33,2039,1131
48375,375,48,2012,122706,-1050,584,-466,2038,1145
48375,375,48,2013,122091,-2141,552,-1589,2126,1187
48375,375,48,2014,122019,-1658,697,-961,2101,1232
48375,375,48,2015,121214,-2277,680,-1597,1995,1225
48375,375,48,2016,120440,-1964,512,-1452,1906,1233
48375,375,48,2017,120008,-1549,448,-1101,1823,1159
48375,375,48,2018,118344,-2413,333,-2080,1649,1243
48375,375,48,2019,116818,-2313,334,-1979,1619,1163
48375,375,48,2020,116004,-1491,278,-1213,1570,1162
48377,377,48,2010,7875,32,6,38,36,18
48377,377,48,2011,7754,-235,17,-218,128,31
48377,377,48,2012,7614,-232,24,-208,97,36
48377,377,48,2013,7383,-351,43,-308,118,50
48377,377,48,2014,7189,-347,61,-286,134,53
48377,377,48,2015,7048,-288,60,-228,133,50
48377,377,48,2016,7113,-38,36,-2,109,42
48377,377,48,2017,7044,-152,4,-148,133,54
48377,377,48,2018,6764,-315,3,-312,88,55
48377,377,48,2019,6612,-216,10,-206,101,47
48377,377,48,2020,6508,-145,4,-141,96,57
48379,379,48,2010,10898,12,1,13,22,40
48379,379,48,2011,10990,96,6,102,104,113
48379,379,48,2012,10927,-61,13,-48,98,115
48379,379,48,2013,11020,98,11,109,116,134
48379,379,48,2014,11001,34,11,45,81,145
48379,379,48,2015,11121,157,10,167,101,149
48379,379,48,2016,11283,228,11,239,86,165
48379,379,48,2017,11713,469,6,475,104,151
48379,379,48,2018,12056,376,5,381,127,165
48379,379,48,2019,12401,338,7,345,133,131
48379,379,48,2020,12552,166,7,173,121,143
48381,381,48,2010,121221,298,35,333,381,266
48381,381,48,2011,123480,1387,126,1513,1650,910
48381,381,48,2012,125047,749,183,932,1568,933
48381,381,48,2013,126833,992,167,1159,1652,1036
48381,381,48,2014,128823,1022,215,1237,1729,980
48381,381,48,2015,130463,815,141,956,1756,1066
48381,381,48,2016,132465,1282,124,1406,1656,1061
48381,381,48,2017,134148,993,110,1103,1601,1015
48381,381,48,2018,135745,987,60,1047,1613,1062
48381,381,48,2019,137770,1482,67,1549,1622,1142
48381,381,48,2020,139899,1667,47,1714,1645,1223
48383,383,48,2010,3353,-28,1,-27,13,2
48383,383,48,2011,3395,10,3,13,46,17
48383,383,48,2012,3477,64,0,64,42,25
48383,383,48,2013,3630,98,26,124,67,38
48383,383,48,2014,3784,74,31,105,69,24
48383,383,48,2015,3804,-40,36,-4,49,25
48383,383,48,2016,3721,-165,43,-122,74,37
48383,383,48,2017,3706,-115,48,-67,78,26
48383,383,48,2018,3728,-49,39,-10,56,24
48383,383,48,2019,3842,35,40,75,61,21
48383,383,48,2020,3833,-92,33,-59,67,17
48385,385,48,2010,3322,10,0,10,8,5
48385,385,48,2011,3432,126,1,127,27,45
48385,385,48,2012,3354,-62,1,-61,43,60
48385,385,48,2013,3320,5,1,6,30,69
48385,385,48,2014,3347,48,1,49,27,51
48385,385,48,2015,3297,-54,2,-52,42,41
48385,385,48,2016,3387,103,0,103,30,44
48385,385,48,2017,3413,45,0,45,44,63
48385,385,48,2018,3475,86,0,86,31,55
48385,385,48,2019,3460,-6,0,-6,36,45
48385,385,48,2020,3411,-25,0,-25,39,63
48387,387,48,2010,12873,4,-1,3,33,23
48387,387,48,2011,12681,-132,-2,-134,134,192
48387,387,48,2012,12721,93,-2,91,124,177
48387,387,48,2013,12484,-187,-2,-189,143,194
48387,387,48,2014,12443,-12,-2,-14,157,181
48387,387,48,2015,12344,-19,-4,-23,107,180
48387,387,48,2016,12175,-119,-1,-120,112,162
48387,387,48,2017,12167,57,-1,56,131,193
48387,387,48,2018,12141,33,0,33,123,181
48387,387,48,2019,12095,9,-1,8,113,167
48387,387,48,2020,11995,-11,1,-10,118,206
48389,389,48,2010,13830,9,9,18,41,11
48389,389,48,2011,14095,150,41,191,166,94
48389,389,48,2012,14256,50,53,103,153,93
48389,389,48,2013,14478,107,66,173,173,125
48389,389,48,2014,15103,428,94,522,200,118
48389,389,48,2015,15556,257,85,342,211,105
48389,389,48,2016,15203,-534,82,-452,205,111
48389,389,48,2017,15141,-206,62,-144,188,108
48389,389,48,2018,15486,225,45,270,198,124
48389,389,48,2019,15951,335,54,389,179,103
48389,389,48,2020,15949,-119,39,-80,192,115
48391,391,48,2010,7376,-21,0,-21,22,8
48391,391,48,2011,7323,-39,2,-37,89,105
48391,391,48,2012,7259,-64,10,-54,86,99
48391,391,48,2013,7283,30,7,37,83,94
48391,391,48,2014,7366,87,7,94,87,98
48391,391,48,2015,7331,-36,7,-29,101,108
48391,391,48,2016,7275,-53,4,-49,96,104
48391,391,48,2017,7178,-96,3,-93,85,88
48391,391,48,2018,6921,-251,5,-246,85,96
48391,391,48,2019,6824,-103,2,-101,48,44
48391,391,48,2020,6877,35,2,37,59,43
48393,393,48,2010,920,-6,0,-6,4,4
48393,393,48,2011,922,-3,0,-3,11,7
48393,393,48,2012,938,14,0,14,10,6
48393,393,48,2013,915,-18,0,-18,8,15
48393,393,48,2014,910,-3,0,-3,10,12
48393,393,48,2015,906,0,0,0,6,8
48393,393,48,2016,910,-2,0,-2,12,7
48393,393,48,2017,937,19,0,19,15,6
48393,393,48,2018,889,-41,0,-41,5,13
48393,393,48,2019,837,-50,0,-50,6,9
48393,393,48,2020,813,-19,0,-19,6,10
48395,395,48,2010,16551,-34,-1,-35,43,74
48395,395,48,2011,16652,78,-1,77,211,185
48395,395,48,2012,16447,-229,3,-226,204,188
48395,395,48,2013,16420,-87,17,-70,212,167
48395,395,48,2014,16457,17,23,40,202,201
48395,395,48,2015,16688,188,23,211,213,195
48395,395,48,2016,16821,83,24,107,232,205
48395,395,48,2017,17152,278,27,305,215,189
48395,395,48,2018,17237,61,19,80,199,193
48395,395,48,2019,17104,-187,20,-167,209,175
48395,395,48,2020,17155,26,14,40,199,186
48397,397,48,2010,78971,419,26,445,216,114
48397,397,48,2011,81103,1486,110,1596,961,435
48397,397,48,2012,82772,1121,70,1191,994,531
48397,397,48,2013,84732,1457,43,1500,952,507
48397,397,48,2014,87138,1779,130,1909,1026,564
48397,397,48,2015,90258,2543,162,2705,928,541
48397,397,48,2016,93579,2620,151,2771,1088,548
48397,397,48,2017,96956,2777,132,2909,1037,573
48397,397,48,2018,100592,3152,96,3248,1055,670
48397,397,48,2019,104862,3763,77,3840,1085,642
48397,397,48,2020,109888,4522,77,4599,1150,689
48399,399,48,2010,10510,20,0,20,35,47
48399,399,48,2011,10503,-6,11,5,128,139
48399,399,48,2012,10337,-143,10,-133,110,144
48399,399,48,2013,10197,-100,5,-95,97,144
48399,399,48,2014,10297,118,18,136,101,136
48399,399,48,2015,10387,118,15,133,91,134
48399,399,48,2016,10290,-94,7,-87,124,134
48399,399,48,2017,10275,29,3,32,106,153
48399,399,48,2018,10167,-83,2,-81,110,138
48399,399,48,2019,10265,89,4,93,113,106
48399,399,48,2020,10401,140,2,142,116,121
48401,401,48,2010,53307,20,5,25,147,113
48401,401,48,2011,53644,189,22,211,693,568
48401,401,48,2012,53735,-71,10,-61,666,507
48401,401,48,2013,53269,-554,-22,-576,693,595
48401,401,48,2014,53144,-213,30,-183,594,531
48401,401,48,2015,52897,-292,18,-274,584,554
48401,401,48,2016,52836,-159,14,-145,633,546
48401,401,48,2017,54148,1238,-3,1235,603,540
48401,401,48,2018,54246,118,-14,104,548,552
48401,401,48,2019,54386,115,-8,107,580,546
48401,401,48,2020,54324,10,-8,2,556,623
48403,403,48,2010,10870,32,0,32,22,23
48403,403,48,2011,10727,-56,-1,-57,92,177
48403,403,48,2012,10526,-139,-1,-140,93,155
48403,403,48,2013,10428,14,0,14,73,183
48403,403,48,2014,10435,87,-2,85,96,175
48403,403,48,2015,10451,108,-2,106,91,181
48403,403,48,2016,10389,11,-4,7,108,176
48403,403,48,2017,10422,126,-6,120,105,193
48403,403,48,2018,10541,190,-6,184,97,164
48403,403,48,2019,10490,-5,-6,-11,103,141
48403,403,48,2020,10507,77,-4,73,97,153
48405,405,48,2010,8855,-11,-1,-12,24,17
48405,405,48,2011,8798,34,0,34,92,183
48405,405,48,2012,8789,8,0,8,119,135
48405,405,48,2013,8661,-96,0,-96,104,136
48405,405,48,2014,8479,-137,1,-136,82,130
48405,405,48,2015,8346,-98,2,-96,105,141
48405,405,48,2016,8280,-5,3,-2,78,141
48405,405,48,2017,8302,40,1,41,88,107
48405,405,48,2018,8251,11,1,12,78,141
48405,405,48,2019,8220,11,2,13,75,119
48405,405,48,2020,8248,105,3,108,72,151
48407,407,48,2010,26480,64,0,64,77,45
48407,407,48,2011,26789,344,-9,335,255,282
48407,407,48,2012,26956,187,-15,172,272,275
48407,407,48,2013,26745,-173,-14,-187,278,296
48407,407,48,2014,27066,320,-16,304,296,280
48407,407,48,2015,27376,344,-12,332,277,301
48407,407,48,2016,27743,430,-16,414,293,342
48407,407,48,2017,28233,528,-17,511,299,324
48407,407,48,2018,28724,540,-17,523,292,324
48407,407,48,2019,28867,169,-17,152,287,297
48407,407,48,2020,29301,520,-12,508,277,346
48409,409,48,2010,64424,-426,14,-412,212,198
48409,409,48,2011,64455,-306,28,-278,900,591
48409,409,48,2012,65261,458,37,495,924,614
48409,409,48,2013,66132,476,47,523,973,626
48409,409,48,2014,66654,116,70,186,985,635
48409,409,48,2015,67121,-76,76,0,1047,574
48409,409,48,2016,67325,-271,85,-186,1030,639
48409,409,48,2017,67221,-502,61,-441,987,649
48409,409,48,2018,66576,-991,46,-945,944,648
48409,409,48,2019,66656,-328,55,-273,931,578
48409,409,48,2020,67069,41,48,89,917,598
48411,411,48,2010,6134,17,1,18,11,27
48411,411,48,2011,6046,-84,1,-83,60,65
48411,411,48,2012,5990,-72,4,-68,81,69
48411,411,48,2013,5959,-22,7,-15,64,78
48411,411,48,2014,5860,-122,9,-113,67,56
48411,411,48,2015,5925,47,11,58,64,57
48411,411,48,2016,5920,-11,10,-1,62,67
48411,411,48,2017,5994,95,7,102,56,84
48411,411,48,2018,6056,56,4,60,67,65
48411,411,48,2019,6009,-45,3,-42,70,75
48411,411,48,2020,6039,37,5,42,70,82
48413,413,48,2010,3503,34,-1,33,8,2
48413,413,48,2011,3309,-215,1,-214,41,21
48413,413,48,2012,3257,-56,-4,-60,31,25
48413,413,48,2013,3188,-79,-4,-83,43,29
48413,413,48,2014,3160,-41,-1,-42,45,32
48413,413,48,2015,3191,30,0,30,24,23
48413,413,48,2016,3056,-139,1,-138,29,26
48413,413,48,2017,2988,-72,1,-71,24,22
48413,413,48,2018,2883,-95,1,-94,23,33
48413,413,48,2019,2801,-79,1,-78,25,29
48413,413,48,2020,2761,-46,1,-45,24,19
48415,415,48,2010,16929,6,-1,5,60,53
48415,415,48,2011,16861,-173,0,-173,272,167
48415,415,48,2012,17120,194,3,197,250,192
48415,415,48,2013,17258,39,6,45,251,158
48415,415,48,2014,17367,19,8,27,269,187
48415,415,48,2015,17565,119,21,140,226,165
48415,415,48,2016,17417,-271,28,-243,266,173
48415,415,48,2017,17020,-491,21,-470,224,155
48415,415,48,2018,16838,-235,16,-219,213,176
48415,415,48,2019,16655,-211,12,-199,200,184
48415,415,48,2020,16662,-19,15,-4,199,188
48417,417,48,2010,3384,-2,0,-2,11,2
48417,417,48,2011,3335,-46,2,-44,25,30
48417,417,48,2012,3361,19,3,22,33,28
48417,417,48,2013,3374,-2,3,1,41,29
48417,417,48,2014,3314,-34,0,-34,22,47
48417,417,48,2015,3331,7,0,7,37,29
48417,417,48,2016,3337,-3,0,-3,39,30
48417,417,48,2017,3289,-44,0,-44,27,32
48417,417,48,2018,3258,-39,0,-39,38,31
48417,417,48,2019,3272,15,0,15,30,30
48417,417,48,2020,3300,34,0,34,34,40
48419,419,48,2010,25460,-25,4,-21,89,55
48419,419,48,2011,25736,187,22,209,354,287
48419,419,48,2012,26062,223,33,256,334,267
48419,419,48,2013,25977,-243,46,-197,380,270
48419,419,48,2014,25604,-451,8,-443,384,322
48419,419,48,2015,25366,-278,-7,-285,355,308
48419,419,48,2016,25583,77,1,78,412,272
48419,419,48,2017,25218,-417,-7,-424,362,305
48419,419,48,2018,25300,58,-6,52,337,306
48419,419,48,2019,25297,-52,-15,-67,340,276
48419,419,48,2020,24915,-378,-2,-380,340,340
48421,421,48,2010,3025,-7,0,-7,5,8
48421,421,48,2011,3013,-25,3,-22,35,26
48421,421,48,2012,3037,2,5,7,48,32
48421,421,48,2013,3067,15,5,20,35,24
48421,421,48,2014,3061,-7,2,-5,40,42
48421,421,48,2015,3053,-25,7,-18,41,31
48421,421,48,2016,3053,-8,6,-2,28,26
48421,421,48,2017,3038,-41,6,-35,43,24
48421,421,48,2018,3094,34,5,39,43,25
48421,421,48,2019,3017,-108,6,-102,42,17
48421,421,48,2020,3027,-23,5,-18,42,13
48423,423,48,2010,210407,365,24,389,724,437
48423,423,48,2011,212770,1030,295,1325,2985,1943
48423,423,48,2012,214824,809,240,1049,2973,1951
48423,423,48,2013,216498,356,303,659,3007,1967
48423,423,48,2014,219678,1645,364,2009,3187,2038
48423,423,48,2015,222450,1405,306,1711,3120,2050
48423,423,48,2016,225181,1476,200,1676,3138,2079
48423,423,48,2017,227159,819,158,977,3114,2103
48423,423,48,2018,229860,1766,103,1869,3010,2176
48423,423,48,2019,232916,2251,92,2343,2899,2185
48423,423,48,2020,235806,2207,76,2283,2921,2312
48425,425,48,2010,8501,7,5,12,19,21
48425,425,48,2011,8428,-83,8,-75,78,75
48425,425,48,2012,8555,107,3,110,96,80
48425,425,48,2013,8567,11,-3,8,85,81
48425,425,48,2014,8559,6,-2,4,84,94
48425,425,48,2015,8619,65,-1,64,82,86
48425,425,48,2016,8663,60,-3,57,75,88
48425,425,48,2017,8850,177,-3,174,95,83
48425,425,48,2018,9017,195,-3,192,73,98
48425,425,48,2019,9123,113,-3,110,101,105
48425,425,48,2020,9139,50,-2,48,90,124
48427,427,48,2010,61140,-38,-20,-58,325,107
48427,427,48,2011,61640,-670,110,-560,1447,390
48427,427,48,2012,61951,-827,169,-658,1323,366
48427,427,48,2013,62347,-650,56,-594,1360,377
48427,427,48,2014,62901,-543,84,-459,1383,376
48427,427,48,2015,63406,-554,108,-446,1337,389
48427,427,48,2016,63697,-636,67,-569,1229,369
48427,427,48,2017,63887,-574,-53,-627,1289,475
48427,427,48,2018,64017,-597,-81,-678,1208,401
48427,427,48,2019,64294,-389,-52,-441,1119,404
48427,427,48,2020,64266,-740,-40,-780,1156,401
48429,429,48,2010,9620,-36,1,-35,33,14
48429,429,48,2011,9535,-45,6,-39,104,149
48429,429,48,2012,9608,71,4,75,99,104
48429,429,48,2013,9366,-216,-4,-220,100,126
48429,429,48,2014,9335,-31,-6,-37,109,103
48429,429,48,2015,9378,57,-4,53,93,105
48429,429,48,2016,9383,20,-2,18,113,125
48429,429,48,2017,9288,-81,-2,-83,94,106
48429,429,48,2018,9419,139,-1,138,108,116
48429,429,48,2019,9364,-56,-1,-57,96,93
48429,429,48,2020,9334,-37,0,-37,105,98
48431,431,48,2010,1137,-4,0,-4,4,7
48431,431,48,2011,1170,32,2,34,12,13
48431,431,48,2012,1190,22,4,26,10,16
48431,431,48,2013,1228,35,1,36,14,11
48431,431,48,2014,1339,99,3,102,19,13
48431,431,48,2015,1330,-12,0,-12,12,9
48431,431,48,2016,1337,4,0,4,19,15
48431,431,48,2017,1285,-63,0,-63,19,10
48431,431,48,2018,1306,20,0,20,14,12
48431,431,48,2019,1295,1,0,1,14,27
48431,431,48,2020,1315,40,0,40,12,30
48433,433,48,2010,1496,11,0,11,0,8
48433,433,48,2011,1463,-24,1,-23,10,19
48433,433,48,2012,1452,4,1,5,11,28
48433,433,48,2013,1418,-29,2,-27,16,23
48433,433,48,2014,1388,-24,2,-22,18,26
48433,433,48,2015,1400,16,0,16,18,23
48433,433,48,2016,1404,5,0,5,20,21
48433,433,48,2017,1374,-22,0,-22,12,20
48433,433,48,2018,1345,-21,0,-21,13,22
48433,433,48,2019,1336,-5,0,-5,11,14
48433,433,48,2020,1348,14,0,14,13,15
48435,435,48,2010,4061,-62,0,-62,8,18
48435,435,48,2011,3986,-99,0,-99,56,32
48435,435,48,2012,3916,-88,2,-86,45,32
48435,435,48,2013,3985,37,6,43,65,39
48435,435,48,2014,3972,-53,15,-38,54,29
48435,435,48,2015,3918,-83,16,-67,43,33
48435,435,48,2016,3902,-75,23,-52,70,34
48435,435,48,2017,3796,-138,15,-123,47,32
48435,435,48,2018,3749,-76,12,-64,49,32
48435,435,48,2019,3779,-1,12,11,44,24
48435,435,48,2020,3738,-66,12,-54,49,35
48437,437,48,2010,7919,38,1,39,26,6
48437,437,48,2011,7805,-144,1,-143,111,84
48437,437,48,2012,7849,-1,4,3,122,79
48437,437,48,2013,7724,-155,4,-151,107,84
48437,437,48,2014,7553,-209,3,-206,104,75
48437,437,48,2015,7477,-76,-1,-77,92,90
48437,437,48,2016,7437,-68,-5,-73,112,80
48437,437,48,2017,7440,39,-7,32,70,98
48437,437,48,2018,7400,-22,-7,-29,79,89
48437,437,48,2019,7399,-1,-11,-12,83,72
48437,437,48,2020,7340,-81,-4,-85,83,58
48439,439,48,2010,1818167,1809,951,2760,6693,2611
48439,439,48,2011,1848598,9378,4709,14087,27474,11135
48439,439,48,2012,1882950,12099,5549,17648,27706,11085
48439,439,48,2013,1913541,9533,5324,14857,27477,11709
48439,439,48,2014,1946907,9393,7785,17178,28167,11859
48439,439,48,2015,1985664,13985,8573,22558,28570,12363
48439,439,48,2016,2023942,14236,7770,22006,28543,12277
48439,439,48,2017,2056197,9968,7053,17021,28387,13129
48439,439,48,2018,2080998,5307,5402,10709,27649,13550
48439,439,48,2019,2101282,2308,4597,6905,27096,13800
48439,439,48,2020,2123347,5987,3826,9813,27220,15107
48441,441,48,2010,131842,91,85,176,485,329
48441,441,48,2011,132867,-43,187,144,2017,1130
48441,441,48,2012,134122,-9,514,505,2046,1274
48441,441,48,2013,133972,-1283,356,-927,2065,1309
48441,441,48,2014,135049,-159,418,259,2063,1224
48441,441,48,2015,136210,-86,493,407,2103,1332
48441,441,48,2016,136330,-974,329,-645,2116,1347
48441,441,48,2017,136615,-673,261,-412,2034,1332
48441,441,48,2018,137319,-55,141,86,2045,1423
48441,441,48,2019,138141,16,171,187,2060,1427
48441,441,48,2020,139200,359,146,505,2029,1485
48443,443,48,2010,1007,18,1,19,5,0
48443,443,48,2011,945,-58,1,-57,13,17
48443,443,48,2012,917,-36,2,-34,13,9
48443,443,48,2013,887,-25,2,-23,8,15
48443,443,48,2014,906,11,5,16,11,7
48443,443,48,2015,863,-43,1,-42,13,16
48443,443,48,2016,815,-47,1,-46,10,12
48443,443,48,2017,810,-8,1,-7,11,8
48443,443,48,2018,792,-12,1,-11,6,13
48443,443,48,2019,752,-38,1,-37,5,8
48443,443,48,2020,702,-43,1,-42,4,10
48445,445,48,2010,12681,-4,6,2,43,14
48445,445,48,2011,12657,-97,23,-74,190,141
48445,445,48,2012,12630,-114,17,-97,201,135
48445,445,48,2013,12716,-4,19,15,181,109
48445,445,48,2014,12796,-25,13,-12,220,125
48445,445,48,2015,12761,-115,10,-105,197,128
48445,445,48,2016,12767,-35,-1,-36,184,141
48445,445,48,2017,12427,-411,-5,-416,201,129
48445,445,48,2018,12311,-145,-8,-153,178,140
48445,445,48,2019,12354,-24,-4,-28,175,104
48445,445,48,2020,12183,-217,-3,-220,178,130
48447,447,48,2010,1639,-6,0,-6,5,0
48447,447,48,2011,1637,3,3,6,14,22
48447,447,48,2012,1610,-21,2,-19,14,23
48447,447,48,2013,1605,-7,0,-7,19,19
48447,447,48,2014,1612,13,0,13,15,20
48447,447,48,2015,1558,-40,0,-40,8,22
48447,447,48,2016,1542,-11,0,-11,19,26
48447,447,48,2017,1510,-23,0,-23,15,24
48447,447,48,2018,1485,-14,0,-14,9,19
48447,447,48,2019,1473,-12,0,-12,16,17
48447,447,48,2020,1487,22,0,22,14,22
48449,449,48,2010,32417,21,6,27,120,62
48449,449,48,2011,32447,-229,22,-207,494,258
48449,449,48,2012,32605,-130,41,-89,521,269
48449,449,48,2013,32575,-279,28,-251,481,263
48449,449,48,2014,32484,-393,51,-342,502,260
48449,449,48,2015,32605,-143,38,-105,534,307
48449,449,48,2016,32455,-430,71,-359,491,282
48449,449,48,2017,32652,-88,54,-34,521,289
48449,449,48,2018,32767,-124,80,-44,461,301
48449,449,48,2019,32744,-198,-23,-221,455,259
48449,449,48,2020,32926,9,12,21,432,272
48451,451,48,2010,110675,194,56,250,396,200
48451,451,48,2011,111761,476,83,559,1514,986
48451,451,48,2012,113324,761,259,1020,1531,1004
48451,451,48,2013,114708,718,105,823,1530,973
48451,451,48,2014,116366,1083,61,1144,1574,1081
48451,451,48,2015,117574,421,105,526,1729,1040
48451,451,48,2016,117742,-547,100,-447,1614,995
48451,451,48,2017,117745,-496,34,-462,1566,1097
48451,451,48,2018,118299,200,-30,170,1496,1106
48451,451,48,2019,119429,704,10,714,1499,1086
48451,451,48,2020,120010,190,15,205,1465,1097
48453,453,48,2010,1030392,2184,952,3136,3862,1116
48453,453,48,2011,1061662,15791,4352,20143,15639,4667
48453,453,48,2012,1096918,18560,5004,23564,15576,4719
48453,453,48,2013,1122346,9472,4974,14446,15839,5133
48453,453,48,2014,1152411,12153,6413,18566,15986,4942
48453,453,48,2015,1180003,9169,7200,16369,16389,5334
48453,453,48,2016,1206283,8606,6623,15229,16301,5340
48453,453,48,2017,1227373,5091,6016,11107,15525,5607
48453,453,48,2018,1246693,5344,4363,9707,15258,5712
48453,453,48,2019,1273567,13709,4331,18040,15093,6348
48453,453,48,2020,1300503,14914,3430,18344,15463,6880
48455,455,48,2010,14728,39,0,39,42,29
48455,455,48,2011,14687,11,-3,8,180,230
48455,455,48,2012,14375,-208,-2,-210,109,214
48455,455,48,2013,14450,195,-3,192,113,233
48455,455,48,2014,14303,-103,11,-92,156,208
48455,455,48,2015,14541,295,11,306,149,219
48455,455,48,2016,14535,102,11,113,136,256
48455,455,48,2017,14680,229,11,240,153,247
48455,455,48,2018,14672,108,8,116,143,267
48455,455,48,2019,14675,75,8,83,137,215
48455,455,48,2020,14883,289,4,293,138,221
48457,457,48,2010,21763,-3,2,-1,53,46
48457,457,48,2011,21676,-51,1,-50,216,253
48457,457,48,2012,21504,-120,5,-115,214,269
48457,457,48,2013,21509,38,9,47,244,282
48457,457,48,2014,21469,27,10,37,212,286
48457,457,48,2015,21372,-40,3,-37,210,267
48457,457,48,2016,21416,108,-3,105,209,269
48457,457,48,2017,21498,146,-3,143,198,258
48457,457,48,2018,21593,208,-4,204,187,295
48457,457,48,2019,21523,29,-4,25,187,280
48457,457,48,2020,21591,164,-2,162,183,277
48459,459,48,2010,39372,24,9,33,113,76
48459,459,48,2011,39728,260,41,301,514,458
48459,459,48,2012,39921,127,52,179,469,446
48459,459,48,2013,39769,-266,27,-239,485,400
48459,459,48,2014,40303,475,22,497,475,443
48459,459,48,2015,40343,42,9,51,474,479
48459,459,48,2016,40807,437,7,444,469,449
48459,459,48,2017,41103,341,0,341,470,512
48459,459,48,2018,41150,80,-4,76,469,496
48459,459,48,2019,41705,564,-6,558,434,435
48459,459,48,2020,42166,493,0,493,438,467
48461,461,48,2010,3340,-6,0,-6,9,14
48461,461,48,2011,3284,-61,5,-56,39,38
48461,461,48,2012,3265,-37,3,-34,55,42
48461,461,48,2013,3389,88,10,98,56,31
48461,461,48,2014,3486,63,11,74,54,33
48461,461,48,2015,3658,144,9,153,49,33
48461,461,48,2016,3698,-6,6,0,67,27
48461,461,48,2017,3657,-90,5,-85,70,27
48461,461,48,2018,3632,-25,5,-20,33,38
48461,461,48,2019,3644,-12,6,-6,44,26
48461,461,48,2020,3623,-41,5,-36,38,22
48463,463,48,2010,26441,9,9,18,96,74
48463,463,48,2011,26587,-106,59,-47,412,218
48463,463,48,2012,26744,-28,41,13,382,234
48463,463,48,2013,26905,12,2,14,428,276
48463,463,48,2014,27017,-2,-8,-10,385,255
48463,463,48,2015,26948,-288,18,-270,439,238
48463,463,48,2016,27082,-39,36,-3,391,253
48463,463,48,2017,27073,-192,34,-158,384,235
48463,463,48,2018,26805,-437,44,-393,388,264
48463,463,48,2019,26794,-148,-5,-153,399,257
48463,463,48,2020,26742,-160,4,-156,383,277
48465,465,48,2010,48963,-18,21,3,207,122
48465,465,48,2011,48962,-581,28,-553,882,330
48465,465,48,2012,48968,-733,170,-563,874,325
48465,465,48,2013,49027,-562,92,-470,893,371
48465,465,48,2014,48821,-884,118,-766,851,312
48465,465,48,2015,48860,-635,108,-527,924,360
48465,465,48,2016,48901,-635,135,-500,871,330
48465,465,48,2017,49071,-370,44,-326,860,364
48465,465,48,2018,49048,-329,6,-323,745,445
48465,465,48,2019,49041,-421,15,-406,743,346
48465,465,48,2020,49028,-381,15,-366,752,396
48467,467,48,2010,52576,69,5,74,122,164
48467,467,48,2011,52490,3,11,14,563,660
48467,467,48,2012,52211,-232,25,-207,529,604
48467,467,48,2013,52328,164,36,200,610,685
48467,467,48,2014,52782,417,65,482,563,585
48467,467,48,2015,53431,654,78,732,564,652
48467,467,48,2016,54407,866,67,933,672,628
48467,467,48,2017,55141,754,53,807,613,686
48467,467,48,2018,56025,857,37,894,637,645
48467,467,48,2019,56744,720,48,768,640,686
48467,467,48,2020,57533,831,38,869,650,726
48469,469,48,2010,86883,-104,23,-81,313,139
48469,469,48,2011,87560,62,80,142,1254,715
48469,469,48,2012,89124,989,70,1059,1294,811
48469,469,48,2013,90075,389,39,428,1298,780
48469,469,48,2014,91037,342,92,434,1302,772
48469,469,48,2015,92130,476,73,549,1352,804
48469,469,48,2016,92423,-303,68,-235,1356,824
48469,469,48,2017,92011,-865,43,-822,1243,837
48469,469,48,2018,91829,-553,19,-534,1162,810
48469,469,48,2019,92021,-217,24,-193,1211,827
48469,469,48,2020,91936,-370,16,-354,1185,918
48471,471,48,2010,68239,263,19,282,147,68
48471,471,48,2011,68405,-74,118,44,611,491
48471,471,48,2012,68602,23,109,132,566,491
48471,471,48,2013,69402,534,115,649,633,496
48471,471,48,2014,70064,306,213,519,648,503
48471,471,48,2015,70825,380,221,601,657,494
48471,471,48,2016,71811,697,193,890,638,549
48471,471,48,2017,72764,659,179,838,643,535
48471,471,48,2018,73037,78,136,214,618,557
48471,471,48,2019,71700,-1459,135,-1324,584,604
48471,471,48,2020,72164,467,101,568,578,687
48473,473,48,2010,43558,111,12,123,145,34
48473,473,48,2011,44138,284,18,302,565,288
48473,473,48,2012,44365,-71,4,-67,566,262
48473,473,48,2013,45436,760,9,769,578,296
48473,473,48,2014,46793,975,46,1021,604,294
48473,473,48,2015,48663,1407,87,1494,680,322
48473,473,48,2016,50062,1028,78,1106,611,324
48473,473,48,2017,51736,1276,55,1331,632,300
48473,473,48,2018,53568,1479,39,1518,664,358
48473,473,48,2019,55311,1382,33,1415,663,332
48473,473,48,2020,57452,1830,26,1856,683,386
48475,475,48,2010,10595,-60,0,-60,29,35
48475,475,48,2011,10671,43,0,43,133,98
48475,475,48,2012,10825,99,0,99,178,126
48475,475,48,2013,11206,285,9,294,198,117
48475,475,48,2014,11571,262,11,273,183,101
48475,475,48,2015,11630,-9,10,1,187,127
48475,475,48,2016,11573,-134,8,-126,191,121
48475,475,48,2017,11377,-233,4,-229,160,128
48475,475,48,2018,11691,219,3,222,202,110
48475,475,48,2019,11985,173,5,178,194,77
48475,475,48,2020,12097,-28,7,-21,216,82
48477,477,48,2010,33695,13,8,21,102,110
48477,477,48,2011,33952,146,48,194,436,373
48477,477,48,2012,33916,-114,80,-34,379,381
48477,477,48,2013,34187,194,42,236,407,374
48477,477,48,2014,34384,135,29,164,407,366
48477,477,48,2015,34820,382,29,411,421,398
48477,477,48,2016,34688,-156,8,-148,399,381
48477,477,48,2017,34804,89,-7,82,393,356
48477,477,48,2018,35485,689,-11,678,387,387
48477,477,48,2019,35626,166,-9,157,362,377
48477,477,48,2020,35771,222,-5,217,363,435
48479,479,48,2010,251358,-76,128,52,1328,311
48479,479,48,2011,255877,-702,901,199,5496,1169
48479,479,48,2012,260487,-426,892,466,5438,1257
48479,479,48,2013,264280,-1097,635,-462,5499,1239
48479,479,48,2014,267258,-2033,770,-1263,5502,1276
48479,479,48,2015,269598,-2660,916,-1744,5420,1350
48479,479,48,2016,272053,-2668,1134,-1534,5310,1327
48479,479,48,2017,273378,-2913,558,-2355,5083,1413
48479,479,48,2018,274734,-2380,354,-2026,4753,1379
48479,479,48,2019,276387,-2128,527,-1601,4659,1412
48479,479,48,2020,277681,-2299,433,-1866,4638,1482
48481,481,48,2010,41280,10,4,14,131,139
48481,481,48,2011,41286,-178,27,-151,549,393
48481,481,48,2012,41130,-299,7,-292,533,402
48481,481,48,2013,41115,-106,-5,-111,555,455
48481,481,48,2014,41082,-200,8,-192,559,397
48481,481,48,2015,41369,172,3,175,551,433
48481,481,48,2016,41619,48,34,82,583,411
48481,481,48,2017,41869,104,2,106,588,441
48481,481,48,2018,41515,-443,-7,-450,547,451
48481,481,48,2019,41671,-57,10,-47,605,401
48481,481,48,2020,41685,-160,5,-155,598,430
48483,483,48,2010,5387,-9,2,-7,11,22
48483,483,48,2011,5447,35,9,44,70,54
48483,483,48,2012,5593,135,4,139,68,66
48483,483,48,2013,5720,113,3,116,76,69
48483,483,48,2014,5701,-48,5,-43,97,74
48483,483,48,2015,5665,-41,5,-36,84,85
48483,483,48,2016,5526,-164,0,-164,83,59
48483,483,48,2017,5301,-222,-1,-223,75,78
48483,483,48,2018,5136,-155,-1,-156,54,62
48483,483,48,2019,5026,-93,-1,-94,43,59
48483,483,48,2020,4946,-58,-1,-59,42,63
48485,485,48,2010,131802,-181,140,-41,459,267
48485,485,48,2011,130825,-1721,270,-1451,1795,1331
48485,485,48,2012,131742,-301,753,452,1784,1297
48485,485,48,2013,132255,-347,420,73,1788,1329
48485,485,48,2014,132721,-438,449,11,1804,1331
48485,485,48,2015,131050,-2602,482,-2120,1762,1342
48485,485,48,2016,131386,-352,328,-24,1666,1299
48485,485,48,2017,131807,-4,238,234,1654,1460
48485,485,48,2018,132046,-38,115,77,1628,1462
48485,485,48,2019,132328,-103,173,70,1579,1370
48485,485,48,2020,133205,601,138,739,1570,1440
48487,487,48,2010,13509,-38,4,-34,46,39
48487,487,48,2011,13455,-93,20,-73,165,146
48487,487,48,2012,13294,-225,15,-210,189,147
48487,487,48,2013,13208,-84,12,-72,161,174
48487,487,48,2014,12991,-221,14,-207,149,165
48487,487,48,2015,13059,48,7,55,176,162
48487,487,48,2016,12893,-203,9,-194,172,146
48487,487,48,2017,12693,-174,3,-171,147,176
48487,487,48,2018,12753,58,0,58,159,157
48487,487,48,2019,12695,-77,0,-77,162,142
48487,487,48,2020,12552,-157,3,-154,164,153
48489,489,48,2010,22226,17,4,21,87,18
48489,489,48,2011,22168,-256,8,-248,343,154
48489,489,48,2012,22202,-135,16,-119,312,159
48489,489,48,2013,22016,-346,-4,-350,308,150
48489,489,48,2014,21926,-225,17,-208,291,177
48489,489,48,2015,21852,-227,17,-210,316,180
48489,489,48,2016,21749,-260,15,-245,293,152
48489,489,48,2017,21489,-328,4,-324,276,212
48489,489,48,2018,21414,-147,-10,-157,258,176
48489,489,48,2019,21280,-206,-2,-208,243,171
48489,489,48,2020,21161,-162,4,-158,242,202
48491,491,48,2010,426568,2340,160,2500,1496,403
48491,491,48,2011,442366,10823,738,11561,6130,1971
48491,491,48,2012,456144,8660,943,9603,5988,2069
48491,491,48,2013,470494,9252,984,10236,6053,2129
48491,491,48,2014,488446,12251,1315,13566,6325,2298
48491,491,48,2015,507728,13538,1610,15148,6439,2504
48491,491,48,2016,528207,15171,1361,16532,6515,2650
48491,491,48,2017,546837,13518,1330,14848,6446,2731
48491,491,48,2018,567465,15996,932,16928,6601,2962
48491,491,48,2019,591823,19974,827,20801,6741,3153
48491,491,48,2020,617855,21763,697,22460,6979,3288
48493,493,48,2010,43054,146,1,147,104,112
48493,493,48,2011,43669,506,6,512,446,345
48493,493,48,2012,44356,471,4,475,512,305
48493,493,48,2013,45224,724,14,738,464,350
48493,493,48,2014,46147,727,24,751,522,361
48493,493,48,2015,47181,864,36,900,557,432
48493,493,48,2016,48202,811,44,855,532,368
48493,493,48,2017,49226,855,32,887,520,383
48493,493,48,2018,50150,802,19,821,548,444
48493,493,48,2019,50950,666,23,689,530,418
48493,493,48,2020,52023,997,23,1020,514,456
48495,495,48,2010,7081,-38,2,-36,22,14
48495,495,48,2011,7160,19,10,29,116,65
48495,495,48,2012,7366,159,6,165,110,73
48495,495,48,2013,7631,194,2,196,129,64
48495,495,48,2014,7818,106,10,116,136,69
48495,495,48,2015,8028,110,35,145,130,65
48495,495,48,2016,7917,-209,34,-175,126,64
48495,495,48,2017,7595,-380,21,-359,111,75
48495,495,48,2018,7743,77,17,94,121,68
48495,495,48,2019,7970,121,27,148,130,51
48495,495,48,2020,7887,-181,13,-168,133,49
48497,497,48,2010,59083,-67,1,-66,195,130
48497,497,48,2011,59938,500,20,520,782,447
48497,497,48,2012,60395,245,19,264,724,518
48497,497,48,2013,60991,303,23,326,776,501
48497,497,48,2014,61668,389,25,414,774,507
48497,497,48,2015,62813,837,37,874,819,551
48497,497,48,2016,64428,1377,43,1420,792,602
48497,497,48,2017,65781,1247,23,1270,726,644
48497,497,48,2018,68251,2272,24,2296,775,608
48497,497,48,2019,69877,1482,9,1491,800,661
48497,497,48,2020,71084,1091,16,1107,794,693
48499,499,48,2010,41989,85,3,88,89,160
48499,499,48,2011,42109,257,0,257,427,562
48499,499,48,2012,42402,482,0,482,396,600
48499,499,48,2013,42366,203,-8,195,405,635
48499,499,48,2014,42791,601,1,602,418,607
48499,499,48,2015,43142,542,10,552,424,628
48499,499,48,2016,43790,832,20,852,407,612
48499,499,48,2017,44325,742,17,759,401,629
48499,499,48,2018,45242,1163,11,1174,399,660
48499,499,48,2019,45621,592,14,606,402,627
48499,499,48,2020,46291,1009,11,1020,392,734
48501,501,48,2010,7852,-45,-2,-47,39,22
48501,501,48,2011,7971,38,14,52,123,55
48501,501,48,2012,8052,-11,29,18,133,71
48501,501,48,2013,8218,24,45,69,155,57
48501,501,48,2014,8392,11,61,72,165,62
48501,501,48,2015,8635,65,71,136,174,67
48501,501,48,2016,8626,-183,72,-111,163,62
48501,501,48,2017,8527,-239,49,-190,146,56
48501,501,48,2018,8520,-126,37,-89,146,65
48501,501,48,2019,8686,-25,50,25,187,47
48501,501,48,2020,8702,-151,38,-113,180,49
48503,503,48,2010,18523,3,2,5,62,92
48503,503,48,2011,18354,-144,-1,-145,215,239
48503,503,48,2012,18273,-56,-3,-59,242,261
48503,503,48,2013,18353,72,2,74,241,235
48503,503,48,2014,18267,-35,18,-17,211,279
48503,503,48,2015,18154,-101,19,-82,236,266
48503,503,48,2016,18095,-49,21,-28,220,252
48503,503,48,2017,17916,-96,12,-84,194,288
48503,503,48,2018,17953,58,7,65,216,243
48503,503,48,2019,17937,28,10,38,179,233
48503,503,48,2020,17904,24,8,32,181,246
48505,505,48,2010,14086,-13,0,-13,92,11
48505,505,48,2011,14223,-79,-20,-99,316,80
48505,505,48,2012,14267,-158,9,-149,275,84
48505,505,48,2013,14375,-87,-6,-93,290,90
48505,505,48,2014,14359,-214,-6,-220,290,90
48505,505,48,2015,14474,-119,16,-103,301,83
48505,505,48,2016,14420,-244,29,-215,254,92
48505,505,48,2017,14251,-307,3,-304,242,108
48505,505,48,2018,14151,-228,-7,-235,228,92
48505,505,48,2019,14221,-35,5,-30,204,106
48505,505,48,2020,14172,-145,12,-133,200,115
48507,507,48,2010,11728,12,12,24,36,9
48507,507,48,2011,11872,-11,23,12,205,73
48507,507,48,2012,12015,3,35,38,201,94
48507,507,48,2013,12203,40,26,66,211,88
48507,507,48,2014,12254,-97,37,-60,206,95
48507,507,48,2015,12322,-76,47,-29,207,109
48507,507,48,2016,12125,-311,41,-270,188,117
48507,507,48,2017,11946,-265,42,-223,154,110
48507,507,48,2018,11934,-123,63,-60,153,107
48507,507,48,2019,11807,-185,0,-185,167,106
48507,507,48,2020,11840,-64,19,-45,163,87
49001,001,49,2010,6657,-10,0,-10,44,7
49001,001,49,2011,6560,-170,4,-166,122,55
49001,001,49,2012,6500,-130,-1,-131,114,45
49001,001,49,2013,6454,-100,4,-96,111,62
49001,001,49,2014,6428,-78,12,-66,98,61
49001,001,49,2015,6351,-131,12,-119,110,69
49001,001,49,2016,6463,51,23,74,99,60
49001,001,49,2017,6402,-138,29,-109,111,63
49001,001,49,2018,6620,162,20,182,94,59
49001,001,49,2019,6725,26,15,41,112,47
49001,001,49,2020,6761,-22,7,-15,106,55
49003,003,49,2010,50178,27,8,35,229,66
49003,003,49,2011,50242,-524,13,-511,904,331
49003,003,49,2012,50205,-602,21,-581,850,321
49003,003,49,2013,50730,55,-9,46,859,374
49003,003,49,2014,51309,71,3,74,861,350
49003,003,49,2015,51839,31,6,37,901,403
49003,003,49,2016,52995,599,39,638,886,366
49003,003,49,2017,53999,542,56,598,805,397
49003,003,49,2018,54807,443,36,479,765,434
49003,003,49,2019,55957,649,16,665,871,385
49003,003,49,2020,57007,617,16,633,827,409
49005,005,49,2010,113388,97,79,176,638,86
49005,005,49,2011,114800,-787,196,-591,2503,501
49005,005,49,2012,115925,-1081,343,-738,2334,478
49005,005,49,2013,117070,-910,184,-726,2388,516
49005,005,49,2014,117956,-1256,278,-978,2351,507
49005,005,49,2015,119777,-176,179,3,2354,522
49005,005,49,2016,122347,469,344,813,2344,586
49005,005,49,2017,124448,-47,453,406,2238,538
49005,005,49,2018,126574,272,313,585,2148,606
49005,005,49,2019,128309,10,180,190,2097,558
49005,005,49,2020,130004,44,149,193,2093,601
49007,007,49,2010,21403,1,1,2,78,80
49007,007,49,2011,21308,-215,10,-205,336,225
49007,007,49,2012,21226,-232,6,-226,334,196
49007,007,49,2013,20908,-424,3,-421,335,243
49007,007,49,2014,20642,-336,25,-311,269,230
49007,007,49,2015,20400,-297,13,-284,267,226
49007,007,49,2016,20349,-96,16,-80,262,233
49007,007,49,2017,20171,-190,26,-164,208,224
49007,007,49,2018,20248,49,15,64,241,226
49007,007,49,2019,20476,170,5,175,246,192
49007,007,49,2020,20760,227,5,232,249,195
49009,009,49,2010,1077,5,0,5,10,0
49009,009,49,2011,1162,79,0,79,11,5
49009,009,49,2012,1096,-75,1,-74,9,5
49009,009,49,2013,1141,38,0,38,14,9
49009,009,49,2014,1125,-14,1,-13,9,12
49009,009,49,2015,1107,-20,1,-19,11,10
49009,009,49,2016,1075,-26,0,-26,8,15
49009,009,49,2017,1012,-54,0,-54,6,14
49009,009,49,2018,984,-25,0,-25,8,11
49009,009,49,2019,964,-25,0,-25,8,3
49009,009,49,2020,1026,62,0,62,6,7
49011,011,49,2010,307919,127,99,226,1571,345
49011,011,49,2011,311904,-484,199,-285,5706,1429
49011,011,49,2012,316022,-719,619,-100,5721,1489
49011,011,49,2013,322368,1852,279,2131,5825,1593
49011,011,49,2014,328891,2064,304,2368,5766,1603
49011,011,49,2015,334814,1608,175,1783,5888,1724
49011,011,49,2016,341255,2092,266,2358,5848,1754
49011,011,49,2017,346858,1633,309,1942,5502,1824
49011,011,49,2018,351154,701,146,847,5335,1879
49011,011,49,2019,355304,611,38,649,5303,1812
49011,011,49,2020,359232,498,37,535,5223,1859
49013,013,49,2010,18647,-60,0,-60,118,19
49013,013,49,2011,18700,-198,1,-197,389,140
49013,013,49,2012,18999,13,7,20,424,141
49013,013,49,2013,19959,633,11,644,449,149
49013,013,49,2014,20197,-88,11,-77,435,117
49013,013,49,2015,20743,243,6,249,442,145
49013,013,49,2016,20226,-753,5,-748,390,162
49013,013,49,2017,19852,-582,7,-575,342,144
49013,013,49,2018,19902,-160,5,-155,345,139
49013,013,49,2019,19877,-231,3,-228,354,151
49013,013,49,2020,19894,-177,2,-175,336,143
49015,015,49,2010,11004,-11,0,-11,53,13
49015,015,49,2011,10986,-118,0,-118,179,80
49015,015,49,2012,10941,-143,0,-143,177,83
49015,015,49,2013,10761,-252,0,-252,154,89
49015,015,49,2014,10641,-153,1,-152,134,107
49015,015,49,2015,10360,-343,1,-342,137,79
49015,015,49,2016,10221,-195,7,-188,140,90
49015,015,49,2017,10027,-201,12,-189,107,114
49015,015,49,2018,10039,-12,4,-8,123,103
49015,015,49,2019,10061,3,2,5,111,94
49015,015,49,2020,10147,66,1,67,121,101
49017,017,49,2010,5196,14,1,15,21,12
49017,017,49,2011,5150,-57,6,-51,55,51
49017,017,49,2012,5064,-107,8,-99,66,56
49017,017,49,2013,5033,-59,7,-52,63,44
49017,017,49,2014,5009,-41,10,-31,62,56
49017,017,49,2015,4966,-64,3,-61,50,34
49017,017,49,2016,4956,-20,1,-19,55,44
49017,017,49,2017,5022,41,2,43,66,44
49017,017,49,2018,4970,-33,0,-33,53,71
49017,017,49,2019,5000,16,-1,15,52,36
49017,017,49,2020,5050,31,0,31,55,35
49019,019,49,2010,9301,55,5,60,34,9
49019,019,49,2011,9286,-75,1,-74,132,71
49019,019,49,2012,9343,23,3,26,122,91
49019,019,49,2013,9361,-26,8,-18,121,84
49019,019,49,2014,9464,28,18,46,131,73
49019,019,49,2015,9530,27,2,29,126,89
49019,019,49,2016,9616,27,14,41,123,79
49019,019,49,2017,9591,-53,16,-37,111,98
49019,019,49,2018,9715,97,7,104,110,90
49019,019,49,2019,9773,43,-1,42,84,68
49019,019,49,2020,9796,7,-1,6,97,80
49021,021,49,2010,46264,-71,13,-58,240,81
49021,021,49,2011,46632,-271,20,-251,879,261
49021,021,49,2012,46661,-535,19,-516,830,292
49021,021,49,2013,46560,-667,5,-662,838,290
49021,021,49,2014,47080,24,-9,15,827,314
49021,021,49,2015,48166,531,-21,510,861,287
49021,021,49,2016,49755,1073,31,1104,827,345
49021,021,49,2017,50944,590,55,645,860,319
49021,021,49,2018,52959,1538,26,1564,791,341
49021,021,49,2019,55269,1821,-12,1809,804,299
49021,021,49,2020,56814,1078,-9,1069,825,347
49023,023,49,2010,10263,-16,1,-15,47,16
49023,023,49,2011,10317,-61,0,-61,196,80
49023,023,49,2012,10300,-125,-1,-126,179,72
49023,023,49,2013,10269,-129,-1,-130,161,64
49023,023,49,2014,10418,41,-1,40,195,85
49023,023,49,2015,10560,36,8,44,170,72
49023,023,49,2016,11045,310,20,330,210,57
49023,023,49,2017,11308,125,23,148,183,66
49023,023,49,2018,11639,215,14,229,190,89
49023,023,49,2019,12002,242,3,245,188,68
49023,023,49,2020,12122,17,4,21,192,92
49025,025,49,2010,7214,88,0,88,16,26
49025,025,49,2011,7297,66,-2,64,79,60
49025,025,49,2012,7177,-142,-1,-143,90,70
49025,025,49,2013,7128,-46,-1,-47,74,78
49025,025,49,2014,7172,46,-3,43,85,88
49025,025,49,2015,7045,-120,-3,-123,80,84
49025,025,49,2016,7306,254,-4,250,87,76
49025,025,49,2017,7535,211,-3,208,85,66
49025,025,49,2018,7663,141,-4,137,71,80
49025,025,49,2019,7873,200,-4,196,80,63
49025,025,49,2020,7914,37,-2,35,86,80
49027,027,49,2010,12541,15,7,22,41,24
49027,027,49,2011,12571,-80,8,-72,193,90
49027,027,49,2012,12468,-206,8,-198,184,96
49027,027,49,2013,12556,-6,9,3,194,109
49027,027,49,2014,12540,-122,7,-115,199,105
49027,027,49,2015,12621,-33,6,-27,196,88
49027,027,49,2016,12641,-63,3,-60,198,118
49027,027,49,2017,12805,55,7,62,212,109
49027,027,49,2018,12941,56,0,56,183,102
49027,027,49,2019,13100,71,-5,66,179,85
49027,027,49,2020,13327,154,-1,153,180,104
49029,029,49,2010,9523,22,3,25,46,18
49029,029,49,2011,9655,23,6,29,154,50
49029,029,49,2012,9812,47,21,68,135,46
49029,029,49,2013,10215,268,7,275,189,64
49029,029,49,2014,10609,284,17,301,144,53
49029,029,49,2015,11048,302,8,310,176,49
49029,029,49,2016,11368,217,8,225,157,61
49029,029,49,2017,11836,366,7,373,156,61
49029,029,49,2018,11971,48,3,51,155,71
49029,029,49,2019,12115,69,1,70,138,62
49029,029,49,2020,12462,267,3,270,133,53
49031,031,49,2010,1563,3,0,3,2,0
49031,031,49,2011,1497,-62,0,-62,18,22
49031,031,49,2012,1495,6,0,6,10,17
49031,031,49,2013,1486,-9,0,-9,11,12
49031,031,49,2014,1465,-20,0,-20,19,18
49031,031,49,2015,1489,23,0,23,13,11
49031,031,49,2016,1457,-24,0,-24,12,19
49031,031,49,2017,1406,-45,0,-45,9,16
49031,031,49,2018,1434,39,0,39,15,25
49031,031,49,2019,1472,33,0,33,17,12
49031,031,49,2020,1473,-8,0,-8,20,10
49033,033,49,2010,2255,-9,0,-9,9,8
49033,033,49,2011,2295,22,0,22,37,19
49033,033,49,2012,2258,-76,2,-74,43,9
49033,033,49,2013,2263,-14,1,-13,26,8
49033,033,49,2014,2274,-7,2,-5,32,17
49033,033,49,2015,2301,9,4,13,34,20
49033,033,49,2016,2311,-13,2,-11,32,11
49033,033,49,2017,2388,65,2,67,31,20
49033,033,49,2018,2455,45,1,46,36,13
49033,033,49,2019,2468,-2,1,-1,28,15
49033,033,49,2020,2452,-35,1,-34,29,11
49035,035,49,2010,1032997,-419,573,154,4755,1413
49035,035,49,2011,1047702,520,1888,2408,18003,5680
49035,035,49,2012,1064140,1838,2997,4835,17708,6001
49035,035,49,2013,1079661,1284,2261,3545,18236,6181
49035,035,49,2014,1090340,-4166,3370,-796,17813,6153
49035,035,49,2015,1102690,-1070,2552,1482,17601,6595
49035,035,49,2016,1120751,2397,4703,7100,17624,6646
49035,035,49,2017,1137273,370,5641,6011,17218,6686
49035,035,49,2018,1148949,-1742,3880,2138,16232,6665
49035,035,49,2019,1158585,-1598,1845,247,16167,6804
49035,035,49,2020,1165517,-3394,1491,-1903,16105,7338
49037,037,49,2010,14837,30,1,31,58,8
49037,037,49,2011,14850,-130,9,-121,219,86
49037,037,49,2012,15052,44,13,57,243,96
49037,037,49,2013,15003,-252,8,-244,281,92
49037,037,49,2014,15074,-89,18,-71,240,97
49037,037,49,2015,15254,34,5,39,240,98
49037,037,49,2016,15346,-50,2,-48,249,108
49037,037,49,2017,15286,-139,2,-137,197,120
49037,037,49,2018,15336,-9,-1,-10,185,124
49037,037,49,2019,15228,-145,-3,-148,174,133
49037,037,49,2020,15278,6,-2,4,180,135
49039,039,49,2010,27938,36,5,41,105,30
49039,039,49,2011,28000,-184,12,-172,416,183
49039,039,49,2012,27958,-286,22,-264,392,177
49039,039,49,2013,28130,-15,20,5,383,212
49039,039,49,2014,28299,-65,20,-45,389,173
49039,039,49,2015,28663,165,12,177,372,183
49039,039,49,2016,29244,370,23,393,382,194
49039,039,49,2017,29953,474,45,519,392,203
49039,039,49,2018,30529,380,28,408,365,197
49039,039,49,2019,30986,251,14,265,382,189
49039,039,49,2020,31393,227,12,239,374,206
49041,041,49,2010,20799,-27,0,-27,89,64
49041,041,49,2011,20872,-69,0,-69,347,204
49041,041,49,2012,20662,-329,1,-328,282,172
49041,041,49,2013,20758,5,1,6,277,187
49041,041,49,2014,20746,-131,9,-122,309,198
49041,041,49,2015,20872,-3,7,4,326,202
49041,041,49,2016,21145,156,2,158,305,189
49041,041,49,2017,21299,41,4,45,314,203
49041,041,49,2018,21516,109,1,110,314,207
49041,041,49,2019,21636,44,0,44,273,195
49041,041,49,2020,21780,84,2,86,281,223
49043,043,49,2010,36502,89,17,106,112,46
49043,043,49,2011,37438,540,46,586,476,128
49043,043,49,2012,37886,106,34,140,431,116
49043,043,49,2013,38447,240,62,302,412,151
49043,043,49,2014,39144,312,125,437,411,147
49043,043,49,2015,39675,127,108,235,442,141
49043,043,49,2016,40564,441,191,632,424,168
49043,043,49,2017,41375,360,180,540,432,162
49043,043,49,2018,41879,103,117,220,414,128
49043,043,49,2019,42081,-110,52,-58,405,147
49043,043,49,2020,42499,155,46,201,392,175
49045,045,49,2010,58502,108,2,110,267,99
49045,045,49,2011,59198,7,0,7,1001,311
49045,045,49,2012,59810,-101,60,-41,985,320
49045,045,49,2013,60655,183,23,206,998,350
49045,045,49,2014,61473,112,52,164,982,319
49045,045,49,2015,62676,558,54,612,953,360
49045,045,49,2016,64643,1289,65,1354,974,365
49045,045,49,2017,67490,2159,96,2255,960,377
49045,045,49,2018,69946,1754,64,1818,1003,369
49045,045,49,2019,72110,1546,40,1586,962,381
49045,045,49,2020,74512,1785,29,1814,1004,402
49047,047,49,2010,32465,-272,2,-270,156,30
49047,047,49,2011,33246,376,-1,375,620,216
49047,047,49,2012,34648,899,17,916,662,203
49047,047,49,2013,35696,513,12,525,735,224
49047,047,49,2014,36934,637,39,676,753,203
49047,047,49,2015,37815,372,24,396,728,244
49047,047,49,2016,36261,-1974,19,-1955,636,244
49047,047,49,2017,35235,-1408,21,-1387,593,239
49047,047,49,2018,35407,-118,10,-108,529,250
49047,047,49,2019,35806,105,-1,104,554,260
49047,047,49,2020,35970,-118,-1,-119,543,260
49049,049,49,2010,520033,446,130,576,3251,451
49049,049,49,2011,530844,271,434,705,12122,1998
49049,049,49,2012,539970,-1080,835,-245,11548,2100
49049,049,49,2013,551689,1345,468,1813,12175,2199
49049,049,49,2014,561171,-861,805,-56,11815,2184
49049,049,49,2015,573289,1918,713,2631,11921,2397
49049,049,49,2016,591107,6887,1371,8258,12018,2492
49049,049,49,2017,607612,5459,1663,7122,11801,2448
49049,049,49,2018,622076,4348,1115,5463,11601,2625
49049,049,49,2019,635675,4070,429,4499,11668,2600
49049,049,49,2020,651059,5833,380,6213,11840,2695
49051,051,49,2010,23642,63,10,73,77,37
49051,051,49,2011,24404,482,32,514,371,124
49051,051,49,2012,25340,614,31,645,378,107
49051,051,49,2013,26578,830,79,909,412,103
49051,051,49,2014,27815,848,73,921,422,129
49051,051,49,2015,29131,934,24,958,470,126
49051,051,49,2016,30433,923,84,1007,440,148
49051,051,49,2017,32045,1147,125,1272,476,140
49051,051,49,2018,33278,840,93,933,431,133
49051,051,49,2019,34210,630,43,673,415,154
49051,051,49,2020,35300,805,32,837,416,160
49053,053,49,2010,138397,-25,15,-10,608,301
49053,053,49,2011,141288,1573,-16,1557,2389,1056
49053,053,49,2012,144216,1801,-10,1791,2165,1065
49053,053,49,2013,147099,1944,-50,1894,2151,1183
49053,053,49,2014,151231,3001,-21,2980,2243,1157
49053,053,49,2015,154839,2533,18,2551,2233,1203
49053,053,49,2016,159537,3700,144,3844,2145,1304
49053,053,49,2017,166195,5543,151,5694,2244,1309
49053,053,49,2018,172051,5112,68,5180,2132,1467
49053,053,49,2019,177938,5137,-18,5119,2223,1438
49053,053,49,2020,184913,6317,-12,6305,2213,1511
49055,055,49,2010,2772,-14,0,-14,10,2
49055,055,49,2011,2742,-47,3,-44,33,20
49055,055,49,2012,2704,-48,1,-47,34,26
49055,055,49,2013,2712,-1,4,3,26,22
49055,055,49,2014,2695,-23,8,-15,34,36
49055,055,49,2015,2689,-15,9,-6,27,27
49055,055,49,2016,2671,-24,7,-17,34,34
49055,055,49,2017,2699,17,7,24,26,21
49055,055,49,2018,2657,-53,4,-49,31,25
49055,055,49,2019,2703,37,0,37,26,16
49055,055,49,2020,2759,49,2,51,24,20
49057,057,49,2010,232136,193,47,240,1064,386
49057,057,49,2011,233851,-820,31,-789,4043,1535
49057,057,49,2012,236268,-157,216,59,3988,1580
49057,057,49,2013,238083,-689,150,-539,3962,1576
49057,057,49,2014,240185,-287,339,52,3797,1699
49057,057,49,2015,242916,433,222,655,3870,1775
49057,057,49,2016,247153,1839,283,2122,3936,1820
49057,057,49,2017,251474,2021,319,2340,3802,1831
49057,057,49,2018,255454,1891,147,2038,3681,1745
49057,057,49,2019,259680,2331,-26,2305,3655,1744
49057,057,49,2020,262658,1077,-2,1075,3661,1773
50001,001,50,2010,36813,-32,7,-25,89,57
50001,001,50,2011,36973,-29,177,148,324,311
50001,001,50,2012,36910,-71,40,-31,282,313
50001,001,50,2013,36949,-38,58,20,328,305
50001,001,50,2014,36950,-6,16,10,311,312
50001,001,50,2015,36955,-105,128,23,308,324
50001,001,50,2016,36973,-55,56,1,316,299
50001,001,50,2017,36947,-94,100,6,308,338
50001,001,50,2018,36970,9,24,33,306,316
50001,001,50,2019,36994,-19,59,40,294,309
50001,001,50,2020,36851,-129,47,-82,288,349
50003,003,50,2010,37078,-19,3,-16,100,122
50003,003,50,2011,36823,-159,26,-133,316,437
50003,003,50,2012,36634,-103,3,-100,328,417
50003,003,50,2013,36570,17,-3,14,349,421
50003,003,50,2014,36207,-269,6,-263,344,444
50003,003,50,2015,36198,-17,92,75,356,437
50003,003,50,2016,35977,-132,48,-84,337,472
50003,003,50,2017,35763,-159,102,-57,323,478
50003,003,50,2018,35635,-3,26,23,309,459
50003,003,50,2019,35532,44,28,72,306,480
50003,003,50,2020,35338,-55,32,-23,303,474
50005,005,50,2010,31163,-33,-1,-34,63,93
50005,005,50,2011,31115,-74,15,-59,305,295
50005,005,50,2012,31034,-54,-1,-55,282,307
50005,005,50,2013,31055,57,-1,56,278,306
50005,005,50,2014,30882,-181,0,-181,309,302
50005,005,50,2015,30658,-186,15,-171,272,326
50005,005,50,2016,30176,-438,-3,-441,277,320
50005,005,50,2017,30172,1,14,15,296,313
50005,005,50,2018,30221,91,0,91,265,308
50005,005,50,2019,29860,-305,0,-305,257,312
50005,005,50,2020,29705,-91,1,-90,256,321
50007,007,50,2010,156774,1,74,75,414,231
50007,007,50,2011,158083,-15,771,756,1524,968
50007,007,50,2012,158777,-50,229,179,1579,1026
50007,007,50,2013,159578,2,278,280,1580,1032
50007,007,50,2014,160134,-260,305,45,1615,1070
50007,007,50,2015,161535,-545,1539,994,1556,1136
50007,007,50,2016,161839,-694,505,-189,1590,1097
50007,007,50,2017,163254,-292,1306,1014,1521,1118
50007,007,50,2018,163755,-28,379,351,1332,1177
50007,007,50,2019,163918,-539,398,-141,1447,1149
50007,007,50,2020,164306,-97,325,228,1389,1242
50009,009,50,2010,6312,-3,0,-3,18,8
50009,009,50,2011,6322,1,1,2,61,54
50009,009,50,2012,6221,-94,0,-94,46,55
50009,009,50,2013,6192,-11,0,-11,44,62
50009,009,50,2014,6153,-41,2,-39,57,58
50009,009,50,2015,6193,45,2,47,55,61
50009,009,50,2016,6225,53,1,54,58,79
50009,009,50,2017,6184,-8,1,-7,46,80
50009,009,50,2018,6209,57,0,57,42,73
50009,009,50,2019,6145,-51,0,-51,52,64
50009,009,50,2020,6123,15,0,15,43,79
50011,011,50,2010,47821,-15,1,-14,146,65
50011,011,50,2011,48233,204,34,238,562,389
50011,011,50,2012,48324,-142,11,-131,603,372
50011,011,50,2013,48416,-100,29,-71,574,404
50011,011,50,2014,48775,123,24,147,602,378
50011,011,50,2015,49002,-15,97,82,601,451
50011,011,50,2016,48998,-175,15,-160,582,424
50011,011,50,2017,48994,-180,44,-136,565,431
50011,011,50,2018,49312,200,19,219,529,430
50011,011,50,2019,49384,-80,49,-31,552,449
50011,011,50,2020,49685,151,40,191,538,430
50013,013,50,2010,6948,-6,0,-6,13,28
50013,013,50,2011,6975,7,8,15,60,48
50013,013,50,2012,6973,4,1,5,58,64
50013,013,50,2013,6990,9,0,9,61,50
50013,013,50,2014,6969,-14,0,-14,55,61
50013,013,50,2015,6873,-99,0,-99,68,66
50013,013,50,2016,6921,58,0,58,55,65
50013,013,50,2017,6976,65,0,65,49,58
50013,013,50,2018,7100,124,0,124,63,64
50013,013,50,2019,7208,85,0,85,67,44
50013,013,50,2020,7169,-42,0,-42,64,60
50015,015,50,2010,24517,21,0,21,88,65
50015,015,50,2011,24717,104,34,138,263,201
50015,015,50,2012,24957,155,9,164,249,176
50015,015,50,2013,25127,45,37,82,271,180
50015,015,50,2014,25149,-24,1,-23,255,206
50015,015,50,2015,25265,3,29,32,274,187
50015,015,50,2016,25360,43,16,59,255,217
50015,015,50,2017,25427,-11,60,49,237,218
50015,015,50,2018,25330,-136,17,-119,232,209
50015,015,50,2019,25420,19,20,39,244,192
50015,015,50,2020,25341,-123,17,-106,235,207
50017,017,50,2010,28945,3,0,3,78,70
50017,017,50,2011,29020,19,10,29,289,242
50017,017,50,2012,28923,-139,4,-135,277,238
50017,017,50,2013,28858,-75,12,-63,254,251
50017,017,50,2014,28888,12,11,23,279,266
50017,017,50,2015,28900,-7,18,11,260,257
50017,017,50,2016,28910,15,7,22,246,256
50017,017,50,2017,28976,42,12,54,286,270
50017,017,50,2018,28827,-95,4,-91,248,305
50017,017,50,2019,28809,10,6,16,242,276
50017,017,50,2020,28837,84,4,88,245,305
50019,019,50,2010,27247,-9,2,-7,76,53
50019,019,50,2011,27198,-63,37,-26,264,284
50019,019,50,2012,27169,-21,8,-13,298,310
50019,019,50,2013,27141,30,6,36,258,317
50019,019,50,2014,27032,-73,2,-71,262,294
50019,019,50,2015,27043,53,31,84,279,348
50019,019,50,2016,26748,-210,9,-201,242,334
50019,019,50,2017,26822,110,32,142,262,329
50019,019,50,2018,26826,49,10,59,247,299
50019,019,50,2019,26934,157,10,167,254,313
50019,019,50,2020,26897,13,8,21,262,319
50021,021,50,2010,61585,-83,2,-81,139,130
50021,021,50,2011,61240,-244,23,-221,544,669
50021,021,50,2012,60816,-351,8,-343,565,645
50021,021,50,2013,60512,-152,7,-145,537,695
50021,021,50,2014,60071,-366,5,-361,591,671
50021,021,50,2015,59582,-360,34,-326,519,680
50021,021,50,2016,59145,-248,3,-245,503,694
50021,021,50,2017,59012,46,22,68,509,706
50021,021,50,2018,58590,-187,2,-185,499,734
50021,021,50,2019,58125,-222,1,-221,468,712
50021,021,50,2020,57764,-118,3,-115,453,701
50023,023,50,2010,59573,22,5,27,174,145
50023,023,50,2011,59608,-95,44,-51,613,525
50023,023,50,2012,59432,-305,14,-291,615,500
50023,023,50,2013,59253,-196,3,-193,542,525
50023,023,50,2014,59005,-236,2,-234,566,570
50023,023,50,2015,58707,-391,65,-326,577,550
50023,023,50,2016,58434,-286,12,-274,537,535
50023,023,50,2017,58330,-103,29,-74,527,555
50023,023,50,2018,58129,-179,0,-179,530,549
50023,023,50,2019,58458,361,0,361,501,534
50023,023,50,2020,58328,-48,4,-44,489,579
50025,025,50,2010,44506,-30,4,-26,116,92
50025,025,50,2011,44261,-276,51,-225,411,431
50025,025,50,2012,44029,-185,14,-171,407,470
50025,025,50,2013,43928,-91,5,-86,421,436
50025,025,50,2014,43708,-229,16,-213,413,417
50025,025,50,2015,43309,-379,78,-301,362,458
50025,025,50,2016,43251,-20,31,11,385,452
50025,025,50,2017,42955,-247,63,-184,369,480
50025,025,50,2018,42690,-157,17,-140,357,480
50025,025,50,2019,42227,-371,18,-353,329,439
50025,025,50,2020,42015,-90,17,-73,335,475
50027,027,50,2010,56604,-34,12,-22,139,167
50027,027,50,2011,56629,26,64,90,521,583
50027,027,50,2012,56162,-398,-3,-401,499,566
50027,027,50,2013,56034,-33,1,-32,488,576
50027,027,50,2014,55770,-157,0,-157,452,553
50027,027,50,2015,55590,-159,123,-36,491,631
50027,027,50,2016,55409,-127,58,-69,460,568
50027,027,50,2017,55320,-25,134,109,452,647
50027,027,50,2018,55208,-30,53,23,469,601
50027,027,50,2019,55032,-85,46,-39,435,569
50027,027,50,2020,54988,68,44,112,431,588
51001,001,51,2010,33150,41,5,46,89,145
51001,001,51,2011,33227,20,51,71,473,466
51001,001,51,2012,33276,-60,85,25,458,425
51001,001,51,2013,32982,-293,67,-226,344,412
51001,001,51,2014,32992,-20,64,44,381,409
51001,001,51,2015,32930,-55,63,8,403,467
51001,001,51,2016,32903,-76,81,5,389,418
51001,001,51,2017,32729,-238,86,-152,357,377
51001,001,51,2018,32603,-126,55,-71,398,451
51001,001,51,2019,32325,-232,59,-173,333,436
51001,001,51,2020,32238,0,52,52,339,478
51003,003,51,2010,99196,73,65,138,294,207
51003,003,51,2011,100231,393,236,629,1105,697
51003,003,51,2012,101504,611,348,959,1061,735
51003,003,51,2013,102329,240,302,542,1099,807
51003,003,51,2014,103811,691,407,1098,1158,770
51003,003,51,2015,105221,667,401,1068,1195,851
51003,003,51,2016,106662,577,492,1069,1168,794
51003,003,51,2017,108107,739,420,1159,1136,848
51003,003,51,2018,108832,291,177,468,1115,852
51003,003,51,2019,109843,491,330,821,1105,913
51003,003,51,2020,110652,428,255,683,1094,973
51005,005,51,2010,16203,-15,2,-13,30,76
51005,005,51,2011,16163,4,4,8,171,220
51005,005,51,2012,16035,-71,2,-69,151,211
51005,005,51,2013,15926,-29,2,-27,158,238
51005,005,51,2014,15613,-198,-2,-200,122,238
51005,005,51,2015,15432,-123,-3,-126,146,200
51005,005,51,2016,15393,32,1,33,126,196
51005,005,51,2017,15143,-128,-2,-130,121,242
51005,005,51,2018,15016,-66,-3,-69,149,206
51005,005,51,2019,14898,-8,-2,-10,115,222
51005,005,51,2020,14701,-61,-1,-62,118,252
51007,007,51,2010,12741,19,3,22,39,13
51007,007,51,2011,12747,-27,15,-12,147,128
51007,007,51,2012,12741,2,3,5,135,143
51007,007,51,2013,12655,-67,0,-67,138,157
51007,007,51,2014,12713,51,0,51,128,119
51007,007,51,2015,12784,67,3,70,139,135
51007,007,51,2016,12805,33,1,34,140,153
51007,007,51,2017,12974,183,1,184,132,149
51007,007,51,2018,12997,49,0,49,136,162
51007,007,51,2019,13058,86,1,87,138,163
51007,007,51,2020,13014,7,1,8,129,181
51009,009,51,2010,32389,7,1,8,86,53
51009,009,51,2011,32160,-210,2,-208,341,361
51009,009,51,2012,32640,481,4,485,332,351
51009,009,51,2013,32331,-275,14,-261,305,352
51009,009,51,2014,32174,-180,13,-167,311,301
51009,009,51,2015,31855,-345,12,-333,356,347
51009,009,51,2016,31903,18,13,31,332,312
51009,009,51,2017,31893,8,12,20,324,353
51009,009,51,2018,31771,-114,10,-104,348,365
51009,009,51,2019,31678,-28,12,-16,314,391
51009,009,51,2020,31667,87,10,97,314,423
51011,011,51,2010,15091,48,0,48,47,27
51011,011,51,2011,15104,36,0,36,148,170
51011,011,51,2012,15240,96,0,96,191,153
51011,011,51,2013,15315,37,-2,35,176,133
51011,011,51,2014,15343,40,4,44,173,188
51011,011,51,2015,15485,133,13,146,173,177
51011,011,51,2016,15535,35,14,49,187,185
51011,011,51,2017,15715,182,13,195,172,185
51011,011,51,2018,15874,135,7,142,200,184
51011,011,51,2019,15902,0,11,11,203,186
51011,011,51,2020,16043,128,8,136,200,194
51013,013,51,2010,209319,524,438,962,816,235
51013,013,51,2011,216078,3010,1652,4662,2989,936
51013,013,51,2012,221614,912,2329,3241,3129,897
51013,013,51,2013,225120,-439,1670,1231,3260,972
51013,013,51,2014,226274,-3552,2412,-1140,3141,904
51013,013,51,2015,228887,-2077,2506,429,3139,960
51013,013,51,2016,231805,-1936,2470,534,3274,894
51013,013,51,2017,235193,-989,2296,1307,3038,945
51013,013,51,2018,236662,-1891,1240,-651,3022,898
51013,013,51,2019,238392,-2004,1811,-193,2765,845
51013,013,51,2020,240119,-1357,1437,80,2732,1099
51015,015,51,2010,73593,-170,0,-170,157,159
51015,015,51,2011,73656,13,20,33,646,615
51015,015,51,2012,73599,-134,24,-110,705,648
51015,015,51,2013,73862,277,17,294,686,708
51015,015,51,2014,73908,93,24,117,693,746
51015,015,51,2015,74324,427,33,460,662,702
51015,015,51,2016,74875,497,55,552,688,686
51015,015,51,2017,75324,415,69,484,706,739
51015,015,51,2018,75906,518,40,558,717,688
51015,015,51,2019,76120,186,60,246,737,769
51015,015,51,2020,76544,644,46,690,613,875
51017,017,51,2010,4721,-5,0,-5,3,4
51017,017,51,2011,4655,-31,3,-28,36,73
51017,017,51,2012,4642,21,6,27,31,71
51017,017,51,2013,4591,-42,5,-37,46,59
51017,017,51,2014,4536,-16,3,-13,35,76
51017,017,51,2015,4463,-52,4,-48,48,74
51017,017,51,2016,4408,-38,9,-29,34,59
51017,017,51,2017,4270,-108,7,-101,32,70
51017,017,51,2018,4275,27,1,28,36,60
51017,017,51,2019,4169,-81,4,-77,39,69
51017,017,51,2020,4119,-39,5,-34,43,58
51019,019,51,2010,75032,99,7,106,206,204
51019,019,51,2011,75555,391,25,416,826,716
51019,019,51,2012,75755,168,22,190,736,708
51019,019,51,2013,76189,450,19,469,774,803
51019,019,51,2014,77054,794,47,841,693,678
51019,019,51,2015,77653,569,61,630,686,712
51019,019,51,2016,78024,428,59,487,696,808
51019,019,51,2017,78445,475,74,549,713,836
51019,019,51,2018,79115,771,39,810,742,878
51019,019,51,2019,79431,354,52,406,693,781
51019,019,51,2020,79811,549,50,599,677,892
51021,021,51,2010,6801,-6,0,-6,6,24
51021,021,51,2011,6776,21,-2,19,40,84
51021,021,51,2012,6693,-35,0,-35,47,94
51021,021,51,2013,6674,18,-1,17,60,95
51021,021,51,2014,6586,-55,-2,-57,43,74
51021,021,51,2015,6536,-5,-2,-7,46,89
51021,021,51,2016,6483,-23,0,-23,56,84
51021,021,51,2017,6361,-86,0,-86,45,82
51021,021,51,2018,6295,-19,0,-19,36,82
51021,021,51,2019,6292,21,0,21,44,68
51021,021,51,2020,6239,-18,0,-18,45,80
51023,023,51,2010,33195,47,0,47,54,50
51023,023,51,2011,33001,-142,1,-141,250,305
51023,023,51,2012,33121,189,0,189,246,308
51023,023,51,2013,32995,-44,1,-43,250,331
51023,023,51,2014,33086,148,3,151,271,323
51023,023,51,2015,33391,354,19,373,254,322
51023,023,51,2016,33298,-71,20,-51,295,335
51023,023,51,2017,33355,162,19,181,248,369
51023,023,51,2018,33412,116,7,123,279,342
51023,023,51,2019,33500,193,16,209,273,392
51023,023,51,2020,33633,268,12,280,255,401
51025,025,51,2010,17393,-3,0,-3,36,57
51025,025,51,2011,17119,-232,0,-232,152,194
51025,025,51,2012,17023,-67,3,-64,152,181
51025,025,51,2013,16976,-34,12,-22,145,168
51025,025,51,2014,16815,-103,22,-81,142,218
51025,025,51,2015,16838,43,16,59,156,190
51025,025,51,2016,16607,-176,18,-158,133,206
51025,025,51,2017,16572,44,18,62,145,239
51025,025,51,2018,16289,-195,7,-188,139,234
51025,025,51,2019,16176,-48,12,-36,139,217
51025,025,51,2020,16037,-35,14,-21,124,242
51027,027,51,2010,24091,-41,0,-41,61,39
51027,027,51,2011,23835,-208,10,-198,236,294
51027,027,51,2012,23835,57,21,78,206,280
51027,027,51,2013,23638,-139,9,-130,232,300
51027,027,51,2014,23167,-408,17,-391,183,273
51027,027,51,2015,22767,-307,21,-286,188,305
51027,027,51,2016,22229,-465,23,-442,168,267
51027,027,51,2017,21622,-471,24,-447,168,332
51027,027,51,2018,21373,-144,18,-126,190,311
51027,027,51,2019,21031,-274,23,-251,179,272
51027,027,51,2020,20613,-295,19,-276,169,308
51029,029,51,2010,17092,-39,0,-39,43,54
51029,029,51,2011,17217,117,9,126,165,166
51029,029,51,2012,17071,-162,10,-152,155,153
51029,029,51,2013,17154,32,2,34,190,139
51029,029,51,2014,16936,-230,2,-228,170,164
51029,029,51,2015,17022,97,1,98,145,157
51029,029,51,2016,17044,53,1,54,125,157
51029,029,51,2017,17046,24,1,25,153,174
51029,029,51,2018,17042,-9,0,-9,156,150
51029,029,51,2019,17134,99,1,100,156,164
51029,029,51,2020,17168,80,1,81,145,193
51031,031,51,2010,54910,80,6,86,162,152
51031,031,51,2011,54799,-217,12,-205,594,497
51031,031,51,2012,54843,-101,36,-65,600,485
51031,031,51,2013,55093,180,39,219,560,526
51031,031,51,2014,55286,117,75,192,545,529
51031,031,51,2015,55374,-36,80,44,608,558
51031,031,51,2016,55391,-86,88,2,580,563
51031,031,51,2017,55440,-120,92,-28,664,585
51031,031,51,2018,55526,-51,38,-13,637,535
51031,031,51,2019,55371,-185,73,-112,623,667
51031,031,51,2020,55304,-58,61,3,547,619
51033,033,51,2010,28631,51,3,54,106,81
51033,033,51,2011,28672,-130,10,-120,386,225
51033,033,51,2012,28950,102,8,110,399,226
51033,033,51,2013,29253,183,6,189,394,285
51033,033,51,2014,29747,275,16,291,439,237
51033,033,51,2015,29907,-14,24,10,407,255
51033,033,51,2016,30091,81,20,101,377,293
51033,033,51,2017,30441,263,16,279,358,289
51033,033,51,2018,30766,257,8,265,359,301
51033,033,51,2019,30745,-108,11,-97,366,290
51033,033,51,2020,30860,85,11,96,338,320
51035,035,51,2010,30071,19,-1,18,56,71
51035,035,51,2011,30093,107,1,108,247,332
51035,035,51,2012,29920,-81,1,-80,271,357
51035,035,51,2013,29915,106,11,117,257,377
51035,035,51,2014,29721,-69,15,-54,254,391
51035,035,51,2015,29882,198,35,233,293,361
51035,035,51,2016,29788,-27,57,30,236,359
51035,035,51,2017,29845,126,55,181,237,357
51035,035,51,2018,29824,54,20,74,256,348
51035,035,51,2019,30022,251,44,295,235,331
51035,035,51,2020,30074,174,37,211,240,399
51036,036,51,2010,7255,14,0,14,25,36
51036,036,51,2011,7200,-17,0,-17,47,85
51036,036,51,2012,7123,-64,0,-64,58,72
51036,036,51,2013,7068,-25,0,-25,50,79
51036,036,51,2014,6975,-89,2,-87,61,67
51036,036,51,2015,7043,48,1,49,76,57
51036,036,51,2016,7026,15,0,15,54,85
51036,036,51,2017,7024,31,0,31,52,85
51036,036,51,2018,6983,5,0,5,58,103
51036,036,51,2019,6969,4,0,4,60,79
51036,036,51,2020,6821,-83,0,-83,52,116
51037,037,51,2010,12568,-2,0,-2,25,49
51037,037,51,2011,12497,-53,5,-48,128,150
51037,037,51,2012,12400,-77,0,-77,140,158
51037,037,51,2013,12281,-107,0,-107,154,167
51037,037,51,2014,12177,-72,-1,-73,129,158
51037,037,51,2015,12182,-18,10,-8,144,131
51037,037,51,2016,12113,-40,8,-32,123,159
51037,037,51,2017,12078,-6,9,3,127,165
51037,037,51,2018,11906,-125,5,-120,131,182
51037,037,51,2019,11849,-31,8,-23,122,156
51037,037,51,2020,11820,14,6,20,131,181
51041,041,51,2010,317210,329,147,476,1041,512
51041,041,51,2011,320344,897,465,1362,3725,1944
51041,041,51,2012,323942,1269,765,2034,3681,2055
51041,041,51,2013,327721,1715,551,2266,3724,2165
51041,041,51,2014,332221,2279,634,2913,3769,2141
51041,041,51,2015,335093,673,798,1471,3828,2403
51041,041,51,2016,338677,1364,670,2034,3971,2401
51041,041,51,2017,343500,2690,667,3357,3946,2457
51041,041,51,2018,348704,3477,338,3815,3976,2572
51041,041,51,2019,353376,2994,476,3470,4078,2868
51041,041,51,2020,358245,3453,412,3865,3970,2954
51043,043,51,2010,14018,18,1,19,28,58
51043,043,51,2011,14197,197,2,199,129,150
51043,043,51,2012,14255,88,6,94,115,150
51043,043,51,2013,14264,26,3,29,124,142
51043,043,51,2014,14329,64,2,66,144,141
51043,043,51,2015,14252,-53,-5,-58,114,136
51043,043,51,2016,14309,75,6,81,128,150
51043,043,51,2017,14468,191,9,200,133,175
51043,043,51,2018,14517,79,8,87,107,143
51043,043,51,2019,14576,98,7,105,121,166
51043,043,51,2020,14622,75,6,81,128,164
51045,045,51,2010,5198,16,0,16,9,3
51045,045,51,2011,5170,-4,0,-4,28,52
51045,045,51,2012,5139,-21,0,-21,38,48
51045,045,51,2013,5138,13,0,13,48,63
51045,045,51,2014,5177,38,0,38,45,42
51045,045,51,2015,5140,-24,0,-24,35,48
51045,045,51,2016,5138,3,0,3,55,61
51045,045,51,2017,5070,-50,-1,-51,35,51
51045,045,51,2018,5105,44,-1,43,44,52
51045,045,51,2019,5127,34,-1,33,35,46
51045,045,51,2020,5077,-15,0,-15,41,75
51047,047,51,2010,46834,72,7,79,176,108
51047,047,51,2011,47347,261,27,288,599,373
51047,047,51,2012,47850,210,25,235,624,347
51047,047,51,2013,48609,461,45,506,639,391
51047,047,51,2014,49243,346,82,428,630,422
51047,047,51,2015,49559,-17,100,83,632,391
51047,047,51,2016,50337,452,111,563,638,424
51047,047,51,2017,51261,602,116,718,640,437
51047,047,51,2018,51785,301,76,377,624,476
51047,047,51,2019,52722,649,98,747,653,461
51047,047,51,2020,53569,597,85,682,651,484
51049,049,51,2010,10028,-4,0,-4,30,35
51049,049,51,2011,9987,-67,0,-67,108,84
51049,049,51,2012,9845,-180,-1,-181,117,82
51049,049,51,2013,9852,10,0,10,104,106
51049,049,51,2014,9843,-11,0,-11,106,102
51049,049,51,2015,9758,-119,0,-119,104,71
51049,049,51,2016,9742,-4,0,-4,95,106
51049,049,51,2017,9840,91,0,91,102,96
51049,049,51,2018,9863,39,0,39,87,101
51049,049,51,2019,9967,68,0,68,117,81
51049,049,51,2020,9933,-7,0,-7,93,121
51051,051,51,2010,15846,9,1,10,38,77
51051,051,51,2011,15778,-55,3,-52,178,194
51051,051,51,2012,15708,-43,2,-41,185,212
51051,051,51,2013,15527,-162,2,-160,174,198
51051,051,51,2014,15345,-124,2,-122,144,206
51051,051,51,2015,15200,-70,0,-70,150,223
51051,051,51,2016,15019,-112,1,-111,138,206
51051,051,51,2017,14728,-220,1,-219,132,207
51051,051,51,2018,14502,-145,0,-145,132,212
51051,051,51,2019,14295,-139,1,-138,113,182
51051,051,51,2020,14078,-130,0,-130,115,202
51053,053,51,2010,28062,15,4,19,70,35
51053,053,51,2011,28114,-20,16,-4,303,245
51053,053,51,2012,28222,-9,22,13,317,218
51053,053,51,2013,28087,-200,25,-175,332,293
51053,053,51,2014,28090,-46,38,-8,274,261
51053,053,51,2015,28146,-48,24,-24,316,233
51053,053,51,2016,28458,240,12,252,305,244
51053,053,51,2017,28678,156,9,165,325,269
51053,053,51,2018,28800,128,3,131,294,300
51053,053,51,2019,28804,-12,3,-9,306,295
51053,053,51,2020,28688,-36,2,-34,233,315
51057,057,51,2010,11145,14,1,15,33,50
51057,057,51,2011,11168,10,1,11,130,117
51057,057,51,2012,11133,-18,4,-14,127,146
51057,057,51,2013,11158,23,5,28,130,132
51057,057,51,2014,11066,-95,11,-84,115,122
51057,057,51,2015,11091,11,10,21,125,119
51057,057,51,2016,11073,7,10,17,111,146
51057,057,51,2017,10960,-80,10,-70,93,135
51057,057,51,2018,10889,-49,8,-41,99,129
51057,057,51,2019,10936,44,10,54,115,122
51057,057,51,2020,10943,30,8,38,108,139
51059,059,51,2010,1086165,309,1465,1774,3846,1051
51059,059,51,2011,1103571,-777,7496,6719,15352,4647
51059,059,51,2012,1120654,-4144,10770,6626,15211,4678
51059,059,51,2013,1132186,-6341,7565,1224,15244,4900
51059,059,51,2014,1136794,-16913,10802,-6111,15169,4788
51059,059,51,2015,1141040,-18162,11849,-6313,15385,5043
51059,059,51,2016,1144957,-17592,11110,-6482,15225,4919
51059,059,51,2017,1149346,-15411,10401,-5010,14423,5090
51059,059,51,2018,1149688,-14444,5323,-9121,14534,5126
51059,059,51,2019,1152359,-14107,8234,-5873,13883,5351
51059,059,51,2020,1150847,-15196,6371,-8825,13523,6215
51061,061,51,2010,65433,95,4,99,205,90
51061,061,51,2011,66032,366,14,380,747,527
51061,061,51,2012,66567,220,33,253,773,480
51061,061,51,2013,67150,349,31,380,708,499
51061,061,51,2014,68135,712,39,751,784,551
51061,061,51,2015,68449,52,58,110,747,537
51061,061,51,2016,68831,102,46,148,781,542
51061,061,51,2017,69555,486,38,524,758,553
51061,061,51,2018,70722,994,25,1019,755,602
51061,061,51,2019,71297,359,19,378,754,554
51061,061,51,2020,71361,-77,21,-56,767,650
51063,063,51,2010,15367,34,1,35,55,16
51063,063,51,2011,15404,23,3,26,161,150
51063,063,51,2012,15438,30,6,36,143,143
51063,063,51,2013,15493,52,-3,49,153,145
51063,063,51,2014,15538,67,1,68,157,178
51063,063,51,2015,15565,67,-1,66,140,179
51063,063,51,2016,15685,137,0,137,132,148
51063,063,51,2017,15783,125,-2,123,147,171
51063,063,51,2018,15788,24,-3,21,155,171
51063,063,51,2019,15796,19,-2,17,148,156
51063,063,51,2020,15777,18,-1,17,139,175
51065,065,51,2010,25792,35,1,36,69,54
51065,065,51,2011,25959,91,7,98,263,194
51065,065,51,2012,25889,-137,2,-135,258,191
51065,065,51,2013,25833,-106,-1,-107,268,214
51065,065,51,2014,25980,93,-6,87,260,196
51065,065,51,2015,26144,105,14,119,249,201
51065,065,51,2016,26227,12,32,44,277,235
51065,065,51,2017,26517,235,26,261,258,230
51065,065,51,2018,26931,333,10,343,303,233
51065,065,51,2019,27266,307,20,327,244,235
51065,065,51,2020,27422,140,14,154,255,254
51067,067,51,2010,56174,69,4,73,133,154
51067,067,51,2011,56339,214,-6,208,487,528
51067,067,51,2012,56293,10,-7,3,515,551
51067,067,51,2013,56272,19,-6,13,530,555
51067,067,51,2014,56265,109,-7,102,505,597
51067,067,51,2015,56234,98,-9,89,506,619
51067,067,51,2016,56167,-13,-5,-18,540,586
51067,067,51,2017,56341,264,-2,262,518,601
51067,067,51,2018,56297,109,-8,101,469,612
51067,067,51,2019,56185,21,-4,17,523,651
51067,067,51,2020,56167,214,-6,208,493,719
51069,069,51,2010,78545,158,0,158,221,104
51069,069,51,2011,79519,550,21,571,959,557
51069,069,51,2012,80247,361,37,398,906,562
51069,069,51,2013,81494,893,49,942,960,657
51069,069,51,2014,82735,827,93,920,964,649
51069,069,51,2015,83525,447,115,562,920,689
51069,069,51,2016,84722,752,144,896,1012,709
51069,069,51,2017,86568,1395,153,1548,970,670
51069,069,51,2018,88378,1439,128,1567,961,716
51069,069,51,2019,89483,865,65,930,981,804
51069,069,51,2020,91119,1441,70,1511,958,828
51071,071,51,2010,17317,2,1,3,61,33
51071,071,51,2011,17152,-139,4,-135,181,210
51071,071,51,2012,17024,-103,17,-86,168,211
51071,071,51,2013,16992,15,3,18,188,234
51071,071,51,2014,16853,-70,3,-67,171,241
51071,071,51,2015,16768,-29,-1,-30,166,220
51071,071,51,2016,16855,127,0,127,199,239
51071,071,51,2017,16759,-43,0,-43,152,204
51071,071,51,2018,16829,141,0,141,169,241
51071,071,51,2019,16693,-43,-1,-44,146,236
51071,071,51,2020,16663,76,0,76,151,258
51073,073,51,2010,36942,47,3,50,102,64
51073,073,51,2011,36897,-71,18,-53,362,354
51073,073,51,2012,36849,-74,35,-39,339,346
51073,073,51,2013,36780,-95,19,-76,342,333
51073,073,51,2014,37038,190,23,213,391,337
51073,073,51,2015,37032,-72,34,-38,402,370
51073,073,51,2016,37121,131,12,143,349,400
51073,073,51,2017,37332,261,5,266,368,424
51073,073,51,2018,37398,157,-1,156,352,439
51073,073,51,2019,37499,174,4,178,344,420
51073,073,51,2020,37459,93,2,95,339,474
51075,075,51,2010,21906,33,0,33,38,17
51075,075,51,2011,21537,-365,3,-362,174,185
51075,075,51,2012,21438,-91,10,-81,157,175
51075,075,51,2013,21732,308,3,311,169,195
51075,075,51,2014,22020,296,1,297,173,185
51075,075,51,2015,22344,333,4,337,180,197
51075,075,51,2016,22665,332,-1,331,163,171
51075,075,51,2017,22893,245,2,247,173,191
51075,075,51,2018,23423,572,-1,571,179,222
51075,075,51,2019,23949,565,0,565,176,215
51075,075,51,2020,24431,528,-1,527,184,226
51077,077,51,2010,15500,-27,0,-27,36,66
51077,077,51,2011,15368,-43,-2,-45,143,229
51077,077,51,2012,15146,-137,-2,-139,139,224
51077,077,51,2013,15131,53,-2,51,153,216
51077,077,51,2014,15925,806,-1,805,160,214
51077,077,51,2015,15960,91,4,95,122,181
51077,077,51,2016,15870,-17,10,-7,126,208
51077,077,51,2017,15699,-110,7,-103,131,197
51077,077,51,2018,15621,16,3,19,118,215
51077,077,51,2019,15574,-1,7,6,127,181
51077,077,51,2020,15493,-15,4,-11,126,195
51079,079,51,2010,18480,28,2,30,80,44
51079,079,51,2011,18694,136,19,155,206,146
51079,079,51,2012,18831,19,20,39,233,131
51079,079,51,2013,18874,-68,60,-8,216,162
51079,079,51,2014,19131,124,52,176,216,136
51079,079,51,2015,19205,25,29,54,200,176
51079,079,51,2016,19313,35,23,58,203,152
51079,079,51,2017,19608,178,28,206,228,140
51079,079,51,2018,19719,33,16,49,232,169
51079,079,51,2019,19901,100,24,124,223,165
51079,079,51,2020,20131,172,19,191,214,173
51081,081,51,2010,12233,-22,1,-21,17,7
51081,081,51,2011,12001,-215,3,-212,109,132
51081,081,51,2012,11746,-262,7,-255,103,115
51081,081,51,2013,11690,-41,4,-37,102,121
51081,081,51,2014,11568,-107,3,-104,104,126
51081,081,51,2015,11792,320,7,327,96,206
51081,081,51,2016,11515,-210,2,-208,103,173
51081,081,51,2017,11552,98,3,101,71,137
51081,081,51,2018,11380,-97,1,-96,76,151
51081,081,51,2019,11289,-66,3,-63,80,108
51081,081,51,2020,11280,18,3,21,93,123
51083,083,51,2010,36204,-20,0,-20,94,118
51083,083,51,2011,35997,-57,-1,-58,340,488
51083,083,51,2012,35740,-178,1,-177,347,427
51083,083,51,2013,35389,-225,-2,-227,348,470
51083,083,51,2014,35205,-57,2,-55,369,491
51083,083,51,2015,35104,-26,3,-23,396,468
51083,083,51,2016,35003,-34,4,-30,391,460
51083,083,51,2017,34592,-302,4,-298,375,488
51083,083,51,2018,34212,-242,-1,-243,352,487
51083,083,51,2019,34035,-45,2,-43,361,495
51083,083,51,2020,33633,-218,1,-217,351,535
51085,085,51,2010,99886,36,9,45,236,224
51085,085,51,2011,99899,-166,48,-118,890,759
51085,085,51,2012,100340,396,48,444,862,848
51085,085,51,2013,101075,611,81,692,920,860
51085,085,51,2014,101740,542,101,643,896,856
51085,085,51,2015,103095,1228,112,1340,941,926
51085,085,51,2016,104345,1097,100,1197,963,906
51085,085,51,2017,105729,1330,101,1431,896,936
51085,085,51,2018,106821,1030,44,1074,967,941
51085,085,51,2019,107535,713,73,786,974,1041
51085,085,51,2020,108262,739,67,806,952,1032
51087,087,51,2010,307201,-107,264,157,998,626
51087,087,51,2011,310401,419,1334,1753,3932,2473
51087,087,51,2012,315575,1793,1725,3518,4076,2405
51087,087,51,2013,318646,393,1246,1639,4029,2544
51087,087,51,2014,321863,171,1666,1837,4090,2650
51087,087,51,2015,324424,-657,1913,1256,4157,2821
51087,087,51,2016,326178,-1632,2092,460,4073,2778
51087,087,51,2017,328008,-1198,1984,786,3926,2873
51087,087,51,2018,329917,-437,1074,637,4155,2875
51087,087,51,2019,332513,-72,1588,1516,3978,2906
51087,087,51,2020,333766,-828,1237,409,3897,3067
51089,089,51,2010,54102,-45,14,-31,132,137
51089,089,51,2011,53530,-452,40,-412,561,723
51089,089,51,2012,53098,-320,33,-287,514,658
51089,089,51,2013,52738,-147,-1,-148,520,725
51089,089,51,2014,52235,-280,9,-271,482,712
51089,089,51,2015,51944,-75,12,-63,452,674
51089,089,51,2016,51654,-119,15,-104,479,661
51089,089,51,2017,51370,-93,16,-77,459,663
51089,089,51,2018,51101,-14,5,-9,466,723
51089,089,51,2019,50724,-137,9,-128,452,700
51089,089,51,2020,50309,-70,8,-62,428,782
51091,091,51,2010,2297,-8,0,-8,0,14
51091,091,51,2011,2260,-35,0,-35,21,23
51091,091,51,2012,2234,-14,0,-14,18,28
51091,091,51,2013,2205,-18,0,-18,12,23
51091,091,51,2014,2238,49,0,49,19,36
51091,091,51,2015,2196,-22,0,-22,10,29
51091,091,51,2016,2213,16,0,16,22,21
51091,091,51,2017,2215,9,0,9,18,24
51091,091,51,2018,2206,-1,0,-1,13,22
51091,091,51,2019,2176,-7,0,-7,18,41
51091,091,51,2020,2200,40,0,40,14,31
51093,093,51,2010,35319,18,4,22,95,73
51093,093,51,2011,35301,-34,5,-29,336,323
51093,093,51,2012,35352,7,47,54,330,329
51093,093,51,2013,35542,246,37,283,289,385
51093,093,51,2014,35887,294,37,331,362,341
51093,093,51,2015,36185,245,37,282,346,327
51093,093,51,2016,36450,80,109,189,388,309
51093,093,51,2017,36758,221,105,326,374,388
51093,093,51,2018,37203,360,76,436,376,368
51093,093,51,2019,37400,133,88,221,353,377
51093,093,51,2020,37725,334,73,407,349,428
51095,095,51,2010,67681,262,33,295,159,184
51095,095,51,2011,68339,503,91,594,657,591
51095,095,51,2012,69460,881,158,1039,672,601
51095,095,51,2013,70674,1133,91,1224,613,641
51095,095,51,2014,72145,1293,130,1423,682,655
51095,095,51,2015,72920,678,170,848,677,748
51095,095,51,2016,74075,1073,205,1278,646,767
51095,095,51,2017,75429,1321,168,1489,641,775
51095,095,51,2018,76206,864,105,969,669,857
51095,095,51,2019,76838,647,113,760,651,773
51095,095,51,2020,77612,776,102,878,671,770
51097,097,51,2010,6976,21,1,22,21,7
51097,097,51,2011,6986,28,4,32,61,83
51097,097,51,2012,7008,32,0,32,63,72
51097,097,51,2013,7029,38,4,42,52,74
51097,097,51,2014,7084,63,-2,61,67,73
51097,097,51,2015,7089,14,1,15,70,79
51097,097,51,2016,7059,-22,4,-18,63,75
51097,097,51,2017,7010,-37,7,-30,68,85
51097,097,51,2018,7033,58,1,59,69,105
51097,097,51,2019,7011,2,5,7,57,86
51097,097,51,2020,6942,-26,3,-23,60,105
51099,099,51,2010,23697,37,26,63,70,15
51099,099,51,2011,24277,385,6,391,335,148
51099,099,51,2012,24615,128,48,176,310,147
51099,099,51,2013,24909,154,19,173,305,185
51099,099,51,2014,25284,211,25,236,301,164
51099,099,51,2015,25442,-32,51,19,305,164
51099,099,51,2016,25982,359,29,388,313,162
51099,099,51,2017,26379,259,39,298,285,185
51099,099,51,2018,26673,159,42,201,282,191
51099,099,51,2019,26981,156,10,166,322,180
51099,099,51,2020,27381,274,20,294,306,200
51101,101,51,2010,15999,38,1,39,51,19
51101,101,51,2011,16013,-51,-2,-53,197,131
51101,101,51,2012,15977,-79,0,-79,191,147
51101,101,51,2013,16096,72,6,78,192,149
51101,101,51,2014,16153,7,12,19,173,130
51101,101,51,2015,16287,84,8,92,198,156
51101,101,51,2016,16416,78,12,90,200,161
51101,101,51,2017,16706,223,11,234,205,150
51101,101,51,2018,16962,182,5,187,207,139
51101,101,51,2019,17198,172,10,182,205,152
51101,101,51,2020,17641,397,7,404,206,164
51103,103,51,2010,11362,17,1,18,25,68
51103,103,51,2011,11276,30,5,35,87,206
51103,103,51,2012,11125,-44,11,-33,91,207
51103,103,51,2013,10960,-31,6,-25,65,203
51103,103,51,2014,10863,-6,10,4,74,174
51103,103,51,2015,10828,41,21,62,98,192
51103,103,51,2016,10776,33,21,54,99,205
51103,103,51,2017,10724,96,19,115,71,236
51103,103,51,2018,10692,99,16,115,83,230
51103,103,51,2019,10619,33,15,48,80,200
51103,103,51,2020,10618,122,13,135,84,219
51105,105,51,2010,25606,10,1,11,60,53
51105,105,51,2011,25546,-53,2,-51,256,263
51105,105,51,2012,25433,-73,1,-72,259,297
51105,105,51,2013,25094,-310,1,-309,249,286
51105,105,51,2014,24744,-258,-4,-262,216,307
51105,105,51,2015,24624,-66,-4,-70,217,264
51105,105,51,2016,24198,-410,-2,-412,223,239
51105,105,51,2017,23934,-187,-4,-191,210,284
51105,105,51,2018,23703,-116,-2,-118,192,306
51105,105,51,2019,23540,-108,-2,-110,224,277
51105,105,51,2020,23238,-206,0,-206,200,296
51107,107,51,2010,315486,1539,383,1922,1293,195
51107,107,51,2011,326357,5084,1760,6844,5015,1020
51107,107,51,2012,337902,4963,2514,7477,5004,1066
51107,107,51,2013,350001,6390,1773,8163,4909,1118
51107,107,51,2014,362330,5852,2365,8217,5112,1150
51107,107,51,2015,374176,5254,2560,7814,5188,1202
51107,107,51,2016,385750,5026,2450,7476,5390,1310
51107,107,51,2017,397192,5377,2298,7675,5194,1438
51107,107,51,2018,405964,3923,1186,5109,5175,1516
51107,107,51,2019,414872,3616,1738,5354,5110,1556
51107,107,51,2020,422784,3207,1361,4568,5075,1749
51109,109,51,2010,33169,83,1,84,102,49
51109,109,51,2011,33325,64,2,66,367,278
51109,109,51,2012,33357,-41,-2,-43,382,301
51109,109,51,2013,33850,376,7,383,382,277
51109,109,51,2014,34173,244,7,251,373,298
51109,109,51,2015,34475,237,14,251,354,303
51109,109,51,2016,35202,602,28,630,392,297
51109,109,51,2017,35803,561,22,583,369,356
51109,109,51,2018,36656,848,6,854,362,368
51109,109,51,2019,37477,815,18,833,379,389
51109,109,51,2020,38132,695,12,707,376,424
51111,111,51,2010,12909,16,3,19,26,52
51111,111,51,2011,12907,7,3,10,135,145
51111,111,51,2012,12639,-288,11,-277,124,127
51111,111,51,2013,12534,-76,5,-71,114,148
51111,111,51,2014,12480,-9,5,-4,106,154
51111,111,51,2015,12348,-153,18,-135,132,130
51111,111,51,2016,12340,-35,38,3,142,153
51111,111,51,2017,12353,15,42,57,118,161
51111,111,51,2018,12257,-82,13,-69,129,155
51111,111,51,2019,12251,18,33,51,108,165
51111,111,51,2020,12267,67,23,90,103,177
51113,113,51,2010,13299,-22,1,-21,30,15
51113,113,51,2011,13142,-140,1,-139,118,137
51113,113,51,2012,13135,16,1,17,116,139
51113,113,51,2013,13093,-18,7,-11,121,149
51113,113,51,2014,13034,-38,14,-24,114,148
51113,113,51,2015,13054,22,24,46,116,141
51113,113,51,2016,13097,40,18,58,153,166
51113,113,51,2017,13218,131,15,146,121,148
51113,113,51,2018,13198,-1,7,6,132,157
51113,113,51,2019,13213,-20,14,-6,154,134
51113,113,51,2020,13312,106,8,114,135,149
51115,115,51,2010,8974,4,1,5,13,18
51115,115,51,2011,8944,28,5,33,48,109
51115,115,51,2012,8911,3,10,13,69,114
51115,115,51,2013,8899,45,8,53,61,126
51115,115,51,2014,8813,-53,9,-44,51,92
51115,115,51,2015,8833,85,1,86,57,123
51115,115,51,2016,8781,10,1,11,73,136
51115,115,51,2017,8704,17,0,17,52,145
51115,115,51,2018,8766,127,0,127,64,129
51115,115,51,2019,8782,76,0,76,55,115
51115,115,51,2020,8766,58,0,58,60,132
51117,117,51,2010,32716,-11,4,-7,71,63
51117,117,51,2011,32567,-5,21,16,285,450
51117,117,51,2012,31698,-806,29,-777,315,445
51117,117,51,2013,31249,-286,15,-271,270,452
51117,117,51,2014,31117,-30,8,-22,301,405
51117,117,51,2015,30934,3,3,6,282,464
51117,117,51,2016,30815,9,1,10,290,416
51117,117,51,2017,30705,84,10,94,306,508
51117,117,51,2018,30707,184,2,186,323,506
51117,117,51,2019,30723,160,7,167,303,452
51117,117,51,2020,30679,133,6,139,314,497
51119,119,51,2010,10981,29,0,29,19,25
51119,119,51,2011,10855,-63,1,-62,73,136
51119,119,51,2012,10851,77,3,80,91,175
51119,119,51,2013,10781,-23,2,-21,88,137
51119,119,51,2014,10653,-34,3,-31,75,168
51119,119,51,2015,10683,78,3,81,94,144
51119,119,51,2016,10750,138,0,138,95,166
51119,119,51,2017,10614,-51,-2,-53,90,172
51119,119,51,2018,10717,188,-2,186,81,163
51119,119,51,2019,10561,-58,-2,-60,69,163
51119,119,51,2020,10569,85,-1,84,78,153
51121,121,51,2010,94560,-7,83,76,224,148
51121,121,51,2011,94761,-515,471,-44,859,617
51121,121,51,2012,95698,-130,732,602,928,584
51121,121,51,2013,96658,149,512,661,917,613
51121,121,51,2014,97193,-394,663,269,836,565
51121,121,51,2015,97427,-720,677,-43,890,619
51121,121,51,2016,98302,3,616,619,864,608
51121,121,51,2017,98230,-803,551,-252,825,651
51121,121,51,2018,98681,-11,266,255,849,650
51121,121,51,2019,98872,-363,438,75,770,659
51121,121,51,2020,98391,-870,337,-533,773,725
51125,125,51,2010,14978,-8,0,-8,41,68
51125,125,51,2011,15019,81,3,84,144,186
51125,125,51,2012,14802,-190,12,-178,130,173
51125,125,51,2013,14799,48,13,61,132,195
51125,125,51,2014,14867,76,6,82,142,155
51125,125,51,2015,14764,-23,7,-16,127,210
51125,125,51,2016,14802,122,3,125,113,199
51125,125,51,2017,14800,56,5,61,110,172
51125,125,51,2018,14836,53,3,56,151,170
51125,125,51,2019,14867,83,3,86,141,195
51125,125,51,2020,14755,-68,5,-63,138,185
51127,127,51,2010,18543,110,1,111,58,66
51127,127,51,2011,18763,173,11,184,168,134
51127,127,51,2012,19148,280,24,304,203,130
51127,127,51,2013,19516,316,18,334,174,144
51127,127,51,2014,20021,431,15,446,176,130
51127,127,51,2015,20382,337,10,347,176,166
51127,127,51,2016,21015,573,9,582,206,158
51127,127,51,2017,21629,555,4,559,204,152
51127,127,51,2018,22275,598,-3,595,227,178
51127,127,51,2019,22984,690,2,692,212,193
51127,127,51,2020,23648,639,5,644,221,199
51131,131,51,2010,12410,4,6,10,35,23
51131,131,51,2011,12406,-14,36,22,163,188
51131,131,51,2012,12209,-154,17,-137,133,195
51131,131,51,2013,12029,-126,17,-109,133,204
51131,131,51,2014,12034,60,12,72,133,199
51131,131,51,2015,12073,87,10,97,122,180
51131,131,51,2016,12003,-16,14,-2,121,189
51131,131,51,2017,11867,-81,11,-70,126,189
51131,131,51,2018,11789,-35,3,-32,128,174
51131,131,51,2019,11800,41,11,52,112,154
51131,131,51,2020,11673,-56,7,-49,116,194
51133,133,51,2010,12356,26,4,30,21,27
51133,133,51,2011,12452,132,17,149,110,162
51133,133,51,2012,12421,38,27,65,87,181
51133,133,51,2013,12298,-48,6,-42,105,185
51133,133,51,2014,12256,29,9,38,87,164
51133,133,51,2015,12243,50,0,50,97,159
51133,133,51,2016,12174,45,0,45,79,192
51133,133,51,2017,12270,168,0,168,92,165
51133,133,51,2018,12172,-18,0,-18,86,166
51133,133,51,2019,12069,10,0,10,80,192
51133,133,51,2020,12069,136,0,136,82,216
51135,135,51,2010,15847,4,1,5,39,53
51135,135,51,2011,15891,77,0,77,168,202
51135,135,51,2012,15758,-93,-3,-96,164,200
51135,135,51,2013,15642,-104,13,-91,184,209
51135,135,51,2014,15515,-110,8,-102,168,195
51135,135,51,2015,15613,99,11,110,181,195
51135,135,51,2016,15502,-84,22,-62,151,199
51135,135,51,2017,15439,-26,19,-7,149,204
51135,135,51,2018,15381,-1,3,2,159,218
51135,135,51,2019,15206,-133,14,-119,157,213
51135,135,51,2020,15160,12,14,26,155,227
51137,137,51,2010,33566,38,7,45,90,109
51137,137,51,2011,33982,313,47,360,400,344
51137,137,51,2012,34263,177,56,233,387,338
51137,137,51,2013,34607,287,47,334,352,344
51137,137,51,2014,34912,268,33,301,365,364
51137,137,51,2015,35173,229,47,276,388,403
51137,137,51,2016,35369,187,54,241,370,414
51137,137,51,2017,35882,479,50,529,371,390
51137,137,51,2018,36620,673,29,702,424,390
51137,137,51,2019,36941,333,34,367,380,426
51137,137,51,2020,37695,746,31,777,398,417
51139,139,51,2010,24062,-3,0,-3,63,43
51139,139,51,2011,23956,-40,2,-38,240,306
51139,139,51,2012,23841,-48,1,-47,213,276
51139,139,51,2013,23724,-63,0,-63,235,285
51139,139,51,2014,23787,91,3,94,258,286
51139,139,51,2015,23667,-71,5,-66,241,294
51139,139,51,2016,23633,15,9,24,249,304
51139,139,51,2017,23801,194,11,205,227,263
51139,139,51,2018,24005,219,12,231,277,305
51139,139,51,2019,23937,-4,5,1,248,316
51139,139,51,2020,23933,75,6,81,256,340
51141,141,51,2010,18474,3,1,4,45,78
51141,141,51,2011,18339,-18,3,-15,141,259
51141,141,51,2012,18339,71,10,81,165,244
51141,141,51,2013,18256,52,4,56,131,266
51141,141,51,2014,18185,46,3,49,133,249
51141,141,51,2015,17972,-78,5,-73,124,263
51141,141,51,2016,17830,-40,5,-35,165,270
51141,141,51,2017,17727,11,2,13,156,270
51141,141,51,2018,17659,48,0,48,151,266
51141,141,51,2019,17592,23,-3,20,130,218
51141,141,51,2020,17493,16,-3,13,127,240
51143,143,51,2010,63591,155,6,161,150,204
51143,143,51,2011,63269,-241,19,-222,542,641
51143,143,51,2012,62900,-233,3,-230,557,690
51143,143,51,2013,62566,-170,19,-151,543,721
51143,143,51,2014,62386,19,13,32,515,716
51143,143,51,2015,62027,-170,10,-160,495,690
51143,143,51,2016,61744,-138,20,-118,515,679
51143,143,51,2017,61334,-171,16,-155,491,743
51143,143,51,2018,60938,-143,8,-135,480,739
51143,143,51,2019,60470,-212,7,-205,500,762
51143,143,51,2020,59850,-301,8,-293,481,809
51145,145,51,2010,28133,20,0,20,65,22
51145,145,51,2011,28138,-49,0,-49,247,192
51145,145,51,2012,28186,-14,11,-3,240,190
51145,145,51,2013,28315,106,2,108,221,197
51145,145,51,2014,28504,146,18,164,232,201
51145,145,51,2015,28068,-509,12,-497,242,193
51145,145,51,2016,28463,348,14,362,239,206
51145,145,51,2017,28722,211,3,214,241,195
51145,145,51,2018,29199,479,0,479,241,244
51145,145,51,2019,29734,501,2,503,265,232
51145,145,51,2020,30148,434,2,436,259,277
51147,147,51,2010,23364,-29,2,-27,53,25
51147,147,51,2011,22328,-1008,11,-997,182,231
51147,147,51,2012,23187,801,24,825,208,219
51147,147,51,2013,22733,-463,17,-446,201,223
51147,147,51,2014,22994,211,38,249,216,209
51147,147,51,2015,23139,161,44,205,214,277
51147,147,51,2016,23049,-158,39,-119,241,212
51147,147,51,2017,22698,-366,53,-313,203,245
51147,147,51,2018,22879,212,38,250,184,255
51147,147,51,2019,22827,-74,42,-32,214,233
51147,147,51,2020,23006,186,36,222,220,263
51149,149,51,2010,35643,-211,55,-156,97,30
51149,149,51,2011,36734,808,75,883,419,216
51149,149,51,2012,37155,-62,354,292,382,246
51149,149,51,2013,37376,-86,152,66,382,225
51149,149,51,2014,37465,-176,136,-40,374,251
51149,149,51,2015,38306,403,189,592,444,199
51149,149,51,2016,38026,-582,82,-500,436,220
51149,149,51,2017,38049,-145,54,-91,378,265
51149,149,51,2018,38170,-58,-15,-73,436,242
51149,149,51,2019,38528,208,16,224,402,265
51149,149,51,2020,38686,49,22,71,386,302
51153,153,51,2010,406183,2378,450,2828,1593,446
51153,153,51,2011,419149,6331,1581,7912,6514,1505
51153,153,51,2012,429716,2987,2424,5411,6646,1490
51153,153,51,2013,437900,1433,1782,3215,6688,1687
51153,153,51,2014,444004,-1484,2691,1207,6661,1708
51153,153,51,2015,451242,-760,3092,2332,6717,1778
51153,153,51,2016,456805,-2066,2893,827,6548,1812
51153,153,51,2017,463400,-720,2766,2046,6530,1974
51153,153,51,2018,466658,-2697,1476,-1221,6480,2019
51153,153,51,2019,471774,-1130,2183,1053,6197,2159
51153,153,51,2020,475533,-1952,1700,-252,6300,2325
51155,155,51,2010,34830,-16,2,-14,69,76
51155,155,51,2011,34741,36,2,38,283,408
51155,155,51,2012,34734,97,1,98,326,428
51155,155,51,2013,34551,-59,4,-55,354,479
51155,155,51,2014,34343,-100,1,-99,346,448
51155,155,51,2015,34357,100,6,106,312,401
51155,155,51,2016,34268,4,9,13,335,435
51155,155,51,2017,34255,84,7,91,342,444
51155,155,51,2018,34097,-14,1,-13,322,465
51155,155,51,2019,34009,103,6,109,302,500
51155,155,51,2020,33935,143,6,149,296,519
51157,157,51,2010,7502,7,0,7,18,29
51157,157,51,2011,7478,-35,-1,-36,78,67
51157,157,51,2012,7414,-37,-1,-38,55,80
51157,157,51,2013,7433,29,-4,25,64,69
51157,157,51,2014,7344,-79,1,-78,56,67
51157,157,51,2015,7409,58,7,65,65,63
51157,157,51,2016,7384,-30,7,-23,53,55
51157,157,51,2017,7409,20,8,28,66,70
51157,157,51,2018,7373,-48,4,-44,75,66
51157,157,51,2019,7372,16,5,21,50,72
51157,157,51,2020,7260,-90,6,-84,57,86
51159,159,51,2010,9276,12,3,15,18,7
51159,159,51,2011,9204,-53,12,-41,69,101
51159,159,51,2012,9076,-80,2,-78,63,116
51159,159,51,2013,8948,-102,2,-100,74,105
51159,159,51,2014,8880,-31,1,-30,63,105
51159,159,51,2015,8779,-33,3,-30,55,125
51159,159,51,2016,8755,5,9,14,76,114
51159,159,51,2017,8882,171,10,181,86,142
51159,159,51,2018,8982,152,4,156,72,129
51159,159,51,2019,9066,106,8,114,69,99
51159,159,51,2020,9071,36,8,44,72,110
51161,161,51,2010,92416,-52,38,-14,193,235
51161,161,51,2011,92841,388,190,578,807,956
51161,161,51,2012,92771,-133,220,87,802,954
51161,161,51,2013,93354,551,145,696,856,955
51161,161,51,2014,93428,-61,214,153,878,940
51161,161,51,2015,93439,26,233,259,823,1064
51161,161,51,2016,93520,57,162,219,860,993
51161,161,51,2017,93900,415,153,568,840,1017
51161,161,51,2018,94161,405,74,479,849,1059
51161,161,51,2019,94423,366,124,490,819,1045
51161,161,51,2020,94509,282,96,378,773,1064
51163,163,51,2010,22348,7,0,7,51,64
51163,163,51,2011,22449,145,2,147,184,231
51163,163,51,2012,22384,-22,12,-10,203,253
51163,163,51,2013,22337,-40,21,-19,226,249
51163,163,51,2014,22443,126,27,153,184,228
51163,163,51,2015,22410,9,21,30,192,253
51163,163,51,2016,22467,113,18,131,207,279
51163,163,51,2017,22736,297,30,327,198,258
51163,163,51,2018,22904,224,14,238,191,259
51163,163,51,2019,22774,-67,23,-44,186,272
51163,163,51,2020,22757,84,19,103,147,267
51165,165,51,2010,76413,34,12,46,221,167
51165,165,51,2011,76868,177,35,212,880,634
51165,165,51,2012,77149,63,93,156,839,695
51165,165,51,2013,77437,122,104,226,809,734
51165,165,51,2014,77897,183,115,298,868,687
51165,165,51,2015,78469,366,87,453,836,710
51165,165,51,2016,79401,616,104,720,898,685
51165,165,51,2017,80448,759,94,853,955,759
51165,165,51,2018,81353,670,42,712,946,750
51165,165,51,2019,82140,576,70,646,919,776
51165,165,51,2020,82346,90,62,152,889,837
51167,167,51,2010,28873,-1,2,1,70,111
51167,167,51,2011,28681,-80,-2,-82,250,360
51167,167,51,2012,28429,-202,9,-193,268,328
51167,167,51,2013,28337,-27,8,-19,287,356
51167,167,51,2014,28082,-200,17,-183,270,345
51167,167,51,2015,27863,-103,6,-97,235,357
51167,167,51,2016,27423,-335,3,-332,244,352
51167,167,51,2017,27054,-229,0,-229,248,388
51167,167,51,2018,26820,-120,0,-120,239,353
51167,167,51,2019,26739,-33,0,-33,276,325
51167,167,51,2020,26647,14,0,14,260,366
51169,169,51,2010,23127,-56,1,-55,63,49
51169,169,51,2011,23053,25,-2,23,185,280
51169,169,51,2012,22956,5,1,6,217,315
51169,169,51,2013,22769,-46,3,-43,180,322
51169,169,51,2014,22521,-126,4,-122,180,306
51169,169,51,2015,22298,-108,4,-104,180,298
51169,169,51,2016,22070,-92,5,-87,162,303
51169,169,51,2017,21897,-55,2,-53,190,308
51169,169,51,2018,21631,-111,-1,-112,158,310
51169,169,51,2019,21578,10,-2,8,163,223
51169,169,51,2020,21629,163,2,165,155,267
51171,171,51,2010,42048,45,12,57,121,119
51171,171,51,2011,42266,123,55,178,473,431
51171,171,51,2012,42532,224,31,255,468,456
51171,171,51,2013,42514,-34,30,-4,464,472
51171,171,51,2014,42737,183,32,215,478,463
51171,171,51,2015,42863,156,49,205,432,508
51171,171,51,2016,42962,50,77,127,485,509
51171,171,51,2017,43319,279,72,351,440,433
51171,171,51,2018,43464,101,58,159,473,483
51171,171,51,2019,43557,120,29,149,471,526
51171,171,51,2020,43905,378,35,413,478,543
51173,173,51,2010,32198,1,3,4,67,79
51173,173,51,2011,32054,-64,13,-51,344,437
51173,173,51,2012,31911,-55,13,-42,324,420
51173,173,51,2013,31789,16,26,42,290,449
51173,173,51,2014,31593,-93,20,-73,283,404
51173,173,51,2015,31444,-71,13,-58,319,407
51173,173,51,2016,31143,-187,21,-166,282,417
51173,173,51,2017,30772,-252,22,-230,317,458
51173,173,51,2018,30509,-59,12,-47,266,480
51173,173,51,2019,30182,-167,19,-148,271,451
51173,173,51,2020,30090,126,16,142,256,489
51175,175,51,2010,18642,79,0,79,44,63
51175,175,51,2011,18638,8,3,11,185,199
51175,175,51,2012,18506,-125,2,-123,173,184
51175,175,51,2013,18330,-170,4,-166,171,183
51175,175,51,2014,18224,-94,2,-92,155,169
51175,175,51,2015,18139,-115,3,-112,189,160
51175,175,51,2016,18090,-53,5,-48,165,165
51175,175,51,2017,17866,-183,4,-179,148,193
51175,175,51,2018,17757,-66,2,-64,165,209
51175,175,51,2019,17797,52,3,55,176,191
51175,175,51,2020,17636,-101,4,-97,155,219
51177,177,51,2010,122981,212,43,255,393,129
51177,177,51,2011,124557,558,150,708,1626,759
51177,177,51,2012,125867,310,252,562,1552,787
51177,177,51,2013,127449,640,162,802,1561,766
51177,177,51,2014,128881,485,191,676,1579,798
51177,177,51,2015,130042,223,204,427,1594,850
51177,177,51,2016,131401,449,142,591,1643,868
51177,177,51,2017,132889,807,139,946,1516,968
51177,177,51,2018,134227,649,79,728,1607,987
51177,177,51,2019,136447,1651,88,1739,1510,1023
51177,177,51,2020,138449,1467,83,1550,1560,1104
51179,179,51,2010,129857,503,97,600,433,198
51179,179,51,2011,132251,1105,127,1232,1731,570
51179,179,51,2012,133449,-391,517,126,1628,584
51179,179,51,2013,136034,1256,320,1576,1702,690
51179,179,51,2014,138937,1449,450,1899,1691,674
51179,179,51,2015,141035,564,481,1045,1719,654
51179,179,51,2016,143641,1312,338,1650,1691,731
51179,179,51,2017,146868,2088,219,2307,1683,753
51179,179,51,2018,149891,2016,57,2073,1771,813
51179,179,51,2019,153775,2815,153,2968,1785,863
51179,179,51,2020,156748,2010,130,2140,1763,920
51181,181,51,2010,7045,7,0,7,16,42
51181,181,51,2011,6923,-112,0,-112,60,69
51181,181,51,2012,6844,-75,0,-75,65,72
51181,181,51,2013,6792,-44,1,-43,69,78
51181,181,51,2014,6783,-7,0,-7,56,57
51181,181,51,2015,6674,-89,1,-88,55,78
51181,181,51,2016,6560,-90,1,-89,62,86
51181,181,51,2017,6508,-25,1,-24,61,87
51181,181,51,2018,6435,-53,0,-53,65,86
51181,181,51,2019,6407,-38,1,-37,65,56
51181,181,51,2020,6385,-2,0,-2,60,78
51183,183,51,2010,12013,-81,1,-80,31,17
51183,183,51,2011,12088,106,6,112,103,142
51183,183,51,2012,11927,-135,6,-129,105,137
51183,183,51,2013,11765,-124,4,-120,108,152
51183,183,51,2014,11724,-20,3,-17,92,114
51183,183,51,2015,11692,-2,5,3,101,134
51183,183,51,2016,11425,-216,0,-216,110,162
51183,183,51,2017,11369,-15,1,-14,90,131
51183,183,51,2018,11194,-130,1,-129,86,132
51183,183,51,2019,11092,-48,1,-47,83,139
51183,183,51,2020,10925,-94,1,-93,78,151
51185,185,51,2010,45118,96,3,99,118,162
51185,185,51,2011,44733,-156,10,-146,445,683
51185,185,51,2012,44276,-247,3,-244,422,632
51185,185,51,2013,44031,-57,3,-54,456,637
51185,185,51,2014,43399,-500,9,-491,435,584
51185,185,51,2015,42930,-372,5,-367,472,574
51185,185,51,2016,42226,-666,27,-639,450,519
51185,185,51,2017,41362,-731,12,-719,381,529
51185,185,51,2018,41152,-34,5,-29,421,599
51185,185,51,2019,40734,-225,8,-217,358,558
51185,185,51,2020,40529,47,8,55,370,629
51187,187,51,2010,37520,78,-1,77,101,111
51187,187,51,2011,37654,17,-1,16,453,335
51187,187,51,2012,37898,159,-1,158,447,357
51187,187,51,2013,38514,489,11,500,472,368
51187,187,51,2014,40147,1377,17,1394,505,332
51187,187,51,2015,38742,-1589,20,-1569,490,363
51187,187,51,2016,39197,321,34,355,466,366
51187,187,51,2017,39478,128,35,163,491,371
51187,187,51,2018,40056,489,13,502,484,411
51187,187,51,2019,40235,47,31,78,503,403
51187,187,51,2020,40475,146,21,167,508,438
51191,191,51,2010,54966,41,2,43,142,174
51191,191,51,2011,54839,-47,17,-30,485,580
51191,191,51,2012,55110,365,8,373,516,625
51191,191,51,2013,54800,-180,18,-162,489,637
51191,191,51,2014,54630,-56,27,-29,457,584
51191,191,51,2015,54309,-137,15,-122,388,580
51191,191,51,2016,54178,-20,11,-9,486,606
51191,191,51,2017,54202,237,10,247,429,651
51191,191,51,2018,54100,129,-2,127,444,668
51191,191,51,2019,53852,-67,7,-60,442,630
51191,191,51,2020,53695,32,5,37,461,656
51193,193,51,2010,17493,7,2,9,50,26
51193,193,51,2011,17639,163,9,172,189,216
51193,193,51,2012,17515,-113,0,-113,191,198
51193,193,51,2013,17553,61,-3,58,180,201
51193,193,51,2014,17440,-72,-5,-77,184,217
51193,193,51,2015,17553,190,-4,186,187,260
51193,193,51,2016,17645,125,-4,121,198,226
51193,193,51,2017,17723,131,-6,125,190,238
51193,193,51,2018,17818,145,-7,138,184,226
51193,193,51,2019,18029,279,-7,272,178,238
51193,193,51,2020,18149,203,-5,198,177,254
51195,195,51,2010,41574,83,3,86,133,88
51195,195,51,2011,41461,-77,2,-75,446,484
51195,195,51,2012,40928,-471,4,-467,414,490
51195,195,51,2013,40685,-178,9,-169,469,540
51195,195,51,2014,39916,-721,11,-710,434,510
51195,195,51,2015,39596,-177,16,-161,372,527
51195,195,51,2016,39059,-477,17,-460,391,471
51195,195,51,2017,38593,-378,15,-363,382,486
51195,195,51,2018,37877,-534,6,-528,340,530
51195,195,51,2019,37427,-392,12,-380,355,425
51195,195,51,2020,37206,-111,9,-102,358,478
51197,197,51,2010,29252,-2,0,-2,63,50
51197,197,51,2011,29204,27,3,30,256,333
51197,197,51,2012,29331,162,4,166,307,342
51197,197,51,2013,29285,61,1,62,267,372
51197,197,51,2014,29060,-111,5,-106,264,380
51197,197,51,2015,29106,139,-1,138,311,400
51197,197,51,2016,28898,-48,-3,-51,256,410
51197,197,51,2017,28832,24,-4,20,310,396
51197,197,51,2018,28659,-53,-5,-58,299,414
51197,197,51,2019,28618,93,-4,89,257,386
51197,197,51,2020,28620,145,-2,143,265,406
51199,199,51,2010,65224,-116,66,-50,135,60
51199,199,51,2011,65796,209,95,304,665,394
51199,199,51,2012,65872,-489,360,-129,588,400
51199,199,51,2013,66046,-283,205,-78,622,381
51199,199,51,2014,66607,62,265,327,647,415
51199,199,51,2015,67900,695,319,1014,680,396
51199,199,51,2016,67914,-480,240,-240,672,421
51199,199,51,2017,68117,-288,204,-84,710,423
51199,199,51,2018,68136,-282,88,-194,653,442
51199,199,51,2019,68579,184,131,315,643,511
51199,199,51,2020,69199,451,120,571,635,586
51510,510,51,2010,140737,-30,325,295,642,211
51510,510,51,2011,144269,51,1518,1569,2687,742
51510,510,51,2012,147379,-1233,2365,1132,2674,682
51510,510,51,2013,149767,-1470,1746,276,2855,732
51510,510,51,2014,151544,-2644,2417,-227,2725,725
51510,510,51,2015,153859,-2254,2496,242,2747,674
51510,510,51,2016,156621,-1376,1986,610,2874,719
51510,510,51,2017,158772,-1756,1846,90,2812,734
51510,510,51,2018,158377,-3474,1072,-2402,2727,708
51510,510,51,2019,159050,-2683,1480,-1203,2628,733
51510,510,51,2020,158726,-3172,1186,-1986,2572,893
51520,520,51,2010,17769,-8,0,-8,70,29
51520,520,51,2011,17726,32,17,49,177,269
51520,520,51,2012,17706,30,1,31,198,245
51520,520,51,2013,17411,-241,4,-237,184,248
51520,520,51,2014,17225,-86,4,-82,182,283
51520,520,51,2015,17185,-28,1,-27,220,231
51520,520,51,2016,17140,-7,-1,-8,209,245
51520,520,51,2017,16956,-57,1,-56,193,321
51520,520,51,2018,16835,-57,-3,-60,183,245
51520,520,51,2019,17036,185,0,185,194,178
51520,520,51,2020,17329,328,-1,327,171,204
51530,530,51,2010,6613,-18,0,-18,26,4
51530,530,51,2011,6715,92,0,92,77,66
51530,530,51,2012,6751,26,4,30,86,81
51530,530,51,2013,6661,-104,6,-98,82,76
51530,530,51,2014,6561,-104,5,-99,73,77
51530,530,51,2015,6541,0,0,0,67,87
51530,530,51,2016,6488,-91,4,-87,115,81
51530,530,51,2017,6504,17,3,20,77,81
51530,530,51,2018,6508,-16,2,-14,79,60
51530,530,51,2019,6481,-22,3,-19,86,94
51530,530,51,2020,6402,-80,3,-77,88,90
51540,540,51,2010,43467,-105,71,-34,125,50
51540,540,51,2011,43780,-275,358,83,485,256
51540,540,51,2012,44610,86,444,530,542,247
51540,540,51,2013,45052,-171,372,201,506,259
51540,540,51,2014,45562,-157,440,283,532,297
51540,540,51,2015,46357,201,418,619,464,291
51540,540,51,2016,46976,26,363,389,501,272
51540,540,51,2017,47456,-82,342,260,537,315
51540,540,51,2018,47421,-490,177,-313,549,272
51540,540,51,2019,47283,-635,273,-362,525,300
51540,540,51,2020,46950,-742,211,-531,546,347
51550,550,51,2010,223525,788,95,883,720,414
51550,550,51,2011,225360,463,172,635,2766,1561
51550,550,51,2012,228134,982,589,1571,2769,1547
51550,550,51,2013,230415,793,412,1205,2805,1693
51550,550,51,2014,233477,1315,525,1840,2881,1630
51550,550,51,2015,235253,-41,595,554,2995,1755
51550,550,51,2016,237656,751,510,1261,2936,1781
51550,550,51,2017,240416,1271,444,1715,2852,1787
51550,550,51,2018,242748,977,244,1221,2939,1816
51550,550,51,2019,245403,1383,284,1667,2992,1996
51550,550,51,2020,247011,549,272,821,2930,2153
51570,570,51,2010,17338,-56,2,-54,40,60
51570,570,51,2011,17288,-57,47,-10,178,218
51570,570,51,2012,17390,76,58,134,189,220
51570,570,51,2013,17492,55,37,92,214,201
51570,570,51,2014,17448,-75,44,-31,223,234
51570,570,51,2015,17457,10,61,71,195,256
51570,570,51,2016,17400,5,24,29,203,287
51570,570,51,2017,17382,22,23,45,196,259
51570,570,51,2018,17337,12,10,22,192,256
51570,570,51,2019,17089,-222,8,-214,213,247
51570,570,51,2020,17205,88,9,97,236,217
51580,580,51,2010,5941,2,0,2,16,27
51580,580,51,2011,5916,-18,3,-15,59,69
51580,580,51,2012,5846,-81,0,-81,71,59
51580,580,51,2013,5832,9,2,11,62,87
51580,580,51,2014,5778,-52,6,-46,62,71
51580,580,51,2015,5671,-21,14,-7,30,128
51580,580,51,2016,5682,-12,13,1,128,118
51580,580,51,2017,5660,11,12,23,71,115
51580,580,51,2018,5660,51,8,59,59,117
51580,580,51,2019,5622,-31,9,-22,78,94
51580,580,51,2020,5639,-4,9,5,81,70
51590,590,51,2010,42925,-97,2,-95,121,173
51590,590,51,2011,42657,-116,20,-96,515,684
51590,590,51,2012,42725,194,49,243,536,704
51590,590,51,2013,42648,25,39,64,555,688
51590,590,51,2014,42295,-323,72,-251,540,643
51590,590,51,2015,41984,-217,74,-143,520,684
51590,590,51,2016,41682,-149,51,-98,486,687
51590,590,51,2017,41078,-425,50,-375,497,726
51590,590,51,2018,40677,-190,31,-159,464,705
51590,590,51,2019,40036,-463,33,-430,487,696
51590,590,51,2020,39869,49,34,83,461,710
51595,595,51,2010,5920,10,1,11,20,35
51595,595,51,2011,5841,-62,5,-57,80,102
51595,595,51,2012,5816,-2,2,0,62,88
51595,595,51,2013,5697,-84,5,-79,65,106
51595,595,51,2014,5606,-76,0,-76,74,90
51595,595,51,2015,5569,-77,-2,-79,75,33
51595,595,51,2016,5487,-123,-3,-126,84,40
51595,595,51,2017,5489,-18,-2,-20,87,65
51595,595,51,2018,5396,-114,-3,-117,92,67
51595,595,51,2019,5409,0,-3,-3,75,60
51595,595,51,2020,5257,-137,-1,-138,74,87
51600,600,51,2010,22616,-7,26,19,78,34
51600,600,51,2011,22467,-327,144,-183,218,186
51600,600,51,2012,22904,54,231,285,338,188
51600,600,51,2013,23241,34,208,242,268,171
51600,600,51,2014,23324,-334,294,-40,273,159
51600,600,51,2015,23247,-371,277,-94,238,226
51600,600,51,2016,23305,-308,284,-24,326,246
51600,600,51,2017,23274,-390,268,-122,318,229
51600,600,51,2018,23256,-211,155,-56,268,229
51600,600,51,2019,23294,-246,225,-21,307,248
51600,600,51,2020,23429,-299,176,-123,514,256
51610,610,51,2010,12422,115,16,131,27,13
51610,610,51,2011,12691,125,70,195,135,60
51610,610,51,2012,13126,240,106,346,152,70
51610,610,51,2013,13403,145,59,204,145,70
51610,610,51,2014,13459,-135,79,-56,179,75
51610,610,51,2015,13777,192,53,245,140,70
51610,610,51,2016,13649,-259,63,-196,143,78
51610,610,51,2017,14273,507,56,563,147,88
51610,610,51,2018,14441,102,27,129,117,78
51610,610,51,2019,14551,16,41,57,158,105
51610,610,51,2020,14631,-26,37,11,179,110
51620,620,51,2010,8579,18,1,19,30,48
51620,620,51,2011,8448,-100,6,-94,97,135
51620,620,51,2012,8488,20,13,33,126,117
51620,620,51,2013,8545,60,5,65,129,136
51620,620,51,2014,8399,-144,7,-137,118,130
51620,620,51,2015,8339,-20,-1,-21,107,145
51620,620,51,2016,8210,-84,0,-84,95,139
51620,620,51,2017,8132,-30,0,-30,98,147
51620,620,51,2018,8033,-75,0,-75,126,150
51620,620,51,2019,7867,-154,0,-154,112,123
51620,620,51,2020,7833,-54,0,-54,128,109
51630,630,51,2010,24356,65,26,91,101,17
51630,630,51,2011,25759,1057,121,1178,399,184
51630,630,51,2012,27190,1014,104,1118,420,159
51630,630,51,2013,27835,348,71,419,405,195
51630,630,51,2014,28276,56,121,177,433,171
51630,630,51,2015,28075,-556,125,-431,422,198
51630,630,51,2016,28469,7,182,189,407,202
51630,630,51,2017,28718,-158,206,48,418,216
51630,630,51,2018,29362,294,138,432,404,195
51630,630,51,2019,29254,-451,136,-315,397,189
51630,630,51,2020,29492,-7,118,111,383,258
51640,640,51,2010,6989,12,-2,10,23,35
51640,640,51,2011,6844,-147,2,-145,106,106
51640,640,51,2012,6850,21,-6,15,107,115
51640,640,51,2013,6927,70,8,78,94,95
51640,640,51,2014,6892,-32,1,-31,95,97
51640,640,51,2015,6791,-19,-5,-24,96,174
51640,640,51,2016,6615,-86,1,-85,100,190
51640,640,51,2017,6477,-39,0,-39,70,169
51640,640,51,2018,6300,-51,-4,-55,70,191
51640,640,51,2019,6324,46,-2,44,93,113
51640,640,51,2020,6296,-20,-2,-22,88,93
51650,650,51,2010,137418,-402,68,-334,480,208
51650,650,51,2011,136652,-1553,114,-1439,1827,1163
51650,650,51,2012,137222,-671,492,-179,1867,1110
51650,650,51,2013,137406,-866,339,-527,1899,1178
51650,650,51,2014,137778,-517,324,-193,1861,1270
51650,650,51,2015,136379,-2261,377,-1884,1763,1297
51650,650,51,2016,135525,-1659,336,-1323,1724,1256
51650,650,51,2017,135007,-1308,263,-1045,1831,1301
51650,650,51,2018,134800,-820,119,-701,1782,1284
51650,650,51,2019,135048,-280,181,-99,1732,1386
51650,650,51,2020,135464,7,164,171,1665,1429
51660,660,51,2010,48999,-40,59,19,127,46
51660,660,51,2011,49950,369,318,687,529,271
51660,660,51,2012,51336,773,353,1126,489,258
51660,660,51,2013,51572,-472,384,-88,556,241
51660,660,51,2014,52589,189,472,661,565,208
51660,660,51,2015,52739,-568,474,-94,553,313
51660,660,51,2016,53685,98,560,658,629,341
51660,660,51,2017,53807,-709,554,-155,558,285
51660,660,51,2018,53715,-723,360,-363,584,316
51660,660,51,2019,53379,-990,410,-580,547,307
51660,660,51,2020,53204,-819,343,-476,605,303
51670,670,51,2010,22640,0,5,5,85,38
51670,670,51,2011,22500,-212,30,-182,334,293
51670,670,51,2012,22306,-293,29,-264,332,268
51670,670,51,2013,22161,-273,37,-236,362,276
51670,670,51,2014,22117,-147,53,-94,354,305
51670,670,51,2015,22241,53,67,120,315,307
51670,670,51,2016,22565,248,59,307,341,324
51670,670,51,2017,22533,-135,83,-52,330,309
51670,670,51,2018,22506,-99,82,-17,300,309
51670,670,51,2019,22523,-24,35,11,336,330
51670,670,51,2020,22375,-201,44,-157,333,322
51678,678,51,2010,7045,-1,4,3,9,4
51678,678,51,2011,6977,-58,13,-45,41,65
51678,678,51,2012,7027,53,13,66,40,58
51678,678,51,2013,7155,143,9,152,36,65
51678,678,51,2014,7135,3,13,16,35,69
51678,678,51,2015,7174,55,12,67,60,88
51678,678,51,2016,7158,22,13,35,19,71
51678,678,51,2017,7139,48,8,56,25,100
51678,678,51,2018,7201,103,-2,101,46,85
51678,678,51,2019,7246,77,1,78,42,73
51678,678,51,2020,7279,15,4,19,78,66
51680,680,51,2010,75553,-33,43,10,237,219
51680,680,51,2011,76614,674,222,896,953,793
51680,680,51,2012,77326,250,241,491,996,779
51680,680,51,2013,78015,195,265,460,1004,770
51680,680,51,2014,78242,-399,427,28,1030,817
51680,680,51,2015,79263,448,409,857,1051,895
51680,680,51,2016,79871,-103,404,301,1039,728
51680,680,51,2017,80567,163,373,536,972,811
51680,680,51,2018,81096,174,221,395,964,830
51680,680,51,2019,81753,191,315,506,999,851
51680,680,51,2020,81561,-651,249,-402,1067,857
51683,683,51,2010,38212,206,68,274,148,26
51683,683,51,2011,39103,247,231,478,596,186
51683,683,51,2012,40284,414,277,691,666,186
51683,683,51,2013,41079,115,204,319,669,191
51683,683,51,2014,41137,-705,276,-429,697,220
51683,683,51,2015,41409,-489,248,-241,726,216
51683,683,51,2016,41245,-938,272,-666,733,235
51683,683,51,2017,41171,-775,236,-539,709,248
51683,683,51,2018,40998,-747,143,-604,697,270
51683,683,51,2019,40907,-689,196,-493,646,242
51683,683,51,2020,40869,-634,155,-479,678,234
51685,685,51,2010,14451,143,14,157,36,1
51685,685,51,2011,15071,306,68,374,297,53
51685,685,51,2012,15404,27,93,120,239,26
51685,685,51,2013,15903,132,111,243,278,28
51685,685,51,2014,15926,-345,173,-172,236,52
51685,685,51,2015,16145,-178,179,1,234,17
51685,685,51,2016,16420,-81,164,83,234,40
51685,685,51,2017,17209,377,150,527,288,30
51685,685,51,2018,18038,477,74,551,304,31
51685,685,51,2019,18071,-334,118,-216,281,29
51685,685,51,2020,18004,-276,92,-184,175,59
51690,690,51,2010,13786,-69,-1,-70,37,27
51690,690,51,2011,13622,-135,3,-132,203,234
51690,690,51,2012,13518,-45,15,-30,185,257
51690,690,51,2013,13443,-7,3,-4,159,229
51690,690,51,2014,13343,-69,0,-69,171,201
51690,690,51,2015,13289,26,18,44,194,290
51690,690,51,2016,13027,-162,20,-142,201,321
51690,690,51,2017,12827,-36,24,-12,155,342
51690,690,51,2018,12576,-88,16,-72,142,321
51690,690,51,2019,12443,-14,20,6,155,294
51690,690,51,2020,12355,-46,13,-33,190,245
51700,700,51,2010,180905,-710,201,-509,705,274
51700,700,51,2011,180139,-2711,468,-2243,2878,1417
51700,700,51,2012,180148,-2525,977,-1548,2900,1399
51700,700,51,2013,181388,-723,561,-162,2905,1481
51700,700,51,2014,181661,-1615,565,-1050,2744,1414
51700,700,51,2015,181121,-2522,744,-1778,2802,1578
51700,700,51,2016,180472,-2556,659,-1897,2805,1562
51700,700,51,2017,179738,-2377,588,-1789,2670,1619
51700,700,51,2018,178904,-2247,277,-1970,2678,1544
51700,700,51,2019,179736,-550,413,-137,2608,1643
51700,700,51,2020,179062,-1977,356,-1621,2674,1721
51710,710,51,2010,243019,-573,322,-251,893,458
51710,710,51,2011,243701,-1718,532,-1186,3699,1833
51710,710,51,2012,246247,-1362,1925,563,3860,1834
51710,710,51,2013,245598,-3447,1024,-2423,3656,1914
51710,710,51,2014,246756,-1824,1224,-600,3750,1950
51710,710,51,2015,246667,-3291,1493,-1798,3669,1965
51710,710,51,2016,246042,-3495,1114,-2381,3714,1964
51710,710,51,2017,244908,-3210,767,-2443,3377,2058
51710,710,51,2018,244168,-2308,165,-2143,3478,2053
51710,710,51,2019,243581,-2409,533,-1876,3386,2088
51710,710,51,2020,242803,-2337,468,-1869,3358,2266
51720,720,51,2010,4013,12,2,14,16,12
51720,720,51,2011,4087,52,12,64,51,40
51720,720,51,2012,4125,26,8,34,47,45
51720,720,51,2013,4103,-55,17,-38,58,42
51720,720,51,2014,4139,-2,12,10,56,32
51720,720,51,2015,4013,-118,3,-115,38,50
51720,720,51,2016,3992,-48,7,-41,68,49
51720,720,51,2017,3927,-67,5,-62,42,46
51720,720,51,2018,3956,56,1,57,32,61
51720,720,51,2019,3983,13,3,16,54,41
51720,720,51,2020,3985,-12,2,-10,43,31
51730,730,51,2010,32502,30,15,45,127,110
51730,730,51,2011,32093,-611,80,-531,517,397
51730,730,51,2012,31995,-357,126,-231,490,357
51730,730,51,2013,32311,151,81,232,480,402
51730,730,51,2014,32242,-185,83,-102,480,442
51730,730,51,2015,31895,-347,68,-279,461,530
51730,730,51,2016,31379,-501,29,-472,487,532
51730,730,51,2017,30966,-320,21,-299,431,544
51730,730,51,2018,30573,-313,-17,-330,483,545
51730,730,51,2019,30593,86,10,96,475,551
51730,730,51,2020,30446,-222,8,-214,593,526
51735,735,51,2010,12148,-7,1,-6,19,23
51735,735,51,2011,12043,-96,4,-92,86,100
51735,735,51,2012,12115,69,18,87,84,99
51735,735,51,2013,12093,-14,-1,-15,99,107
51735,735,51,2014,12005,-71,0,-71,83,103
51735,735,51,2015,12018,10,4,14,105,107
51735,735,51,2016,11940,-59,6,-53,88,113
51735,735,51,2017,12041,117,5,122,106,125
51735,735,51,2018,12138,142,1,143,99,143
51735,735,51,2019,12228,91,3,94,108,111
51735,735,51,2020,12257,50,4,54,97,119
51740,740,51,2010,95457,-212,49,-163,381,297
51740,740,51,2011,95767,-328,53,-275,1593,1007
51740,740,51,2012,96516,-94,316,222,1563,1022
51740,740,51,2013,96123,-1058,167,-891,1515,1023
51740,740,51,2014,95886,-948,176,-772,1556,1016
51740,740,51,2015,96407,-193,255,62,1520,1053
51740,740,51,2016,95287,-1808,267,-1541,1520,1103
51740,740,51,2017,94964,-841,213,-628,1424,1112
51740,740,51,2018,94879,-466,82,-384,1414,1108
51740,740,51,2019,94582,-858,175,-683,1444,1052
51740,740,51,2020,95094,42,138,180,1418,1088
51750,750,51,2010,16432,-5,18,13,27,2
51750,750,51,2011,16817,289,55,344,129,92
51750,750,51,2012,16720,-190,67,-123,125,104
51750,750,51,2013,17124,337,36,373,128,106
51750,750,51,2014,17395,190,47,237,138,108
51750,750,51,2015,17301,-114,22,-92,122,124
51750,750,51,2016,17321,14,21,35,107,122
51750,750,51,2017,17470,146,18,164,111,128
51750,750,51,2018,18013,550,7,557,108,130
51750,750,51,2019,18107,84,16,100,108,114
51750,750,51,2020,18255,123,12,135,115,105
51760,760,51,2010,204375,-403,165,-238,704,514
51760,760,51,2011,206487,555,591,1146,2820,1867
51760,760,51,2012,210922,2460,677,3137,2945,1791
51760,760,51,2013,214020,1525,522,2047,2861,1895
51760,760,51,2014,217238,1523,635,2158,2858,1893
51760,760,51,2015,221084,1831,777,2608,2976,1793
51760,760,51,2016,225669,2406,902,3308,3016,1768
51760,760,51,2017,227620,-65,943,878,2914,1840
51760,760,51,2018,229621,302,552,854,2940,1797
51760,760,51,2019,231027,-251,722,471,2970,2027
51760,760,51,2020,232226,-51,583,532,3036,2351
51770,770,51,2010,96722,-270,72,-198,334,326
51770,770,51,2011,96791,-576,440,-136,1455,1248
51770,770,51,2012,98034,310,584,894,1458,1113
51770,770,51,2013,98884,167,392,559,1489,1205
51770,770,51,2014,99475,-110,476,366,1403,1169
51770,770,51,2015,99741,-618,538,-80,1445,1090
51770,770,51,2016,99383,-1074,437,-637,1415,1136
51770,770,51,2017,98989,-844,457,-387,1300,1303
51770,770,51,2018,98964,-267,251,-16,1270,1273
51770,770,51,2019,99216,-204,377,173,1383,1305
51770,770,51,2020,99058,-549,296,-253,1393,1295
51775,775,51,2010,24897,36,11,47,58,40
51775,775,51,2011,25030,91,91,182,233,281
51775,775,51,2012,25190,151,76,227,244,310
51775,775,51,2013,25330,186,46,232,229,323
51775,775,51,2014,25441,110,39,149,230,266
51775,775,51,2015,25378,-15,30,15,256,333
51775,775,51,2016,25268,20,35,55,218,382
51775,775,51,2017,25362,198,32,230,211,345
51775,775,51,2018,25271,29,16,45,219,353
51775,775,51,2019,25209,86,23,109,195,366
51775,775,51,2020,25340,233,20,253,227,348
51790,790,51,2010,23738,15,5,20,79,106
51790,790,51,2011,24023,276,26,302,294,313
51790,790,51,2012,23808,-164,44,-120,272,367
51790,790,51,2013,24100,367,28,395,239,352
51790,790,51,2014,24287,184,57,241,293,346
51790,790,51,2015,24192,-48,48,0,306,400
51790,790,51,2016,24218,-9,96,87,310,370
51790,790,51,2017,24395,184,97,281,269,373
51790,790,51,2018,24583,245,65,310,272,395
51790,790,51,2019,24916,319,82,401,287,356
51790,790,51,2020,25190,227,64,291,348,365
51800,800,51,2010,84859,168,33,201,275,227
51800,800,51,2011,84808,-518,28,-490,1128,689
51800,800,51,2012,85320,-45,178,133,1093,697
51800,800,51,2013,85832,122,112,234,1048,758
51800,800,51,2014,86976,585,145,730,1102,688
51800,800,51,2015,88190,596,168,764,1148,699
51800,800,51,2016,89360,606,133,739,1185,753
51800,800,51,2017,90228,421,89,510,1106,747
51800,800,51,2018,91135,503,9,512,1205,810
51800,800,51,2019,92277,784,47,831,1126,818
51800,800,51,2020,93913,1378,43,1421,1150,931
51810,810,51,2010,438864,-188,421,233,1470,682
51810,810,51,2011,442654,-543,942,399,6191,2786
51810,810,51,2012,445189,-3536,2521,-1015,6269,2747
51810,810,51,2013,447922,-1570,1313,-257,6021,2992
51810,810,51,2014,449139,-3478,1537,-1941,6148,2995
51810,810,51,2015,450635,-3330,1773,-1557,6128,3069
51810,810,51,2016,451510,-3719,1524,-2195,6130,3065
51810,810,51,2017,450417,-4810,1157,-3653,5699,3151
51810,810,51,2018,450488,-2739,293,-2446,5688,3175
51810,810,51,2019,450766,-2631,747,-1884,5545,3398
51810,810,51,2020,451231,-1910,643,-1267,5466,3751
51820,820,51,2010,20989,14,-1,13,66,86
51820,820,51,2011,21099,55,6,61,293,242
51820,820,51,2012,21065,-97,20,-77,295,249
51820,820,51,2013,21164,55,22,77,272,246
51820,820,51,2014,21303,19,69,88,294,243
51820,820,51,2015,21543,172,85,257,275,293
51820,820,51,2016,21759,111,83,194,306,284
51820,820,51,2017,22196,349,94,443,281,287
51820,820,51,2018,22390,124,48,172,284,263
51820,820,51,2019,22416,-58,77,19,283,276
51820,820,51,2020,22741,234,61,295,306,276
51830,830,51,2010,13706,-4,12,8,30,10
51830,830,51,2011,14095,273,101,374,118,105
51830,830,51,2012,14519,251,168,419,87,89
51830,830,51,2013,14615,22,100,122,105,130
51830,830,51,2014,14586,-116,92,-24,119,122
51830,830,51,2015,14815,105,104,209,97,77
51830,830,51,2016,14894,-83,74,-9,135,48
51830,830,51,2017,14990,-36,61,25,129,58
51830,830,51,2018,15009,-61,31,-30,107,60
51830,830,51,2019,15019,-57,49,-8,114,96
51830,830,51,2020,15259,231,38,269,96,126
51840,840,51,2010,26150,-88,17,-71,93,99
51840,840,51,2011,26663,276,81,357,427,272
51840,840,51,2012,27012,183,71,254,355,263
51840,840,51,2013,27328,121,99,220,361,261
51840,840,51,2014,27398,-165,173,8,349,284
51840,840,51,2015,27500,-252,208,-44,425,280
51840,840,51,2016,27789,-72,213,141,379,229
51840,840,51,2017,28148,116,166,282,353,276
51840,840,51,2018,27889,-464,105,-359,361,260
51840,840,51,2019,28036,-60,122,62,353,268
51840,840,51,2020,27700,-505,103,-402,355,286
53001,001,53,2010,18791,-37,-4,-41,148,49
53001,001,53,2011,18876,-217,-7,-224,424,115
53001,001,53,2012,18936,-228,-21,-249,400,97
53001,001,53,2013,19080,-128,-12,-140,407,122
53001,001,53,2014,19154,-210,22,-188,379,122
53001,001,53,2015,19208,-251,63,-188,382,142
53001,001,53,2016,19311,-179,51,-128,357,127
53001,001,53,2017,19574,-9,19,10,387,133
53001,001,53,2018,19640,-217,1,-216,371,90
53001,001,53,2019,19959,-49,86,37,393,109
53001,001,53,2020,20027,-263,73,-190,383,124
53003,003,53,2010,21725,69,1,70,62,33
53003,003,53,2011,21984,227,-5,222,252,216
53003,003,53,2012,21935,-19,-13,-32,230,241
53003,003,53,2013,22167,255,-11,244,252,269
53003,003,53,2014,22235,72,-16,56,241,227
53003,003,53,2015,22167,-42,-12,-54,249,260
53003,003,53,2016,22362,235,-2,233,226,262
53003,003,53,2017,22612,284,-6,278,202,231
53003,003,53,2018,22699,130,-9,121,222,255
53003,003,53,2019,22687,26,-10,16,236,263
53003,003,53,2020,22820,199,-5,194,229,291
53005,005,53,2010,176467,812,43,855,656,265
53005,005,53,2011,180449,2550,156,2706,2551,1289
53005,005,53,2012,182400,395,206,601,2602,1218
53005,005,53,2013,184362,519,205,724,2522,1268
53005,005,53,2014,186535,580,387,967,2541,1298
53005,005,53,2015,190282,2065,387,2452,2697,1402
53005,005,53,2016,193573,1741,318,2059,2734,1497
53005,005,53,2017,198229,3074,338,3412,2653,1409
53005,005,53,2018,201174,1664,259,1923,2541,1510
53005,005,53,2019,204173,1569,275,1844,2596,1440
53005,005,53,2020,206426,1062,218,1280,2590,1623
53007,007,53,2010,72747,137,1,138,266,113
53007,007,53,2011,73213,149,21,170,945,645
53007,007,53,2012,73471,-5,4,-1,941,671
53007,007,53,2013,73723,-45,44,-1,927,660
53007,007,53,2014,74114,187,30,217,900,712
53007,007,53,2015,75030,614,32,646,979,710
53007,007,53,2016,75809,532,11,543,931,693
53007,007,53,2017,76216,213,-20,193,871,655
53007,007,53,2018,76612,300,-32,268,840,712
53007,007,53,2019,77053,268,8,276,896,731
53007,007,53,2020,77574,396,6,402,879,760
53009,009,53,2010,71505,121,20,141,165,197
53009,009,53,2011,71778,469,39,508,686,919
53009,009,53,2012,71791,262,47,309,655,942
53009,009,53,2013,72091,504,63,567,661,929
53009,009,53,2014,72518,562,96,658,694,928
53009,009,53,2015,73261,962,93,1055,663,982
53009,009,53,2016,74351,1245,77,1322,699,935
53009,009,53,2017,75741,1658,84,1742,646,1003
53009,009,53,2018,76792,1373,66,1439,623,1015
53009,009,53,2019,77457,1119,94,1213,590,1134
53009,009,53,2020,78067,1121,73,1194,595,1171
53011,011,53,2010,426733,564,190,754,1341,720
53011,011,53,2011,432388,2720,417,3137,5485,2969
53011,011,53,2012,436532,1729,165,1894,5344,3021
53011,011,53,2013,441591,2578,149,2727,5463,3098
53011,011,53,2014,448505,4291,381,4672,5341,3136
53011,011,53,2015,457320,6073,445,6518,5639,3386
53011,011,53,2016,465911,5902,499,6401,5631,3452
53011,011,53,2017,475238,6643,521,7164,5592,3455
53011,011,53,2018,482467,4929,343,5272,5454,3508
53011,011,53,2019,489271,4703,353,5056,5630,3890
53011,011,53,2020,496865,5913,275,6188,5621,4207
53013,013,53,2010,4094,29,1,30,6,22
53013,013,53,2011,4005,-69,1,-68,41,63
53013,013,53,2012,3977,-8,1,-7,26,46
53013,013,53,2013,4002,26,9,35,34,44
53013,013,53,2014,3984,-26,19,-7,39,51
53013,013,53,2015,3961,0,15,15,37,74
53013,013,53,2016,3983,12,19,31,38,47
53013,013,53,2017,4010,40,18,58,31,62
53013,013,53,2018,4055,46,18,64,37,55
53013,013,53,2019,4023,-39,15,-24,32,39
53013,013,53,2020,4048,29,14,43,29,48
53015,015,53,2010,102358,-40,1,-39,295,295
53015,015,53,2011,102313,-376,24,-352,1249,942
53015,015,53,2012,101669,-846,36,-810,1206,1044
53015,015,53,2013,101497,-300,49,-251,1141,1056
53015,015,53,2014,101811,257,65,322,1138,1125
53015,015,53,2015,103031,1089,36,1125,1239,1147
53015,015,53,2016,104760,1564,8,1572,1261,1106
53015,015,53,2017,106800,1936,8,1944,1280,1189
53015,015,53,2018,108673,1830,-1,1829,1274,1232
53015,015,53,2019,110389,1667,6,1673,1246,1199
53015,015,53,2020,111371,994,9,1003,1256,1275
53017,017,53,2010,38513,42,4,46,141,99
53017,017,53,2011,38660,-75,-9,-84,540,306
53017,017,53,2012,39192,314,-14,300,518,283
53017,017,53,2013,39379,-42,29,-13,506,306
53017,017,53,2014,39757,81,90,171,521,307
53017,017,53,2015,40521,428,106,534,539,307
53017,017,53,2016,41312,510,69,579,523,310
53017,017,53,2017,41961,382,42,424,517,291
53017,017,53,2018,42518,326,22,348,515,306
53017,017,53,2019,43251,412,104,516,523,304
53017,017,53,2020,43560,99,80,179,492,363
53019,019,53,2010,7545,3,3,6,21,34
53019,019,53,2011,7641,118,8,126,54,85
53019,019,53,2012,7668,30,5,35,74,82
53019,019,53,2013,7598,-63,3,-60,71,82
53019,019,53,2014,7597,14,2,16,76,90
53019,019,53,2015,7526,-60,1,-59,69,82
53019,019,53,2016,7534,25,1,26,64,80
53019,019,53,2017,7587,64,1,65,77,88
53019,019,53,2018,7661,83,1,84,76,86
53019,019,53,2019,7676,32,1,33,57,75
53019,019,53,2020,7759,100,1,101,67,84
53021,021,53,2010,79076,567,-14,553,423,114
53021,021,53,2011,83048,2559,59,2618,1683,350
53021,021,53,2012,85691,1158,65,1223,1761,376
53021,021,53,2013,86441,-635,116,-519,1629,366
53021,021,53,2014,87640,-199,179,-20,1582,354
53021,021,53,2015,88681,-468,206,-262,1673,363
53021,021,53,2016,90132,-2,182,180,1647,372
53021,021,53,2017,91803,367,78,445,1617,395
53021,021,53,2018,93950,935,25,960,1600,418
53021,021,53,2019,95446,140,277,417,1488,413
53021,021,53,2020,97075,372,209,581,1530,486
53023,023,53,2010,2261,6,0,6,3,13
53023,023,53,2011,2237,-20,0,-20,20,26
53023,023,53,2012,2209,-10,0,-10,21,39
53023,023,53,2013,2239,29,3,32,19,21
53023,023,53,2014,2202,-41,4,-37,20,22
53023,023,53,2015,2223,14,5,19,25,21
53023,023,53,2016,2255,16,8,24,33,26
53023,023,53,2017,2224,-51,8,-43,31,19
53023,023,53,2018,2257,50,6,56,18,40
53023,023,53,2019,2266,1,5,6,23,21
53023,023,53,2020,2290,25,3,28,19,23
53025,025,53,2010,89554,205,-7,198,430,201
53025,025,53,2011,90588,100,-27,73,1613,649
53025,025,53,2012,91292,-104,-68,-172,1577,681
53025,025,53,2013,91698,-596,124,-472,1529,651
53025,025,53,2014,92898,87,305,392,1498,674
53025,025,53,2015,93517,-482,258,-224,1502,657
53025,025,53,2016,94144,-439,271,-168,1465,668
53025,025,53,2017,95262,265,116,381,1453,710
53025,025,53,2018,96497,448,51,499,1494,759
53025,025,53,2019,97959,250,412,662,1473,674
53025,025,53,2020,99377,373,322,695,1474,754
53027,027,53,2010,72849,28,9,37,219,196
53027,027,53,2011,72374,-546,40,-506,829,798
53027,027,53,2012,71785,-656,28,-628,798,767
53027,027,53,2013,71059,-714,26,-688,794,841
53027,027,53,2014,70796,-217,17,-200,746,804
53027,027,53,2015,71027,267,5,272,789,824
53027,027,53,2016,71555,590,-4,586,776,832
53027,027,53,2017,72507,1074,-12,1062,736,851
53027,027,53,2018,73787,1438,-17,1421,744,888
53027,027,53,2019,75047,1433,-7,1426,724,887
53027,027,53,2020,75950,1136,0,1136,748,978
53029,029,53,2010,78700,-34,106,72,244,113
53029,029,53,2011,78970,-48,82,34,914,675
53029,029,53,2012,79086,-529,397,-132,895,641
53029,029,53,2013,78266,-1294,185,-1109,896,623
53029,029,53,2014,78777,86,233,319,882,686
53029,029,53,2015,80135,787,387,1174,877,702
53029,029,53,2016,81826,1207,237,1444,965,724
53029,029,53,2017,83362,1261,84,1345,965,784
53029,029,53,2018,84391,1006,-84,922,887,784
53029,029,53,2019,85344,802,59,861,900,808
53029,029,53,2020,86014,550,59,609,885,817
53031,031,53,2010,29899,64,6,70,47,101
53031,031,53,2011,29858,112,10,122,209,371
53031,031,53,2012,29808,91,7,98,180,328
53031,031,53,2013,30021,318,18,336,199,328
53031,031,53,2014,30172,261,18,279,193,326
53031,031,53,2015,30376,366,9,375,196,370
53031,031,53,2016,30949,730,13,743,185,358
53031,031,53,2017,31264,495,14,509,176,374
53031,031,53,2018,31864,807,9,816,169,387
53031,031,53,2019,32347,677,9,686,204,404
53031,031,53,2020,32700,596,9,605,192,437
53033,033,53,2010,1938431,230,3642,3872,6302,2831
53033,033,53,2011,1974499,10151,13505,23656,24504,12142
53033,033,53,2012,2011708,11007,13548,24555,24478,11963
53033,033,53,2013,2047967,10604,12845,23449,25149,12475
53033,033,53,2014,2086174,5145,20130,25275,25255,12337
53033,033,53,2015,2127372,7076,21668,28744,25244,12821
53033,033,53,2016,2167863,8129,19263,27392,25972,12931
53033,033,53,2017,2205001,2851,21670,24521,25667,13072
53033,033,53,2018,2228488,-5847,17662,11815,24792,13059
53033,033,53,2019,2249653,-5122,15419,10297,24434,13590
53033,033,53,2020,2274315,3111,11943,15054,24583,15094
53035,035,53,2010,251696,181,131,312,766,506
53035,035,53,2011,254351,1534,189,1723,2961,2033
53035,035,53,2012,254414,-1625,577,-1048,3029,1920
53035,035,53,2013,252538,-3091,291,-2800,2877,2015
53035,035,53,2014,253568,-112,347,235,2935,2086
53035,035,53,2015,259467,4535,417,4952,3040,2154
53035,035,53,2016,263419,2748,273,3021,3092,2167
53035,035,53,2017,266636,2182,195,2377,3092,2257
53035,035,53,2018,269583,2187,49,2236,2968,2265
53035,035,53,2019,272299,1899,105,2004,3050,2346
53035,035,53,2020,272787,38,89,127,3001,2647
53037,037,53,2010,40992,57,19,76,102,95
53037,037,53,2011,41561,347,74,421,427,282
53037,037,53,2012,41636,-126,74,-52,404,272
53037,037,53,2013,41845,17,61,78,427,288
53037,037,53,2014,42619,583,90,673,367,279
53037,037,53,2015,43120,290,90,380,408,287
53037,037,53,2016,44922,1630,66,1696,405,312
53037,037,53,2017,46164,1044,79,1123,425,315
53037,037,53,2018,47341,1014,64,1078,408,313
53037,037,53,2019,47856,386,55,441,410,338
53037,037,53,2020,49204,1275,37,1312,407,363
53039,039,53,2010,20375,45,2,47,67,60
53039,039,53,2011,20691,252,5,257,226,168
53039,039,53,2012,20640,-66,6,-60,207,193
53039,039,53,2013,20873,192,10,202,193,167
53039,039,53,2014,20863,-27,0,-27,203,182
53039,039,53,2015,21009,113,8,121,198,173
53039,039,53,2016,21295,254,12,266,195,175
53039,039,53,2017,21757,477,3,480,195,215
53039,039,53,2018,22095,317,-3,314,231,209
53039,039,53,2019,22433,318,18,336,203,200
53039,039,53,2020,22697,273,10,283,217,234
53041,041,53,2010,75503,-47,15,-32,244,159
53041,041,53,2011,75674,58,65,123,921,868
53041,041,53,2012,75452,-306,33,-273,862,809
53041,041,53,2013,74994,-534,37,-497,884,849
53041,041,53,2014,74877,-215,55,-160,817,769
53041,041,53,2015,75474,527,90,617,869,885
53041,041,53,2016,76709,1083,67,1150,952,869
53041,041,53,2017,78269,1475,51,1526,939,911
53041,041,53,2018,79466,1224,39,1263,867,936
53041,041,53,2019,80599,1091,73,1164,921,950
53041,041,53,2020,82109,1512,63,1575,908,964
53043,043,53,2010,10572,4,0,4,27,28
53043,043,53,2011,10527,-27,3,-24,107,127
53043,043,53,2012,10430,-70,2,-68,86,117
53043,043,53,2013,10295,-129,2,-127,97,106
53043,043,53,2014,10224,-68,2,-66,96,103
53043,043,53,2015,10287,61,1,62,99,97
53043,043,53,2016,10339,64,2,66,100,113
53043,043,53,2017,10586,259,1,260,106,119
53043,043,53,2018,10708,150,1,151,100,129
53043,043,53,2019,10938,247,1,248,99,115
53043,043,53,2020,11090,175,1,176,102,123
53045,045,53,2010,60733,36,19,55,160,164
53045,045,53,2011,60882,84,84,168,606,623
53045,045,53,2012,60689,-284,87,-197,653,637
53045,045,53,2013,60480,-342,65,-277,683,607
53045,045,53,2014,60613,80,132,212,569,643
53045,045,53,2015,60999,331,110,441,625,675
53045,045,53,2016,62166,1026,169,1195,640,670
53045,045,53,2017,63769,1482,150,1632,670,708
53045,045,53,2018,65533,1677,126,1803,647,694
53045,045,53,2019,66939,1325,149,1474,627,694
53045,045,53,2020,68224,1282,112,1394,638,738
53047,047,53,2010,41224,77,17,94,148,133
53047,047,53,2011,41325,-154,83,-71,580,406
53047,047,53,2012,41176,-325,33,-292,557,419
53047,047,53,2013,41044,-246,39,-207,489,413
53047,047,53,2014,41225,-1,91,90,521,423
53047,047,53,2015,41345,-51,119,68,489,430
53047,047,53,2016,41516,27,88,115,504,448
53047,047,53,2017,41802,167,48,215,516,444
53047,047,53,2018,42058,199,29,228,480,451
53047,047,53,2019,42403,197,137,334,477,466
53047,047,53,2020,42620,168,112,280,469,530
53049,049,53,2010,20879,5,1,6,42,84
53049,049,53,2011,20888,116,-3,113,202,306
53049,049,53,2012,20591,-239,16,-223,208,283
53049,049,53,2013,20460,-24,8,-16,195,307
53049,049,53,2014,20583,237,17,254,181,318
53049,049,53,2015,20890,407,20,427,195,320
53049,049,53,2016,21298,454,53,507,199,301
53049,049,53,2017,21756,528,37,565,206,316
53049,049,53,2018,22052,441,28,469,175,350
53049,049,53,2019,22517,560,75,635,157,327
53049,049,53,2020,22984,604,59,663,173,364
53051,051,53,2010,12950,-23,1,-22,25,53
53051,051,53,2011,12956,38,-2,36,117,146
53051,051,53,2012,13007,80,-1,79,101,129
53051,051,53,2013,12890,-79,-3,-82,121,155
53051,051,53,2014,12926,61,6,67,106,136
53051,051,53,2015,13095,180,5,185,122,139
53051,051,53,2016,13128,83,1,84,119,169
53051,051,53,2017,13360,245,3,248,123,140
53051,051,53,2018,13583,279,0,279,120,175
53051,051,53,2019,13726,189,-1,188,119,163
53051,051,53,2020,14144,469,1,470,119,167
53053,053,53,2010,795402,-1794,623,-1171,2666,1361
53053,053,53,2011,807728,5866,1346,7212,10852,5771
53053,053,53,2012,815772,-29,2550,2521,11444,5723
53053,053,53,2013,821307,-1056,1595,539,10971,5867
53053,053,53,2014,833106,4271,2045,6316,11502,6017
53053,053,53,2015,844317,3700,2405,6105,11514,6371
53053,053,53,2016,864004,12350,1917,14267,11876,6518
53053,053,53,2017,880745,10399,1710,12109,11484,6902
53053,053,53,2018,894951,8560,1088,9648,11400,6885
53053,053,53,2019,905719,5466,1133,6599,11279,7140
53053,053,53,2020,913890,3709,925,4634,11333,7842
53055,055,53,2010,15783,1,0,1,33,17
53055,055,53,2011,15807,44,14,58,84,117
53055,055,53,2012,15806,51,10,61,76,138
53055,055,53,2013,15867,104,16,120,86,145
53055,055,53,2014,15970,125,27,152,95,144
53055,055,53,2015,16155,219,25,244,87,148
53055,055,53,2016,16256,143,29,172,83,154
53055,055,53,2017,16674,451,29,480,88,153
53055,055,53,2018,16991,344,27,371,70,125
53055,055,53,2019,17352,375,28,403,96,137
53055,055,53,2020,17492,173,22,195,93,146
53057,057,53,2010,116939,-34,23,-11,376,305
53057,057,53,2011,117578,167,82,249,1481,1084
53057,057,53,2012,117716,-232,43,-189,1446,1102
53057,057,53,2013,118270,173,97,270,1425,1124
53057,057,53,2014,119990,1046,269,1315,1488,1086
53057,057,53,2015,121589,1100,277,1377,1384,1164
53057,057,53,2016,123661,1487,295,1782,1500,1214
53057,057,53,2017,125852,1765,182,1947,1501,1264
53057,057,53,2018,127728,1593,118,1711,1391,1230
53057,057,53,2019,129181,950,364,1314,1394,1255
53057,057,53,2020,130789,1289,290,1579,1406,1374
53059,059,53,2010,11115,26,2,28,19,4
53059,059,53,2011,11156,16,12,28,101,88
53059,059,53,2012,11205,29,6,35,103,86
53059,059,53,2013,11316,85,2,87,107,84
53059,059,53,2014,11387,44,6,50,104,82
53059,059,53,2015,11386,-9,3,-6,86,80
53059,059,53,2016,11590,189,5,194,99,90
53059,059,53,2017,11815,226,6,232,87,98
53059,059,53,2018,11920,85,6,91,99,84
53059,059,53,2019,12096,145,19,164,90,78
53059,059,53,2020,12107,19,13,32,86,106
53061,061,53,2010,715522,262,638,900,2358,976
53061,061,53,2011,722149,241,2176,2417,8949,4718
53061,061,53,2012,732239,3672,2233,5905,8906,4706
53061,061,53,2013,744322,5633,1919,7552,9340,4863
53061,061,53,2014,757485,5708,3023,8731,9393,5017
53061,061,53,2015,770022,4851,3119,7970,9732,5153
53061,061,53,2016,787886,10193,2872,13065,10064,5309
53061,061,53,2017,803061,7639,3192,10831,9853,5540
53061,061,53,2018,814107,4291,2514,6805,9800,5582
53061,061,53,2019,822413,1894,2330,4224,9854,5806
53061,061,53,2020,830393,2627,1806,4433,9814,6318
53063,063,53,2010,472102,111,241,352,1498,907
53063,063,53,2011,473516,-959,635,-324,5883,4136
53063,063,53,2012,475605,-477,840,363,5827,3997
53063,063,53,2013,478553,695,631,1326,6103,4400
53063,063,53,2014,483148,1919,872,2791,5943,4099
53063,063,53,2015,488970,3465,852,4317,5957,4447
53063,063,53,2016,497163,6174,499,6673,6100,4598
53063,063,53,2017,505708,6468,477,6945,6066,4488
53063,063,53,2018,513502,6474,321,6795,5787,4808
53063,063,53,2019,522231,7481,235,7716,5848,4833
53063,063,53,2020,528225,5084,199,5283,5863,5147
53065,065,53,2010,43472,-47,19,-28,104,134
53065,065,53,2011,43457,-69,34,-35,423,401
53065,065,53,2012,43494,-9,27,18,456,431
53065,065,53,2013,43287,-239,25,-214,426,420
53065,065,53,2014,43498,168,10,178,460,421
53065,065,53,2015,43576,116,6,122,430,469
53065,065,53,2016,44187,639,7,646,452,486
53065,065,53,2017,44679,516,8,524,428,459
53065,065,53,2018,45305,661,6,667,433,473
53065,065,53,2019,45815,566,3,569,412,469
53065,065,53,2020,46360,651,2,653,412,516
53067,067,53,2010,253011,295,180,475,758,475
53067,067,53,2011,256439,1864,464,2328,3002,1907
53067,067,53,2012,258613,218,825,1043,3126,1930
53067,067,53,2013,261976,1741,551,2292,3104,2038
53067,067,53,2014,265071,1276,703,1979,3134,1990
53067,067,53,2015,268175,1442,714,2156,3154,2198
53067,067,53,2016,273827,4235,452,4687,3105,2155
53067,067,53,2017,280255,5173,356,5529,3138,2260
53067,067,53,2018,285672,4472,196,4668,3105,2374
53067,067,53,2019,289661,3093,211,3304,3120,2431
53067,067,53,2020,294074,3739,170,3909,3122,2608
53069,069,53,2010,3983,-1,1,0,9,4
53069,069,53,2011,3992,23,6,29,26,46
53069,069,53,2012,3996,23,5,28,32,55
53069,069,53,2013,4002,11,6,17,40,52
53069,069,53,2014,4008,16,12,28,24,47
53069,069,53,2015,3989,3,4,7,24,49
53069,069,53,2016,4123,164,0,164,24,55
53069,069,53,2017,4207,104,0,104,25,45
53069,069,53,2018,4343,148,0,148,27,40
53069,069,53,2019,4420,100,-1,99,28,49
53069,069,53,2020,4498,108,0,108,30,58
53071,071,53,2010,58915,80,19,99,162,122
53071,071,53,2011,59452,351,13,364,686,515
53071,071,53,2012,59342,-295,14,-281,685,521
53071,071,53,2013,59387,-88,24,-64,675,556
53071,071,53,2014,59548,-27,84,57,681,564
53071,071,53,2015,59970,308,40,348,683,608
53071,071,53,2016,60112,-1,81,80,660,595
53071,071,53,2017,60683,474,63,537,650,618
53071,071,53,2018,60778,39,42,81,612,596
53071,071,53,2019,61062,134,100,234,603,554
53071,071,53,2020,61292,155,82,237,614,621
53073,073,53,2010,201549,73,103,176,611,359
53073,073,53,2011,203503,754,349,1103,2283,1430
53073,073,53,2012,204902,347,303,650,2258,1475
53073,073,53,2013,206139,331,241,572,2291,1602
53073,073,53,2014,208240,877,557,1434,2222,1538
53073,073,53,2015,211942,2340,543,2883,2358,1565
53073,073,53,2016,216486,3443,430,3873,2318,1663
53073,073,53,2017,221417,3955,459,4414,2233,1743
53073,073,53,2018,225098,2716,357,3073,2208,1611
53073,073,53,2019,228675,2963,351,3314,2048,1790
53073,073,53,2020,231016,1859,289,2148,2122,1931
53075,075,53,2010,44795,-106,93,-13,106,80
53075,075,53,2011,45067,-285,358,73,441,245
53075,075,53,2012,46660,954,391,1345,429,230
53075,075,53,2013,46831,-391,320,-71,500,265
53075,075,53,2014,46965,-505,474,-31,418,265
53075,075,53,2015,48224,577,497,1074,456,284
53075,075,53,2016,48912,85,450,535,421,268
53075,075,53,2017,49514,-58,504,446,432,274
53075,075,53,2018,49821,-207,417,210,384,288
53075,075,53,2019,50136,-148,362,214,362,264
53075,075,53,2020,49500,-994,275,-719,348,264
53077,077,53,2010,244249,332,-65,267,1183,424
53077,077,53,2011,245899,-710,-130,-840,4335,1840
53077,077,53,2012,246064,-1886,-265,-2151,4109,1816
53077,077,53,2013,246395,-1800,-53,-1853,4018,1845
53077,077,53,2014,246748,-1972,114,-1858,4065,1871
53077,077,53,2015,247648,-1307,59,-1248,4070,1911
53077,077,53,2016,249332,-700,313,-387,4043,1965
53077,077,53,2017,249851,-1172,-21,-1193,3789,2074
53077,077,53,2018,250633,-745,-140,-885,3779,2112
53077,077,53,2019,251552,-1158,581,-577,3593,2102
53077,077,53,2020,251879,-1555,455,-1100,3594,2173
54001,001,54,2010,16610,15,0,15,39,31
54001,001,54,2011,16600,11,3,14,152,176
54001,001,54,2012,16869,242,-2,240,193,174
54001,001,54,2013,16875,46,-2,44,179,216
54001,001,54,2014,16909,75,-3,72,163,199
54001,001,54,2015,16980,103,-2,101,171,201
54001,001,54,2016,16752,-200,1,-199,160,190
54001,001,54,2017,16530,-211,0,-211,183,192
54001,001,54,2018,16524,26,-2,24,159,187
54001,001,54,2019,16466,-9,1,-8,153,203
54001,001,54,2020,16444,41,2,43,152,217
54003,003,54,2010,104638,320,8,328,320,229
54003,003,54,2011,105778,522,169,691,1284,837
54003,003,54,2012,107024,781,51,832,1337,934
54003,003,54,2013,108587,1013,19,1032,1431,913
54003,003,54,2014,110316,1217,19,1236,1381,913
54003,003,54,2015,111824,1092,30,1122,1389,1009
54003,003,54,2016,113621,1435,33,1468,1354,1028
54003,003,54,2017,115234,1284,-22,1262,1387,1043
54003,003,54,2018,117472,1935,-59,1876,1448,1093
54003,003,54,2019,119623,1740,37,1777,1471,1096
54003,003,54,2020,122125,2179,36,2215,1472,1177
54005,005,54,2010,24607,-25,0,-25,71,65
54005,005,54,2011,24411,-139,-3,-142,305,359
54005,005,54,2012,24356,-16,-2,-18,271,304
54005,005,54,2013,24091,-252,-1,-253,266,282
54005,005,54,2014,23716,-310,0,-310,262,334
54005,005,54,2015,23252,-354,0,-354,230,343
54005,005,54,2016,22803,-353,0,-353,233,329
54005,005,54,2017,22368,-362,-2,-364,243,316
54005,005,54,2018,21907,-374,-2,-376,232,318
54005,005,54,2019,21352,-421,-2,-423,193,324
54005,005,54,2020,21055,-160,-2,-162,188,323
54007,007,54,2010,14544,9,1,10,34,19
54007,007,54,2011,14535,-22,5,-17,171,162
54007,007,54,2012,14452,-61,3,-58,152,175
54007,007,54,2013,14387,-44,-2,-46,168,184
54007,007,54,2014,14407,53,-1,52,153,183
54007,007,54,2015,14378,-37,2,-35,177,169
54007,007,54,2016,14316,1,-1,0,132,193
54007,007,54,2017,14218,-52,0,-52,132,178
54007,007,54,2018,14030,-119,1,-118,124,193
54007,007,54,2019,13894,-78,5,-73,113,176
54007,007,54,2020,13702,-116,5,-111,111,191
54009,009,54,2010,23973,-21,1,-20,56,108
54009,009,54,2011,23814,14,2,16,192,365
54009,009,54,2012,23677,29,-1,28,166,326
54009,009,54,2013,23596,49,-1,48,203,328
54009,009,54,2014,23383,-91,3,-88,182,302
54009,009,54,2015,23213,-40,3,-37,211,342
54009,009,54,2016,22674,-352,-3,-355,182,367
54009,009,54,2017,22406,-149,-2,-151,226,342
54009,009,54,2018,22130,-145,-6,-151,171,295
54009,009,54,2019,21924,-95,-1,-96,191,301
54009,009,54,2020,21674,-102,1,-101,178,326
54011,011,54,2010,96282,21,20,41,301,296
54011,011,54,2011,96584,107,221,328,1135,1158
54011,011,54,2012,96933,100,133,233,1221,1082
54011,011,54,2013,97030,17,68,85,1218,1200
54011,011,54,2014,96659,-367,75,-292,1144,1207
54011,011,54,2015,96617,50,84,134,1128,1293
54011,011,54,2016,95708,-788,54,-734,1046,1220
54011,011,54,2017,94511,-920,23,-897,1048,1345
54011,011,54,2018,92935,-1251,-5,-1256,1046,1371
54011,011,54,2019,91897,-968,65,-903,1027,1159
54011,011,54,2020,91589,-196,48,-148,1013,1177
54013,013,54,2010,7658,21,0,21,23,15
54013,013,54,2011,7642,-10,0,-10,88,93
54013,013,54,2012,7604,-14,0,-14,78,101
54013,013,54,2013,7557,-32,0,-32,81,97
54013,013,54,2014,7565,34,0,34,69,94
54013,013,54,2015,7472,-64,-1,-65,62,90
54013,013,54,2016,7387,-77,-2,-79,73,80
54013,013,54,2017,7321,-37,-2,-39,69,95
54013,013,54,2018,7197,-67,-2,-69,51,105
54013,013,54,2019,7077,-73,-2,-75,51,95
54013,013,54,2020,6945,-87,0,-87,49,94
54015,015,54,2010,9382,-19,0,-19,39,32
54015,015,54,2011,9344,-56,-2,-58,121,101
54015,015,54,2012,9217,-132,-2,-134,111,108
54015,015,54,2013,9150,-72,-1,-73,112,107
54015,015,54,2014,8892,-250,0,-250,95,109
54015,015,54,2015,8886,-2,0,-2,114,117
54015,015,54,2016,8842,-33,0,-33,99,110
54015,015,54,2017,8704,-80,0,-80,75,134
54015,015,54,2018,8604,-63,0,-63,95,131
54015,015,54,2019,8506,-88,0,-88,90,100
54015,015,54,2020,8341,-135,0,-135,86,115
54017,017,54,2010,8198,8,0,8,18,28
54017,017,54,2011,8253,63,1,64,68,77
54017,017,54,2012,8300,68,0,68,65,86
54017,017,54,2013,8551,262,-2,260,66,84
54017,017,54,2014,8471,-68,-2,-70,69,80
54017,017,54,2015,8706,250,1,251,69,90
54017,017,54,2016,8577,-121,3,-118,72,84
54017,017,54,2017,8530,-34,2,-32,70,85
54017,017,54,2018,8568,49,1,50,68,80
54017,017,54,2019,8451,-91,3,-88,64,91
54017,017,54,2020,8368,-46,3,-43,62,104
54019,019,54,2010,46029,25,2,27,144,183
54019,019,54,2011,45924,-50,23,-27,565,641
54019,019,54,2012,45873,15,8,23,554,618
54019,019,54,2013,45570,-215,9,-206,576,669
54019,019,54,2014,45176,-310,13,-297,548,644
54019,019,54,2015,44726,-298,26,-272,502,677
54019,019,54,2016,44184,-415,25,-390,461,612
54019,019,54,2017,43620,-363,12,-351,444,657
54019,019,54,2018,43067,-356,4,-352,439,641
54019,019,54,2019,42500,-325,22,-303,400,664
54019,019,54,2020,42062,-143,20,-123,396,712
54021,021,54,2010,8731,19,0,19,22,6
54021,021,54,2011,8754,-3,18,15,73,63
54021,021,54,2012,8760,25,-2,23,67,86
54021,021,54,2013,8635,-113,-2,-115,68,80
54021,021,54,2014,8511,-118,0,-118,71,79
54021,021,54,2015,8315,-187,6,-181,55,74
54021,021,54,2016,8153,-147,6,-141,63,87
54021,021,54,2017,8060,-84,5,-79,67,81
54021,021,54,2018,7937,-92,2,-90,53,85
54021,021,54,2019,7888,-48,14,-34,64,80
54021,021,54,2020,7811,-64,8,-56,60,80
54023,023,54,2010,11892,-17,0,-17,39,48
54023,023,54,2011,11881,-9,3,-6,119,125
54023,023,54,2012,11801,-73,2,-71,116,125
54023,023,54,2013,11737,-31,-1,-32,110,140
54023,023,54,2014,11614,-105,-1,-106,110,130
54023,023,54,2015,11648,40,-1,39,135,138
54023,023,54,2016,11594,-26,-1,-27,119,145
54023,023,54,2017,11625,27,0,27,131,126
54023,023,54,2018,11610,-22,0,-22,129,121
54023,023,54,2019,11486,-88,0,-88,104,140
54023,023,54,2020,11510,58,0,58,107,140
54025,025,54,2010,35554,49,1,50,105,88
54025,025,54,2011,35743,328,38,366,336,515
54025,025,54,2012,35892,226,25,251,389,490
54025,025,54,2013,35823,-29,20,-9,387,441
54025,025,54,2014,35602,-218,104,-114,361,466
54025,025,54,2015,35603,42,85,127,355,476
54025,025,54,2016,35538,-4,77,73,341,478
54025,025,54,2017,35206,-183,17,-166,353,517
54025,025,54,2018,34767,-317,12,-305,342,476
54025,025,54,2019,34634,39,22,61,310,503
54025,025,54,2020,34319,-103,21,-82,300,532
54027,027,54,2010,23945,11,0,11,65,81
54027,027,54,2011,23775,-111,-5,-116,199,254
54027,027,54,2012,23668,-70,-6,-76,229,256
54027,027,54,2013,23479,-143,-5,-148,222,262
54027,027,54,2014,23430,-30,-4,-34,243,256
54027,027,54,2015,23314,-86,-4,-90,229,253
54027,027,54,2016,23338,52,-4,48,235,258
54027,027,54,2017,23398,178,-3,175,178,294
54027,027,54,2018,23380,19,-3,16,227,259
54027,027,54,2019,23213,-125,-3,-128,233,273
54027,027,54,2020,23190,49,-2,47,217,287
54029,029,54,2010,30686,4,0,4,71,75
54029,029,54,2011,30644,18,15,33,306,378
54029,029,54,2012,30480,-56,15,-41,294,412
54029,029,54,2013,30408,15,13,28,293,387
54029,029,54,2014,30293,-7,30,23,272,404
54029,029,54,2015,30014,-142,15,-127,290,438
54029,029,54,2016,29679,-191,-6,-197,229,367
54029,029,54,2017,29411,-27,-8,-35,224,455
54029,029,54,2018,29096,-141,-10,-151,267,430
54029,029,54,2019,28834,-46,-7,-53,244,452
54029,029,54,2020,28571,-40,-3,-43,245,466
54031,031,54,2010,14044,31,2,33,38,56
54031,031,54,2011,13967,-132,36,-96,154,136
54031,031,54,2012,13857,-148,37,-111,135,134
54031,031,54,2013,13977,76,44,120,140,139
54031,031,54,2014,13964,-68,39,-29,154,137
54031,031,54,2015,13833,-160,59,-101,135,166
54031,031,54,2016,13837,-55,62,7,175,178
54031,031,54,2017,13859,-27,33,6,162,145
54031,031,54,2018,13789,-89,25,-64,157,164
54031,031,54,2019,13825,-2,36,34,163,159
54031,031,54,2020,13633,-209,37,-172,162,181
54033,033,54,2010,69244,105,2,107,209,160
54033,033,54,2011,69309,156,14,170,800,903
54033,033,54,2012,69113,-130,13,-117,821,884
54033,033,54,2013,68935,-93,1,-92,794,868
54033,033,54,2014,68702,-248,4,-244,823,805
54033,033,54,2015,68573,-88,9,-79,807,849
54033,033,54,2016,68392,-116,12,-104,770,843
54033,033,54,2017,67951,-261,7,-254,688,871
54033,033,54,2018,67547,-238,-1,-239,724,889
54033,033,54,2019,67339,-79,17,-62,735,882
54033,033,54,2020,66870,-244,13,-231,705,943
54035,035,54,2010,29233,33,2,35,92,107
54035,035,54,2011,29320,74,18,92,319,321
54035,035,54,2012,29285,-23,11,-12,319,337
54035,035,54,2013,29200,-85,0,-85,335,333
54035,035,54,2014,29139,-37,11,-26,314,344
54035,035,54,2015,29179,32,20,52,348,357
54035,035,54,2016,29192,20,16,36,314,336
54035,035,54,2017,28919,-191,6,-185,301,387
54035,035,54,2018,28741,-110,1,-109,300,370
54035,035,54,2019,28661,-31,25,-6,309,382
54035,035,54,2020,28453,-133,20,-113,303,397
54037,037,54,2010,53612,82,17,99,150,131
54037,037,54,2011,54483,393,274,667,617,414
54037,037,54,2012,54736,-34,122,88,601,426
54037,037,54,2013,55054,119,62,181,584,442
54037,037,54,2014,55702,410,53,463,631,444
54037,037,54,2015,56164,335,35,370,556,458
54037,037,54,2016,56112,-217,47,-170,568,451
54037,037,54,2017,56586,392,23,415,593,530
54037,037,54,2018,57078,438,-6,432,581,520
54037,037,54,2019,57347,228,58,286,495,512
54037,037,54,2020,57486,137,55,192,520,576
54039,039,54,2010,192925,-39,4,-35,508,578
54039,039,54,2011,192216,-463,130,-333,2095,2463
54039,039,54,2012,192306,40,147,187,2262,2312
54039,039,54,2013,191625,-488,96,-392,2223,2480
54039,039,54,2014,190458,-1068,149,-919,2221,2456
54039,039,54,2015,188399,-1709,154,-1555,2038,2544
54039,039,54,2016,186400,-1768,116,-1652,2096,2441
54039,039,54,2017,183525,-2311,77,-2234,1902,2546
54039,039,54,2018,180497,-2191,10,-2181,1878,2726
54039,039,54,2019,178393,-1596,157,-1439,1845,2508
54039,039,54,2020,176253,-1413,118,-1295,1790,2633
54041,041,54,2010,16411,15,0,15,57,28
54041,041,54,2011,16436,42,0,42,200,215
54041,041,54,2012,16450,35,-1,34,185,203
54041,041,54,2013,16477,64,1,65,195,232
54041,041,54,2014,16445,-38,15,-23,220,226
54041,041,54,2015,16436,14,16,30,188,225
54041,041,54,2016,16290,-117,12,-105,206,246
54041,041,54,2017,16166,-43,-1,-44,169,248
54041,041,54,2018,15981,-112,-1,-113,163,234
54041,041,54,2019,15877,-42,-1,-43,171,232
54041,041,54,2020,15805,2,-1,1,168,243
54043,043,54,2010,21674,1,0,1,61,96
54043,043,54,2011,21569,-107,1,-106,289,287
54043,043,54,2012,21606,41,1,42,250,251
54043,043,54,2013,21454,-172,-2,-174,288,268
54043,043,54,2014,21523,37,-4,33,295,253
54043,043,54,2015,21284,-218,-5,-223,227,246
54043,043,54,2016,21107,-127,-1,-128,228,276
54043,043,54,2017,20895,-189,5,-184,252,279
54043,043,54,2018,20586,-215,2,-213,209,305
54043,043,54,2019,20453,-76,11,-65,231,299
54043,043,54,2020,20043,-299,8,-291,214,331
54045,045,54,2010,36719,20,0,20,101,150
54045,045,54,2011,36462,-185,-3,-188,457,525
54045,045,54,2012,36322,-26,-1,-27,437,543
54045,045,54,2013,35937,-284,-3,-287,440,540
54045,045,54,2014,35254,-586,-2,-588,415,527
54045,045,54,2015,34444,-665,0,-665,375,528
54045,045,54,2016,33662,-561,1,-560,339,563
54045,045,54,2017,33030,-426,1,-425,362,570
54045,045,54,2018,32597,-232,2,-230,359,563
54045,045,54,2019,31989,-415,-1,-416,322,515
54045,045,54,2020,31688,-89,0,-89,318,529
54047,047,54,2010,22094,-29,1,-28,67,54
54047,047,54,2011,21730,-262,10,-252,270,382
54047,047,54,2012,21318,-299,5,-294,271,395
54047,047,54,2013,20963,-318,58,-260,281,384
54047,047,54,2014,20390,-541,24,-517,251,322
54047,047,54,2015,19768,-532,22,-510,221,340
54047,047,54,2016,19186,-453,0,-453,206,338
54047,047,54,2017,18517,-565,10,-555,219,337
54047,047,54,2018,18198,-185,8,-177,191,332
54047,047,54,2019,17600,-467,31,-436,160,322
54047,047,54,2020,16916,-517,25,-492,165,353
54049,049,54,2010,56566,59,3,62,172,116
54049,049,54,2011,56715,76,48,124,685,657
54049,049,54,2012,56791,71,9,80,641,635
54049,049,54,2013,56762,-84,57,-27,664,657
54049,049,54,2014,56841,62,18,80,646,636
54049,049,54,2015,56815,43,15,58,630,707
54049,049,54,2016,56557,-167,8,-159,630,726
54049,049,54,2017,56430,-108,9,-99,666,692
54049,049,54,2018,56132,-169,2,-167,592,721
54049,049,54,2019,56077,76,12,88,565,708
54049,049,54,2020,55962,31,9,40,558,716
54051,051,54,2010,33091,3,-1,2,75,108
54051,051,54,2011,32935,-75,10,-65,320,410
54051,051,54,2012,32827,5,6,11,294,405
54051,051,54,2013,32647,-99,2,-97,351,429
54051,051,54,2014,32363,-202,0,-202,328,409
54051,051,54,2015,32218,-69,0,-69,331,402
54051,051,54,2016,31736,-379,1,-378,325,431
54051,051,54,2017,31260,-384,8,-376,289,389
54051,051,54,2018,30845,-289,1,-288,280,406
54051,051,54,2019,30558,-181,13,-168,278,397
54051,051,54,2020,30103,-318,11,-307,269,417
54053,053,54,2010,27377,13,0,13,82,72
54053,053,54,2011,27328,9,-4,5,278,330
54053,053,54,2012,27233,-72,-4,-76,299,315
54053,053,54,2013,27164,6,-5,1,275,341
54053,053,54,2014,27177,90,-1,89,281,355
54053,053,54,2015,27117,-10,2,-8,290,338
54053,053,54,2016,26956,-45,5,-40,248,368
54053,053,54,2017,26841,-31,3,-28,273,358
54053,053,54,2018,26795,38,-1,37,274,355
54053,053,54,2019,26572,-132,5,-127,253,349
54053,053,54,2020,26335,-109,5,-104,254,387
54055,055,54,2010,62335,46,1,47,192,165
54055,055,54,2011,62568,282,88,370,762,899
54055,055,54,2012,62441,20,17,37,804,951
54055,055,54,2013,61947,-324,22,-302,740,927
54055,055,54,2014,61807,18,21,39,732,895
54055,055,54,2015,61187,-498,27,-471,750,899
54055,055,54,2016,60638,-355,11,-344,662,864
54055,055,54,2017,59903,-562,-3,-565,719,889
54055,055,54,2018,59228,-364,-13,-377,668,965
54055,055,54,2019,58823,-201,10,-191,665,878
54055,055,54,2020,58258,-259,8,-251,642,958
54057,057,54,2010,28208,16,0,16,76,105
54057,057,54,2011,28066,-105,-1,-106,276,312
54057,057,54,2012,27895,-149,1,-148,281,303
54057,057,54,2013,27700,-171,1,-170,324,347
54057,057,54,2014,27580,-138,17,-121,284,280
54057,057,54,2015,27431,-125,22,-103,274,320
54057,057,54,2016,27404,14,12,26,290,340
54057,057,54,2017,27227,-80,-4,-84,251,343
54057,057,54,2018,26979,-169,-6,-175,268,342
54057,057,54,2019,26904,26,-2,24,248,348
54057,057,54,2020,26722,-48,0,-48,240,373
54059,059,54,2010,26769,-47,0,-47,96,115
54059,059,54,2011,26605,-221,41,-180,356,341
54059,059,54,2012,26193,-431,2,-429,364,359
54059,059,54,2013,26015,-164,16,-148,350,378
54059,059,54,2014,25742,-215,0,-215,325,383
54059,059,54,2015,25321,-412,0,-412,341,355
54059,059,54,2016,24700,-544,0,-544,270,349
54059,059,54,2017,24151,-490,-1,-491,308,370
54059,059,54,2018,23847,-230,-1,-231,304,377
54059,059,54,2019,23390,-384,-1,-385,264,335
54059,059,54,2020,22951,-289,0,-289,252,400
54061,061,54,2010,96768,405,31,436,225,124
54061,061,54,2011,99070,1198,661,1859,1070,640
54061,061,54,2012,101009,1117,383,1500,1046,650
54061,061,54,2013,102392,696,313,1009,1035,674
54061,061,54,2014,103631,236,546,782,1122,655
54061,061,54,2015,104871,86,655,741,1202,693
54061,061,54,2016,105866,50,587,637,1070,712
54061,061,54,2017,106086,-414,267,-147,1101,732
54061,061,54,2018,105930,-540,35,-505,1068,722
54061,061,54,2019,106281,-393,491,98,994,745
54061,061,54,2020,106819,-45,387,342,975,788
54063,063,54,2010,13520,15,0,15,40,29
54063,063,54,2011,13551,86,-1,85,120,174
54063,063,54,2012,13503,-25,0,-25,147,170
54063,063,54,2013,13523,54,-2,52,151,182
54063,063,54,2014,13619,131,14,145,120,168
54063,063,54,2015,13586,25,11,36,120,187
54063,063,54,2016,13506,-70,9,-61,135,155
54063,063,54,2017,13397,-55,3,-52,126,182
54063,063,54,2018,13293,-40,-1,-41,117,179
54063,063,54,2019,13295,41,8,49,127,173
54063,063,54,2020,13229,-25,7,-18,127,175
54065,065,54,2010,17492,-17,-1,-18,43,72
54065,065,54,2011,17471,24,24,48,132,202
54065,065,54,2012,17434,29,-9,20,146,198
54065,065,54,2013,17453,62,32,94,134,208
54065,065,54,2014,17533,118,11,129,160,210
54065,065,54,2015,17513,55,0,55,141,213
54065,065,54,2016,17661,240,-6,234,142,229
54065,065,54,2017,17740,196,-6,190,140,250
54065,065,54,2018,17852,197,-6,191,145,225
54065,065,54,2019,17875,136,-6,130,124,229
54065,065,54,2020,17873,119,-4,115,123,240
54067,067,54,2010,26219,16,3,19,77,98
54067,067,54,2011,26207,8,32,40,287,338
54067,067,54,2012,26255,48,0,48,302,298
54067,067,54,2013,25943,-229,-2,-231,298,383
54067,067,54,2014,25712,-191,1,-190,265,308
54067,067,54,2015,25547,-117,21,-96,276,344
54067,067,54,2016,25372,-165,20,-145,264,293
54067,067,54,2017,25126,-159,14,-145,268,369
54067,067,54,2018,24877,-180,7,-173,260,336
54067,067,54,2019,24569,-212,21,-191,218,335
54067,067,54,2020,24340,-83,16,-67,219,380
54069,069,54,2010,44477,50,3,53,104,110
54069,069,54,2011,44216,-184,45,-139,464,584
54069,069,54,2012,44017,-115,13,-102,503,596
54069,069,54,2013,43762,-143,8,-135,481,597
54069,069,54,2014,43279,-401,14,-387,455,554
54069,069,54,2015,43018,-136,13,-123,478,614
54069,069,54,2016,42659,-231,9,-222,416,552
54069,069,54,2017,42069,-436,3,-433,421,579
54069,069,54,2018,41841,-108,-2,-110,440,556
54069,069,54,2019,41626,-40,9,-31,394,577
54069,069,54,2020,41182,-235,7,-228,408,623
54071,071,54,2010,7676,-4,2,-2,14,30
54071,071,54,2011,7539,-88,-2,-90,65,112
54071,071,54,2012,7474,-74,22,-52,82,96
54071,071,54,2013,7381,-68,8,-60,68,102
54071,071,54,2014,7233,-144,4,-140,82,95
54071,071,54,2015,7106,-96,3,-93,54,89
54071,071,54,2016,6994,-109,0,-109,80,85
54071,071,54,2017,6978,18,0,18,68,100
54071,071,54,2018,6976,44,0,44,53,99
54071,071,54,2019,6960,4,0,4,61,80
54071,071,54,2020,6932,-11,0,-11,59,76
54073,073,54,2010,7569,-18,0,-18,18,33
54073,073,54,2011,7572,40,0,40,62,98
54073,073,54,2012,7531,3,0,3,57,100
54073,073,54,2013,7517,8,0,8,68,90
54073,073,54,2014,7589,71,-1,70,72,72
54073,073,54,2015,7499,-58,-2,-60,78,108
54073,073,54,2016,7493,2,0,2,74,82
54073,073,54,2017,7460,-5,0,-5,63,91
54073,073,54,2018,7479,51,0,51,80,110
54073,073,54,2019,7416,-46,0,-46,70,88
54073,073,54,2020,7438,31,0,31,72,80
54075,075,54,2010,8734,0,0,0,25,12
54075,075,54,2011,8826,111,6,117,90,115
54075,075,54,2012,8704,-118,3,-115,81,92
54075,075,54,2013,8683,3,0,3,87,110
54075,075,54,2014,8656,8,-1,7,78,111
54075,075,54,2015,8576,-52,0,-52,80,108
54075,075,54,2016,8532,-28,-1,-29,88,102
54075,075,54,2017,8494,-30,0,-30,90,98
54075,075,54,2018,8420,-36,0,-36,75,112
54075,075,54,2019,8274,-104,0,-104,70,111
54075,075,54,2020,8190,-15,0,-15,70,139
54077,077,54,2010,33546,6,1,7,76,42
54077,077,54,2011,33660,128,-1,127,355,369
54077,077,54,2012,33905,214,0,214,368,337
54077,077,54,2013,33693,-182,0,-182,337,367
54077,077,54,2014,33927,247,8,255,339,363
54077,077,54,2015,33855,-106,49,-57,348,362
54077,077,54,2016,33802,-64,52,-12,351,391
54077,077,54,2017,33846,40,51,91,326,371
54077,077,54,2018,33543,-279,76,-203,318,419
54077,077,54,2019,33479,-32,-1,-33,321,351
54077,077,54,2020,33380,-56,21,-35,321,387
54079,079,54,2010,55620,96,6,102,117,87
54079,079,54,2011,56032,312,24,336,605,528
54079,079,54,2012,56448,312,29,341,606,529
54079,079,54,2013,56496,21,19,40,596,580
54079,079,54,2014,56631,58,15,73,636,565
54079,079,54,2015,56601,-79,10,-69,636,592
54079,079,54,2016,56670,67,8,75,564,566
54079,079,54,2017,56704,94,7,101,550,612
54079,079,54,2018,56710,108,1,109,536,637
54079,079,54,2019,56507,-89,11,-78,481,608
54079,079,54,2020,56428,59,9,68,495,641
54081,081,54,2010,78921,52,13,65,233,237
54081,081,54,2011,79366,316,131,447,986,988
54081,081,54,2012,79284,-134,79,-55,989,1005
54081,081,54,2013,78843,-364,39,-325,955,1069
54081,081,54,2014,78236,-615,33,-582,912,935
54081,081,54,2015,77416,-673,39,-634,843,1030
54081,081,54,2016,76319,-861,32,-829,814,1082
54081,081,54,2017,75106,-1032,15,-1017,832,1032
54081,081,54,2018,74256,-531,0,-531,777,1094
54081,081,54,2019,73659,-367,29,-338,774,1031
54081,081,54,2020,72920,-417,24,-393,766,1112
54083,083,54,2010,29360,-16,0,-16,61,86
54083,083,54,2011,29432,109,14,123,307,357
54083,083,54,2012,29388,10,8,18,310,366
54083,083,54,2013,29519,148,11,159,328,356
54083,083,54,2014,29371,-122,12,-110,316,350
54083,083,54,2015,29209,-124,20,-104,313,370
54083,083,54,2016,29038,-89,12,-77,288,380
54083,083,54,2017,28896,-93,5,-88,297,350
54083,083,54,2018,28823,6,-1,5,291,366
54083,083,54,2019,28670,-53,10,-43,258,370
54083,083,54,2020,28387,-134,8,-126,253,409
54085,085,54,2010,10420,-6,0,-6,23,45
54085,085,54,2011,10315,-81,1,-80,99,123
54085,085,54,2012,10254,-33,0,-33,95,123
54085,085,54,2013,10153,-77,0,-77,89,113
54085,085,54,2014,10082,-50,1,-49,89,111
54085,085,54,2015,10089,39,-1,38,112,143
54085,085,54,2016,9990,-112,17,-95,102,106
54085,085,54,2017,9856,-117,10,-107,90,118
54085,085,54,2018,9774,-36,2,-34,87,134
54085,085,54,2019,9616,-123,18,-105,93,145
54085,085,54,2020,9499,-59,17,-42,90,165
54087,087,54,2010,14897,3,0,3,33,65
54087,087,54,2011,14803,-79,-1,-80,159,173
54087,087,54,2012,14679,-133,0,-133,172,164
54087,087,54,2013,14609,-9,2,-7,147,207
54087,087,54,2014,14597,20,4,24,158,190
54087,087,54,2015,14379,-157,1,-156,140,203
54087,087,54,2016,14122,-201,9,-192,131,196
54087,087,54,2017,14020,-31,5,-26,126,202
54087,087,54,2018,13880,-28,0,-28,141,252
54087,087,54,2019,13651,-174,9,-165,123,186
54087,087,54,2020,13482,-96,8,-88,122,203
54089,089,54,2010,13939,18,0,18,29,33
54089,089,54,2011,13857,2,3,5,127,213
54089,089,54,2012,13838,47,0,47,116,179
54089,089,54,2013,13597,-170,0,-170,111,186
54089,089,54,2014,13344,-150,-2,-152,97,199
54089,089,54,2015,13150,-91,-2,-93,96,200
54089,089,54,2016,13003,-77,-1,-78,129,197
54089,089,54,2017,12897,11,-1,10,94,210
54089,089,54,2018,12668,-130,-1,-131,108,206
54089,089,54,2019,12536,-54,-1,-55,100,175
54089,089,54,2020,12444,-19,-1,-20,94,166
54091,091,54,2010,16876,19,0,19,51,69
54091,091,54,2011,16919,74,0,74,172,203
54091,091,54,2012,16960,57,0,57,182,197
54091,091,54,2013,16978,18,4,22,183,186
54091,091,54,2014,17091,113,5,118,177,181
54091,091,54,2015,16920,-135,7,-128,163,204
54091,091,54,2016,16952,30,4,34,189,190
54091,091,54,2017,16907,-7,1,-6,162,200
54091,091,54,2018,16820,-9,1,-8,122,201
54091,091,54,2019,16707,-58,2,-56,147,204
54091,091,54,2020,16699,76,1,77,138,223
54093,093,54,2010,7129,-13,0,-13,21,19
54093,093,54,2011,7130,35,0,35,60,94
54093,093,54,2012,7079,-14,0,-14,57,93
54093,093,54,2013,7079,7,0,7,76,83
54093,093,54,2014,7050,3,0,3,62,92
54093,093,54,2015,7088,43,0,43,69,75
54093,093,54,2016,7056,-7,0,-7,71,95
54093,093,54,2017,6994,-49,0,-49,77,89
54093,093,54,2018,6957,0,0,0,54,91
54093,093,54,2019,6891,-19,0,-19,52,99
54093,093,54,2020,6816,7,0,7,54,136
54095,095,54,2010,9215,-21,0,-21,21,13
54095,095,54,2011,9117,-10,0,-10,74,161
54095,095,54,2012,9052,-31,0,-31,92,126
54095,095,54,2013,9005,-31,0,-31,103,117
54095,095,54,2014,9084,104,0,104,88,116
54095,095,54,2015,8959,-102,6,-96,88,118
54095,095,54,2016,8972,31,7,38,94,119
54095,095,54,2017,8803,-140,5,-135,77,111
54095,095,54,2018,8749,-30,-1,-31,92,115
54095,095,54,2019,8622,-107,9,-98,80,109
54095,095,54,2020,8533,-58,7,-51,80,117
54097,097,54,2010,24242,2,0,2,65,82
54097,097,54,2011,24279,44,-2,42,256,261
54097,097,54,2012,24456,159,-6,153,277,254
54097,097,54,2013,24619,107,2,109,313,257
54097,097,54,2014,24686,68,6,74,265,267
54097,097,54,2015,24756,30,22,52,269,248
54097,097,54,2016,24699,-32,20,-12,261,305
54097,097,54,2017,24589,-103,9,-94,260,275
54097,097,54,2018,24424,-112,4,-108,232,287
54097,097,54,2019,24315,-119,20,-99,258,268
54097,097,54,2020,24230,-38,15,-23,242,304
54099,099,54,2010,42501,-44,2,-42,98,93
54099,099,54,2011,42234,-169,13,-156,382,492
54099,099,54,2012,41933,-253,10,-243,387,447
54099,099,54,2013,41890,-39,-4,-43,477,470
54099,099,54,2014,41574,-297,0,-297,467,489
54099,099,54,2015,41272,-183,-1,-184,419,535
54099,099,54,2016,40807,-395,9,-386,435,515
54099,099,54,2017,40301,-389,13,-376,406,536
54099,099,54,2018,40046,-34,-2,-36,346,563
54099,099,54,2019,39552,-346,26,-320,337,510
54099,099,54,2020,39054,-263,20,-243,327,582
54101,101,54,2010,9151,15,1,16,27,40
54101,101,54,2011,9123,-41,6,-35,109,102
54101,101,54,2012,8981,-127,5,-122,106,126
54101,101,54,2013,8832,-104,2,-102,88,136
54101,101,54,2014,8750,-65,0,-65,98,115
54101,101,54,2015,8635,-78,0,-78,90,128
54101,101,54,2016,8554,-30,0,-30,79,129
54101,101,54,2017,8349,-162,0,-162,82,125
54101,101,54,2018,8304,-6,0,-6,87,125
54101,101,54,2019,8179,-90,0,-90,80,115
54101,101,54,2020,8058,-75,0,-75,82,128
54103,103,54,2010,16537,1,1,2,36,65
54103,103,54,2011,16370,-132,7,-125,172,215
54103,103,54,2012,16345,44,1,45,173,238
54103,103,54,2013,16114,-177,0,-177,170,227
54103,103,54,2014,15962,-96,-1,-97,153,209
54103,103,54,2015,15783,-136,0,-136,182,225
54103,103,54,2016,15673,-122,6,-116,193,188
54103,103,54,2017,15444,-144,1,-143,145,231
54103,103,54,2018,15302,-80,0,-80,181,243
54103,103,54,2019,15130,-93,5,-88,158,242
54103,103,54,2020,14904,-144,5,-139,168,255
54105,105,54,2010,5721,11,0,11,24,23
54105,105,54,2011,5751,23,8,31,58,60
54105,105,54,2012,5770,27,0,27,55,62
54105,105,54,2013,5834,55,0,55,60,50
54105,105,54,2014,5786,-40,0,-40,58,66
54105,105,54,2015,5798,31,0,31,57,74
54105,105,54,2016,5759,-41,0,-41,54,53
54105,105,54,2017,5781,22,0,22,60,60
54105,105,54,2018,5794,31,0,31,54,70
54105,105,54,2019,5783,-2,0,-2,49,58
54105,105,54,2020,5705,-71,0,-71,52,58
54107,107,54,2010,86976,46,-2,44,262,275
54107,107,54,2011,86913,-19,15,-4,994,1048
54107,107,54,2012,86655,-149,8,-141,887,987
54107,107,54,2013,86577,-33,-9,-42,989,1012
54107,107,54,2014,86533,-19,-8,-27,1043,1038
54107,107,54,2015,86410,22,5,27,990,1128
54107,107,54,2016,85824,-486,10,-476,990,1098
54107,107,54,2017,85163,-470,-4,-474,900,1085
54107,107,54,2018,84343,-655,-11,-666,935,1091
54107,107,54,2019,83668,-435,0,-435,892,1132
54107,107,54,2020,82938,-445,3,-442,870,1159
54109,109,54,2010,23728,-28,0,-28,54,100
54109,109,54,2011,23462,-187,0,-187,272,352
54109,109,54,2012,23213,-163,0,-163,244,333
54109,109,54,2013,22943,-165,0,-165,230,332
54109,109,54,2014,22582,-266,0,-266,220,323
54109,109,54,2015,22179,-302,0,-302,217,322
54109,109,54,2016,21777,-267,3,-264,202,340
54109,109,54,2017,21275,-395,1,-394,207,317
54109,109,54,2018,20828,-302,0,-302,191,338
54109,109,54,2019,20449,-202,1,-201,166,343
54109,109,54,2020,20123,-123,1,-122,168,373
55001,001,55,2010,20878,18,-1,17,35,42
55001,001,55,2011,20767,34,-2,32,120,263
55001,001,55,2012,20411,-254,3,-251,122,229
55001,001,55,2013,20407,100,6,106,145,255
55001,001,55,2014,20120,-134,4,-130,132,285
55001,001,55,2015,20027,-12,11,-1,140,232
55001,001,55,2016,19984,93,14,107,126,275
55001,001,55,2017,19905,40,12,52,128,258
55001,001,55,2018,20386,604,15,619,120,260
55001,001,55,2019,20268,16,8,24,135,275
55001,001,55,2020,20498,360,8,368,133,268
55003,003,55,2010,16142,11,0,11,37,62
55003,003,55,2011,16025,-97,-1,-98,181,200
55003,003,55,2012,15835,-219,8,-211,178,162
55003,003,55,2013,15968,116,12,128,185,181
55003,003,55,2014,15996,28,9,37,186,191
55003,003,55,2015,15808,-169,4,-165,179,204
55003,003,55,2016,15637,-182,8,-174,179,176
55003,003,55,2017,15507,-124,10,-114,173,189
55003,003,55,2018,15553,77,6,83,174,209
55003,003,55,2019,15506,-39,7,-32,164,179
55003,003,55,2020,15415,-67,6,-61,158,190
55005,005,55,2010,45816,-49,6,-43,131,145
55005,005,55,2011,45892,47,21,68,521,510
55005,005,55,2012,45784,-202,28,-174,572,500
55005,005,55,2013,45585,-243,36,-207,514,505
55005,005,55,2014,45355,-260,27,-233,492,492
55005,005,55,2015,45375,-30,28,-2,518,489
55005,005,55,2016,45271,-132,36,-96,494,501
55005,005,55,2017,45201,-73,51,-22,469,513
55005,005,55,2018,45123,-63,30,-33,504,547
55005,005,55,2019,45226,97,40,137,495,528
55005,005,55,2020,45090,-117,31,-86,483,534
55007,007,55,2010,15001,21,0,21,30,57
55007,007,55,2011,15061,75,7,82,121,143
55007,007,55,2012,15060,-5,4,-1,139,136
55007,007,55,2013,15115,93,8,101,115,160
55007,007,55,2014,14975,-100,6,-94,121,164
55007,007,55,2015,14980,22,4,26,133,153
55007,007,55,2016,14926,19,4,23,116,192
55007,007,55,2017,15013,129,5,134,107,153
55007,007,55,2018,15086,98,2,100,141,167
55007,007,55,2019,15172,111,4,115,129,158
55007,007,55,2020,15242,127,3,130,130,188
55009,009,55,2010,248474,-52,79,27,879,416
55009,009,55,2011,250496,193,274,467,3345,1780
55009,009,55,2012,252700,334,313,647,3453,1839
55009,009,55,2013,254249,-328,376,48,3388,1854
55009,009,55,2014,256254,-64,391,327,3483,1756
55009,009,55,2015,257916,-31,413,382,3327,2018
55009,009,55,2016,259588,-98,365,267,3405,1987
55009,009,55,2017,261714,598,342,940,3290,2089
55009,009,55,2018,262985,-365,434,69,3263,2058
55009,009,55,2019,263899,-291,98,-193,3119,2020
55009,009,55,2020,264610,-499,155,-344,3101,2062
55011,011,55,2010,13551,-18,0,-18,33,52
55011,011,55,2011,13441,-91,0,-91,129,147
55011,011,55,2012,13344,-133,5,-128,144,116
55011,011,55,2013,13367,-17,2,-15,158,118
55011,011,55,2014,13234,-125,5,-120,124,138
55011,011,55,2015,13245,-37,7,-30,153,112
55011,011,55,2016,13148,-146,5,-141,165,121
55011,011,55,2017,13115,-23,6,-17,122,137
55011,011,55,2018,13126,11,11,22,133,143
55011,011,55,2019,13012,-107,4,-103,116,127
55011,011,55,2020,13033,32,1,33,122,134
55013,013,55,2010,15430,-7,0,-7,31,52
55013,013,55,2011,15464,31,4,35,141,140
55013,013,55,2012,15339,-94,4,-90,137,172
55013,013,55,2013,15266,-25,5,-20,127,176
55013,013,55,2014,15229,34,2,36,116,191
55013,013,55,2015,15140,-35,2,-33,136,189
55013,013,55,2016,15235,124,2,126,155,185
55013,013,55,2017,15297,131,1,132,124,195
55013,013,55,2018,15334,118,0,118,124,206
55013,013,55,2019,15390,112,1,113,119,175
55013,013,55,2020,15557,234,0,234,117,182
55015,015,55,2010,49041,-43,2,-41,156,53
55015,015,55,2011,49623,261,8,269,592,278
55015,015,55,2012,49653,-296,19,-277,600,297
55015,015,55,2013,49649,-264,18,-246,545,305
55015,015,55,2014,49480,-323,19,-304,519,388
55015,015,55,2015,49823,72,26,98,540,289
55015,015,55,2016,49606,-366,11,-355,497,359
55015,015,55,2017,49988,246,12,258,490,363
55015,015,55,2018,50111,35,9,44,471,391
55015,015,55,2019,50112,-150,8,-142,484,340
55015,015,55,2020,50209,-17,9,-8,477,373
55017,017,55,2010,62646,53,4,57,170,86
55017,017,55,2011,62958,59,1,60,762,508
55017,017,55,2012,63063,-164,5,-159,770,499
55017,017,55,2013,63102,-93,15,-78,698,571
55017,017,55,2014,63349,133,14,147,700,586
55017,017,55,2015,63438,-17,12,-5,728,628
55017,017,55,2016,63577,30,6,36,741,632
55017,017,55,2017,63774,115,6,121,657,577
55017,017,55,2018,64095,273,0,273,645,597
55017,017,55,2019,64692,503,5,508,685,595
55017,017,55,2020,64737,-8,3,-5,689,641
55019,019,55,2010,34670,-46,2,-44,152,118
55019,019,55,2011,34670,-263,3,-260,581,320
55019,019,55,2012,34433,-510,15,-495,560,314
55019,019,55,2013,34529,-171,4,-167,593,334
55019,019,55,2014,34348,-387,6,-381,558,361
55019,019,55,2015,34350,-207,11,-196,539,341
55019,019,55,2016,34512,-133,27,-106,605,335
55019,019,55,2017,34588,-184,32,-152,575,346
55019,019,55,2018,34737,-107,49,-58,564,356
55019,019,55,2019,34785,-208,11,-197,576,332
55019,019,55,2020,34720,-320,15,-305,579,338
55021,021,55,2010,56854,20,0,20,137,153
55021,021,55,2011,56712,-259,4,-255,628,513
55021,021,55,2012,56476,-316,12,-304,578,513
55021,021,55,2013,56577,-38,25,-13,626,510
55021,021,55,2014,56645,-5,25,20,615,554
55021,021,55,2015,56683,6,29,35,571,561
55021,021,55,2016,56907,120,40,160,622,555
55021,021,55,2017,57267,244,32,276,600,515
55021,021,55,2018,57275,11,17,28,580,597
55021,021,55,2019,57537,156,22,178,606,523
55021,021,55,2020,57668,95,16,111,592,575
55023,023,55,2010,16629,-17,0,-17,52,45
55023,023,55,2011,16673,79,2,81,144,180
55023,023,55,2012,16510,-142,1,-141,174,196
55023,023,55,2013,16384,-118,5,-113,159,172
55023,023,55,2014,16339,-58,7,-51,175,167
55023,023,55,2015,16315,-7,8,1,142,165
55023,023,55,2016,16241,-68,5,-63,165,175
55023,023,55,2017,16182,-55,6,-49,168,177
55023,023,55,2018,16211,70,1,71,141,181
55023,023,55,2019,16121,-98,3,-95,166,160
55023,023,55,2020,16021,-64,1,-63,154,191
55025,025,55,2010,489247,15,306,321,1601,718
55025,025,55,2011,496121,2626,1235,3861,5982,2981
55025,025,55,2012,503087,2348,1426,3774,6108,2917
55025,025,55,2013,510026,1876,2077,3953,6144,3164
55025,025,55,2014,516602,1604,1929,3533,6304,3230
55025,025,55,2015,523399,1403,2460,3863,6184,3225
55025,025,55,2016,531775,3274,2039,5313,6196,3145
55025,025,55,2017,537901,1390,2085,3475,5984,3330
55025,025,55,2018,542448,1086,1121,2207,5777,3438
55025,025,55,2019,547637,1314,1464,2778,5733,3348
55025,025,55,2020,552536,1523,1178,2701,5729,3565
55027,027,55,2010,88723,-45,12,-33,225,208
55027,027,55,2011,88392,-320,34,-286,860,904
55027,027,55,2012,88154,-268,45,-223,818,824
55027,027,55,2013,87953,-170,26,-144,846,895
55027,027,55,2014,88085,107,14,121,855,824
55027,027,55,2015,87838,-111,24,-87,816,970
55027,027,55,2016,87365,-359,23,-336,777,911
55027,027,55,2017,87724,479,29,508,818,962
55027,027,55,2018,87796,207,23,230,780,934
55027,027,55,2019,87626,-24,14,-10,773,934
55027,027,55,2020,87336,-113,15,-98,772,966
55029,029,55,2010,27749,-34,4,-30,58,59
55029,029,55,2011,27766,121,-2,119,203,303
55029,029,55,2012,27538,-124,6,-118,209,319
55029,029,55,2013,27614,225,3,228,197,350
55029,029,55,2014,27478,-28,1,-27,212,313
55029,029,55,2015,27320,-13,6,-7,210,357
55029,029,55,2016,27354,136,7,143,233,340
55029,029,55,2017,27473,264,8,272,210,362
55029,029,55,2018,27638,272,6,278,219,333
55029,029,55,2019,27752,223,5,228,204,316
55029,029,55,2020,27889,300,2,302,203,364
55031,031,55,2010,44137,-12,2,-10,117,124
55031,031,55,2011,43968,-212,18,-194,468,443
55031,031,55,2012,43770,-311,32,-279,479,400
55031,031,55,2013,43792,-28,58,30,425,425
55031,031,55,2014,43686,-128,35,-93,417,424
55031,031,55,2015,43553,-193,53,-140,398,387
55031,031,55,2016,43471,-135,49,-86,447,442
55031,031,55,2017,43451,-87,54,-33,421,405
55031,031,55,2018,43353,-81,11,-70,404,430
55031,031,55,2019,43506,122,38,160,414,422
55031,031,55,2020,43702,202,31,233,401,438
55033,033,55,2010,43888,0,-1,-1,120,92
55033,033,55,2011,43808,-266,10,-256,471,296
55033,033,55,2012,43818,-170,37,-133,433,285
55033,033,55,2013,44064,76,60,136,441,323
55033,033,55,2014,44100,-158,52,-106,467,328
55033,033,55,2015,44300,-1,75,74,465,335
55033,033,55,2016,44389,-77,59,-18,436,328
55033,033,55,2017,44784,207,67,274,480,360
55033,033,55,2018,45135,295,27,322,408,379
55033,033,55,2019,45384,113,45,158,419,329
55033,033,55,2020,45452,-31,38,7,407,348
55035,035,55,2010,99012,-4,11,7,283,141
55035,035,55,2011,99952,478,58,536,1132,731
55035,035,55,2012,100862,405,96,501,1189,772
55035,035,55,2013,101775,381,157,538,1176,799
55035,035,55,2014,101745,-548,139,-409,1221,841
55035,035,55,2015,102142,-53,129,76,1232,899
55035,035,55,2016,102989,379,161,540,1207,897
55035,035,55,2017,103671,207,151,358,1207,879
55035,035,55,2018,104276,239,99,338,1133,862
55035,035,55,2019,104466,-210,120,-90,1127,849
55035,035,55,2020,105260,438,99,537,1094,841
55037,037,55,2010,4398,-8,0,-8,5,23
55037,037,55,2011,4383,17,-2,15,27,56
55037,037,55,2012,4369,3,0,3,30,45
55037,037,55,2013,4387,42,0,42,27,52
55037,037,55,2014,4347,-31,0,-31,31,40
55037,037,55,2015,4343,24,0,24,22,50
55037,037,55,2016,4322,12,0,12,32,64
55037,037,55,2017,4345,58,0,58,35,70
55037,037,55,2018,4295,-6,0,-6,28,73
55037,037,55,2019,4300,29,0,29,28,51
55037,037,55,2020,4298,30,0,30,25,57
55039,039,55,2010,101579,-108,12,-96,304,253
55039,039,55,2011,101822,-12,77,65,1097,916
55039,039,55,2012,101802,-346,120,-226,1123,911
55039,039,55,2013,101808,-347,208,-139,1126,976
55039,039,55,2014,101993,-124,191,67,1068,941
55039,039,55,2015,101970,-341,187,-154,1075,940
55039,039,55,2016,102189,-77,111,34,1076,887
55039,039,55,2017,102324,-102,106,4,1084,949
55039,039,55,2018,102777,415,57,472,1000,1015
55039,039,55,2019,103079,117,62,179,1088,966
55039,039,55,2020,102902,-290,65,-225,1042,998
55041,041,55,2010,9294,-4,0,-4,30,35
55041,041,55,2011,9249,-30,2,-28,95,111
55041,041,55,2012,9162,-84,2,-82,116,122
55041,041,55,2013,9097,-62,2,-60,114,119
55041,041,55,2014,9112,0,3,3,123,108
55041,041,55,2015,9015,-95,3,-92,110,116
55041,041,55,2016,9040,30,3,33,116,124
55041,041,55,2017,8981,-45,2,-43,107,122
55041,041,55,2018,9001,59,-1,58,82,120
55041,041,55,2019,9034,44,-1,43,104,112
55041,041,55,2020,8960,-50,1,-49,97,122
55043,043,55,2010,51234,-4,4,0,144,107
55043,043,55,2011,51186,-96,9,-87,531,491
55043,043,55,2012,50880,-408,23,-385,546,475
55043,043,55,2013,51011,37,50,87,525,472
55043,043,55,2014,51708,593,31,624,535,488
55043,043,55,2015,52103,325,44,369,577,551
55043,043,55,2016,52044,-204,31,-173,597,481
55043,043,55,2017,51773,-345,33,-312,542,502
55043,043,55,2018,51501,-387,15,-372,613,515
55043,043,55,2019,51509,-81,24,-57,533,469
55043,043,55,2020,51021,-534,16,-518,557,526
55045,045,55,2010,36858,-4,10,6,110,93
55045,045,55,2011,36853,-92,36,-56,393,342
55045,045,55,2012,36760,-176,50,-126,374,341
55045,045,55,2013,36933,35,40,75,422,319
55045,045,55,2014,36856,-112,40,-72,349,352
55045,045,55,2015,36928,-19,33,14,400,337
55045,045,55,2016,36782,-169,14,-155,378,369
55045,045,55,2017,36843,6,11,17,367,321
55045,045,55,2018,36867,22,13,35,361,369
55045,045,55,2019,36853,-18,9,-9,346,350
55045,045,55,2020,36603,-221,3,-218,343,374
55047,047,55,2010,19016,-9,1,-8,51,72
55047,047,55,2011,19055,22,1,23,212,194
55047,047,55,2012,19000,-14,-3,-17,191,226
55047,047,55,2013,18885,-98,1,-97,221,240
55047,047,55,2014,18757,-109,5,-104,192,217
55047,047,55,2015,18703,11,-2,9,191,250
55047,047,55,2016,18616,-77,2,-75,214,226
55047,047,55,2017,18731,171,3,174,198,255
55047,047,55,2018,18869,174,3,177,199,237
55047,047,55,2019,18910,68,2,70,196,223
55047,047,55,2020,18908,39,2,41,193,237
55049,049,55,2010,23694,-8,1,-7,72,59
55049,049,55,2011,23586,-182,3,-179,291,221
55049,049,55,2012,23585,-78,5,-73,282,206
55049,049,55,2013,23565,-90,7,-83,257,194
55049,049,55,2014,23594,-29,12,-17,259,207
55049,049,55,2015,23597,-38,6,-32,228,193
55049,049,55,2016,23471,-188,6,-182,299,242
55049,049,55,2017,23692,166,3,169,263,210
55049,049,55,2018,23709,-51,5,-46,256,192
55049,049,55,2019,23648,-130,2,-128,249,183
55049,049,55,2020,23640,-49,2,-47,243,205
55051,051,55,2010,5925,8,0,8,11,10
55051,051,55,2011,5959,74,0,74,40,79
55051,051,55,2012,5888,-14,0,-14,34,90
55051,051,55,2013,5829,-3,0,-3,38,93
55051,051,55,2014,5860,87,0,87,39,95
55051,051,55,2015,5724,-102,1,-101,36,73
55051,051,55,2016,5656,-10,1,-9,29,87
55051,051,55,2017,5675,69,1,70,35,86
55051,051,55,2018,5671,53,0,53,30,88
55051,051,55,2019,5688,51,0,51,44,77
55051,051,55,2020,5698,67,0,67,37,95
55053,053,55,2010,20464,-1,1,0,56,29
55053,053,55,2011,20522,16,2,18,238,197
55053,053,55,2012,20500,-76,3,-73,248,197
55053,053,55,2013,20561,38,-2,36,240,212
55053,053,55,2014,20584,-6,4,-2,246,217
55053,053,55,2015,20526,-104,4,-100,275,232
55053,053,55,2016,20484,-106,10,-96,242,187
55053,053,55,2017,20496,-16,12,-4,236,220
55053,053,55,2018,20494,-23,27,4,210,215
55053,053,55,2019,20676,126,7,133,248,197
55053,053,55,2020,20630,-90,2,-88,235,193
55055,055,55,2010,83727,-76,18,-58,229,130
55055,055,55,2011,83854,-202,18,-184,940,627
55055,055,55,2012,84367,185,48,233,890,597
55055,055,55,2013,84613,-32,48,16,878,632
55055,055,55,2014,84370,-543,51,-492,920,674
55055,055,55,2015,84501,-101,44,-57,847,651
55055,055,55,2016,84494,-201,36,-165,857,697
55055,055,55,2017,84733,83,21,104,842,702
55055,055,55,2018,85091,234,20,254,851,743
55055,055,55,2019,84829,-350,5,-345,778,697
55055,055,55,2020,85038,170,10,180,774,749
55057,057,55,2010,26675,-1,1,0,62,49
55057,057,55,2011,26705,26,7,33,266,268
55057,057,55,2012,26775,70,7,77,273,276
55057,057,55,2013,26571,-195,5,-190,297,312
55057,057,55,2014,26349,-181,5,-176,248,293
55057,057,55,2015,26319,-58,7,-51,293,269
55057,057,55,2016,26345,61,7,68,266,307
55057,057,55,2017,26474,145,4,149,291,310
55057,057,55,2018,26599,155,4,159,261,293
55057,057,55,2019,26688,100,1,101,270,284
55057,057,55,2020,26908,261,2,263,254,294
55059,059,55,2010,166629,-76,26,-50,525,262
55059,059,55,2011,166871,-516,62,-454,2028,1332
55059,059,55,2012,167273,-200,75,-125,1948,1393
55059,059,55,2013,167380,-549,81,-468,1976,1395
55059,059,55,2014,167938,-106,113,7,1989,1409
55059,059,55,2015,168044,-505,148,-357,1903,1432
55059,059,55,2016,168012,-657,81,-576,1922,1376
55059,059,55,2017,168492,8,74,82,1876,1471
55059,059,55,2018,169054,135,62,197,1878,1507
55059,059,55,2019,169760,314,-29,285,1833,1417
55059,059,55,2020,169671,-411,8,-403,1802,1497
55061,061,55,2010,20561,-1,0,-1,42,55
55061,061,55,2011,20556,-45,1,-44,205,166
55061,061,55,2012,20504,-105,4,-101,206,160
55061,061,55,2013,20374,-136,7,-129,194,197
55061,061,55,2014,20347,-54,11,-43,209,191
55061,061,55,2015,20329,-26,14,-12,182,187
55061,061,55,2016,20378,-3,20,17,196,163
55061,061,55,2017,20406,18,15,33,201,204
55061,061,55,2018,20367,-24,16,-8,174,204
55061,061,55,2019,20451,41,10,51,213,181
55061,061,55,2020,20386,-63,8,-55,190,199
55063,063,55,2010,114879,94,29,123,362,238
55063,063,55,2011,115255,3,66,69,1299,988
55063,063,55,2012,116581,933,59,992,1258,947
55063,063,55,2013,116938,70,96,166,1218,1011
55063,063,55,2014,117508,204,61,265,1267,943
55063,063,55,2015,117782,-51,63,12,1268,990
55063,063,55,2016,117804,-265,50,-215,1240,1000
55063,063,55,2017,118161,133,46,179,1204,1019
55063,063,55,2018,118220,-71,9,-62,1155,1032
55063,063,55,2019,118151,-220,31,-189,1144,1026
55063,063,55,2020,118502,251,25,276,1147,1080
55065,065,55,2010,16799,-46,1,-45,40,22
55065,065,55,2011,16853,-20,0,-20,208,132
55065,065,55,2012,16792,-137,-3,-140,204,129
55065,065,55,2013,16662,-207,2,-205,211,140
55065,065,55,2014,16769,23,2,25,220,135
55065,065,55,2015,16785,-93,1,-92,232,125
55065,065,55,2016,16751,-102,6,-96,215,152
55065,065,55,2017,16688,-142,2,-140,205,127
55065,065,55,2018,16659,-92,10,-82,208,154
55065,065,55,2019,16667,-74,-1,-75,221,139
55065,065,55,2020,16646,-86,0,-86,221,156
55067,067,55,2010,19964,-9,4,-5,58,63
55067,067,55,2011,19794,-155,7,-148,193,216
55067,067,55,2012,19621,-165,7,-158,209,225
55067,067,55,2013,19415,-150,12,-138,178,249
55067,067,55,2014,19258,-140,18,-122,202,237
55067,067,55,2015,19051,-133,20,-113,173,265
55067,067,55,2016,19087,53,18,71,191,225
55067,067,55,2017,19184,90,17,107,218,227
55067,067,55,2018,19239,71,16,87,169,200
55067,067,55,2019,19208,-24,9,-15,219,235
55067,067,55,2020,19119,-31,12,-19,200,270
55069,069,55,2010,28777,9,-1,8,81,50
55069,069,55,2011,28503,-213,1,-212,263,326
55069,069,55,2012,28501,56,1,57,273,326
55069,069,55,2013,28301,-114,2,-112,269,359
55069,069,55,2014,28105,-129,3,-126,270,338
55069,069,55,2015,27864,-158,6,-152,246,335
55069,069,55,2016,27844,28,4,32,292,342
55069,069,55,2017,27745,-9,1,-8,249,337
55069,069,55,2018,27686,6,0,6,282,346
55069,069,55,2019,27596,-33,0,-33,256,314
55069,069,55,2020,27566,41,0,41,252,323
55071,071,55,2010,81330,-135,8,-127,199,188
55071,071,55,2011,81035,-350,39,-311,839,822
55071,071,55,2012,80720,-460,60,-400,854,773
55071,071,55,2013,80487,-240,62,-178,820,871
55071,071,55,2014,79950,-558,58,-500,817,859
55071,071,55,2015,79488,-398,71,-327,786,917
55071,071,55,2016,79363,-109,51,-58,815,877
55071,071,55,2017,79056,-218,31,-187,777,895
55071,071,55,2018,78925,-53,44,-9,791,912
55071,071,55,2019,78785,-60,21,-39,745,843
55071,071,55,2020,78757,89,19,108,754,889
55073,073,55,2010,134064,-141,26,-115,407,298
55073,073,55,2011,134355,-248,36,-212,1656,1150
55073,073,55,2012,134391,-510,64,-446,1624,1142
55073,073,55,2013,134912,20,78,98,1602,1157
55073,073,55,2014,135173,-245,54,-191,1594,1123
55073,073,55,2015,135361,-422,94,-328,1622,1098
55073,073,55,2016,135132,-693,90,-603,1601,1225
55073,073,55,2017,135525,-11,83,72,1568,1238
55073,073,55,2018,135478,-419,74,-345,1530,1231
55073,073,55,2019,135697,-120,58,-62,1518,1238
55073,073,55,2020,135593,-458,45,-413,1532,1228
55075,075,55,2010,41662,-38,1,-37,82,129
55075,075,55,2011,41419,-139,9,-130,394,506
55075,075,55,2012,41360,79,6,85,365,500
55075,075,55,2013,41306,71,11,82,404,533
55075,075,55,2014,41072,-150,7,-143,380,467
55075,075,55,2015,40676,-258,9,-249,358,505
55075,075,55,2016,40298,-266,13,-253,384,508
55075,075,55,2017,40341,122,10,132,394,478
55075,075,55,2018,40401,230,12,242,371,551
55075,075,55,2019,40256,72,4,76,352,573
55075,075,55,2020,40262,211,5,216,353,560
55077,077,55,2010,15372,-7,0,-7,37,54
55077,077,55,2011,15363,15,2,17,171,196
55077,077,55,2012,15237,-118,2,-116,140,150
55077,077,55,2013,15174,-52,1,-51,149,160
55077,077,55,2014,15060,-86,2,-84,160,187
55077,077,55,2015,15112,86,3,89,158,195
55077,077,55,2016,15115,69,3,72,134,203
55077,077,55,2017,15270,199,2,201,121,166
55077,077,55,2018,15393,186,1,187,149,213
55077,077,55,2019,15537,182,2,184,147,187
55077,077,55,2020,15585,81,0,81,150,182
55078,078,55,2010,4270,13,5,18,31,12
55078,078,55,2011,4372,24,18,42,100,39
55078,078,55,2012,4364,-90,11,-79,103,35
55078,078,55,2013,4384,-62,25,-37,88,34
55078,078,55,2014,4508,60,15,75,91,44
55078,078,55,2015,4510,-59,0,-59,96,34
55078,078,55,2016,4531,-29,0,-29,102,52
55078,078,55,2017,4602,31,0,31,90,50
55078,078,55,2018,4596,-39,0,-39,79,46
55078,078,55,2019,4553,-80,0,-80,90,53
55078,078,55,2020,4546,-18,0,-18,85,73
55079,079,55,2010,948289,-1353,369,-984,3598,2013
55079,079,55,2011,951376,-4293,1472,-2821,14177,8259
55079,079,55,2012,954672,-4891,2016,-2875,14248,7999
55079,079,55,2013,957557,-5426,2635,-2791,14002,8256
55079,079,55,2014,958639,-7272,2563,-4709,13966,8152
55079,079,55,2015,958606,-8830,2928,-5902,13980,8113
55079,079,55,2016,955121,-11779,2804,-8975,13711,8237
55079,079,55,2017,950843,-12445,2932,-9513,13506,8294
55079,079,55,2018,947908,-10152,2461,-7691,13308,8561
55079,079,55,2019,947011,-6699,1258,-5441,13060,8513
55079,079,55,2020,945016,-7555,1397,-6158,12911,8761
55081,081,55,2010,44813,33,7,40,165,62
55081,081,55,2011,45059,42,21,63,615,430
55081,081,55,2012,45008,-331,45,-286,662,428
55081,081,55,2013,45123,-36,20,-16,570,431
55081,081,55,2014,45162,-187,21,-166,622,412
55081,081,55,2015,45314,-121,53,-68,607,384
55081,081,55,2016,45505,-42,40,-2,625,430
55081,081,55,2017,45818,86,39,125,606,414
55081,081,55,2018,46197,257,36,293,544,456
55081,081,55,2019,46674,302,18,320,582,426
55081,081,55,2020,46582,-233,23,-210,567,449
55083,083,55,2010,37714,19,0,19,96,53
55083,083,55,2011,37571,-133,4,-129,363,378
55083,083,55,2012,37418,-189,15,-174,348,326
55083,083,55,2013,37364,-81,12,-69,366,347
55083,083,55,2014,37459,102,15,117,329,342
55083,083,55,2015,37474,-26,15,-11,397,367
55083,083,55,2016,37477,-10,14,4,354,353
55083,083,55,2017,37530,75,6,81,350,376
55083,083,55,2018,37901,394,4,398,378,404
55083,083,55,2019,38057,126,4,130,382,355
55083,083,55,2020,38383,341,3,344,388,405
55085,085,55,2010,35949,-25,4,-21,87,123
55085,085,55,2011,35795,-30,10,-20,305,437
55085,085,55,2012,35679,-24,15,-9,325,424
55085,085,55,2013,35562,36,13,49,285,443
55085,085,55,2014,35330,-74,12,-62,281,443
55085,085,55,2015,35307,164,3,167,293,479
55085,085,55,2016,35358,206,3,209,322,478
55085,085,55,2017,35237,40,2,42,288,450
55085,085,55,2018,35449,349,0,349,333,469
55085,085,55,2019,35607,312,1,313,299,454
55085,085,55,2020,35751,316,1,317,309,479
55087,087,55,2010,176843,-81,42,-39,592,316
55087,087,55,2011,177877,-195,132,-63,2354,1253
55087,087,55,2012,178960,-64,185,121,2241,1246
55087,087,55,2013,180301,110,242,352,2272,1253
55087,087,55,2014,182127,631,263,894,2244,1277
55087,087,55,2015,183311,133,221,354,2350,1499
55087,087,55,2016,184606,199,193,392,2348,1437
55087,087,55,2017,185834,205,177,382,2284,1427
55087,087,55,2018,187012,336,124,460,2180,1457
55087,087,55,2019,187927,64,132,196,2211,1495
55087,087,55,2020,188766,32,106,138,2193,1504
55089,089,55,2010,86378,-80,12,-68,206,153
55089,089,55,2011,86811,300,55,355,797,716
55089,089,55,2012,87137,205,72,277,813,752
55089,089,55,2013,87250,-68,103,35,801,719
55089,089,55,2014,87622,144,131,275,785,681
55089,089,55,2015,87991,152,131,283,833,738
55089,089,55,2016,88413,267,128,395,834,802
55089,089,55,2017,88540,-59,118,59,839,767
55089,089,55,2018,89302,722,48,770,820,821
55089,089,55,2019,89597,166,82,248,851,800
55089,089,55,2020,90043,430,68,498,829,879
55091,091,55,2010,7472,-17,0,-17,25,7
55091,091,55,2011,7401,-60,1,-59,70,82
55091,091,55,2012,7373,-60,5,-55,83,59
55091,091,55,2013,7346,-26,1,-25,82,83
55091,091,55,2014,7299,-44,2,-42,77,83
55091,091,55,2015,7238,-69,1,-68,79,72
55091,091,55,2016,7245,6,5,11,73,76
55091,091,55,2017,7246,-23,2,-21,84,61
55091,091,55,2018,7276,21,4,25,82,76
55091,091,55,2019,7265,-44,1,-43,85,54
55091,091,55,2020,7271,12,2,14,78,87
55093,093,55,2010,41091,38,-3,35,100,68
55093,093,55,2011,40906,-352,-6,-358,399,231
55093,093,55,2012,40744,-339,8,-331,400,241
55093,093,55,2013,40845,-107,54,-53,416,261
55093,093,55,2014,41076,77,46,123,359,242
55093,093,55,2015,41117,-128,71,-57,391,291
55093,093,55,2016,41528,246,52,298,407,294
55093,093,55,2017,42075,438,48,486,370,310
55093,093,55,2018,42608,430,32,462,365,296
55093,093,55,2019,42768,26,18,44,382,264
55093,093,55,2020,42700,-156,25,-131,361,302
55095,095,55,2010,44155,-49,3,-46,122,120
55095,095,55,2011,43953,-241,8,-233,431,400
55095,095,55,2012,43522,-508,14,-494,419,367
55095,095,55,2013,43320,-198,12,-186,416,432
55095,095,55,2014,43343,45,9,54,444,464
55095,095,55,2015,43240,-95,16,-79,415,437
55095,095,55,2016,43261,53,9,62,429,465
55095,095,55,2017,43409,152,4,156,421,426
55095,095,55,2018,43578,244,2,246,401,480
55095,095,55,2019,43705,204,2,206,378,457
55095,095,55,2020,43794,183,4,187,387,485
55097,097,55,2010,70025,-48,11,-37,197,151
55097,097,55,2011,70093,-176,31,-145,725,511
55097,097,55,2012,70436,49,75,124,718,485
55097,097,55,2013,70535,-96,105,9,650,549
55097,097,55,2014,70546,-300,127,-173,710,525
55097,097,55,2015,70544,-314,168,-146,703,556
55097,097,55,2016,70483,-349,151,-198,656,519
55097,097,55,2017,70674,-97,165,68,681,557
55097,097,55,2018,70979,41,100,141,683,517
55097,097,55,2019,70943,-286,125,-161,643,521
55097,097,55,2020,71032,-95,102,7,631,551
55099,099,55,2010,14096,-37,0,-37,30,57
55099,099,55,2011,13985,-64,3,-61,107,156
55099,099,55,2012,13846,-108,17,-91,110,160
55099,099,55,2013,13740,-36,21,-15,105,194
55099,099,55,2014,13658,-48,21,-27,120,174
55099,099,55,2015,13577,19,6,25,99,203
55099,099,55,2016,13417,-101,6,-95,116,182
55099,099,55,2017,13377,54,5,59,120,217
55099,099,55,2018,13371,43,1,44,121,169
55099,099,55,2019,13347,46,3,49,101,175
55099,099,55,2020,13245,-41,4,-37,108,171
55101,101,55,2010,195407,-190,26,-164,606,458
55101,101,55,2011,194910,-1411,59,-1352,2497,1646
55101,101,55,2012,194602,-1124,87,-1037,2426,1702
55101,101,55,2013,194694,-575,76,-499,2356,1752
55101,101,55,2014,194821,-656,75,-581,2387,1664
55101,101,55,2015,194725,-777,150,-627,2381,1842
55101,101,55,2016,194915,-506,163,-343,2372,1834
55101,101,55,2017,196026,413,201,614,2380,1869
55101,101,55,2018,196348,-273,247,-26,2284,1932
55101,101,55,2019,196204,-699,23,-676,2346,1817
55101,101,55,2020,195802,-872,82,-790,2267,1885
55103,103,55,2010,18023,-34,0,-34,49,21
55103,103,55,2011,18009,-17,0,-17,178,174
55103,103,55,2012,17815,-197,9,-188,180,188
55103,103,55,2013,17822,-17,16,-1,180,171
55103,103,55,2014,17747,-91,15,-76,177,174
55103,103,55,2015,17568,-176,17,-159,177,197
55103,103,55,2016,17545,-39,19,-20,169,172
55103,103,55,2017,17510,-39,19,-20,190,204
55103,103,55,2018,17416,-61,11,-50,164,208
55103,103,55,2019,17313,-99,16,-83,165,185
55103,103,55,2020,17258,-45,14,-31,162,186
55105,105,55,2010,160261,-249,3,-246,488,309
55105,105,55,2011,159899,-901,-22,-923,1959,1397
55105,105,55,2012,160113,-319,22,-297,1926,1401
55105,105,55,2013,160402,-80,69,-11,1881,1551
55105,105,55,2014,160999,14,88,102,1930,1407
55105,105,55,2015,161095,-509,107,-402,2025,1515
55105,105,55,2016,161363,-180,66,-114,1929,1541
55105,105,55,2017,162278,394,49,443,1993,1513
55105,105,55,2018,162817,212,26,238,1885,1580
55105,105,55,2019,163120,-44,13,-31,1858,1528
55105,105,55,2020,163084,-319,23,-296,1832,1578
55107,107,55,2010,14730,-32,0,-32,36,28
55107,107,55,2011,14615,-93,8,-85,131,162
55107,107,55,2012,14305,-331,19,-312,161,169
55107,107,55,2013,14366,112,21,133,118,189
55107,107,55,2014,14347,10,28,38,152,207
55107,107,55,2015,14119,-183,21,-162,135,203
55107,107,55,2016,14084,-9,4,-5,144,173
55107,107,55,2017,14120,72,7,79,139,181
55107,107,55,2018,14054,-37,5,-32,136,169
55107,107,55,2019,14091,75,5,80,148,191
55107,107,55,2020,14022,-36,4,-32,143,180
55109,109,55,2010,84399,-94,-1,-95,314,151
55109,109,55,2011,84836,-109,-4,-113,1121,571
55109,109,55,2012,85075,-257,20,-237,1010,536
55109,109,55,2013,85700,96,53,149,1032,547
55109,109,55,2014,86599,358,41,399,1054,542
55109,109,55,2015,87207,71,41,112,1071,569
55109,109,55,2016,87643,25,19,44,990,595
55109,109,55,2017,88615,587,17,604,1030,660
55109,109,55,2018,89721,657,26,683,1002,579
55109,109,55,2019,90691,585,-4,581,1015,625
55109,109,55,2020,91838,819,-3,816,995,666
55111,111,55,2010,62051,-3,18,15,202,113
55111,111,55,2011,62241,-28,55,27,770,605
55111,111,55,2012,62377,-97,50,-47,766,573
55111,111,55,2013,62788,187,47,234,751,565
55111,111,55,2014,62972,-1,42,41,766,612
55111,111,55,2015,63290,42,80,122,792,586
55111,111,55,2016,63627,176,59,235,779,674
55111,111,55,2017,63956,191,73,264,768,698
55111,111,55,2018,64306,162,92,254,752,652
55111,111,55,2019,64420,-21,24,3,715,605
55111,111,55,2020,64449,-83,36,-47,725,650
55113,113,55,2010,16553,9,1,10,51,44
55113,113,55,2011,16545,12,1,13,161,181
55113,113,55,2012,16520,0,1,1,171,194
55113,113,55,2013,16479,3,2,5,176,220
55113,113,55,2014,16364,-50,3,-47,163,227
55113,113,55,2015,16297,-27,2,-25,173,213
55113,113,55,2016,16327,90,1,91,164,225
55113,113,55,2017,16378,98,3,101,152,202
55113,113,55,2018,16439,112,2,114,164,218
55113,113,55,2019,16540,150,3,153,132,184
55113,113,55,2020,16700,246,2,248,136,222
55115,115,55,2010,41938,8,4,12,120,143
55115,115,55,2011,41669,-255,18,-237,429,461
55115,115,55,2012,41512,-194,13,-181,431,406
55115,115,55,2013,41408,-37,10,-27,432,504
55115,115,55,2014,41349,-55,14,-41,423,435
55115,115,55,2015,41058,-286,14,-272,444,463
55115,115,55,2016,40927,-65,5,-60,394,462
55115,115,55,2017,40832,-51,8,-43,455,504
55115,115,55,2018,40725,-76,8,-68,442,479
55115,115,55,2019,40794,92,5,97,445,472
55115,115,55,2020,40786,9,4,13,430,452
55117,117,55,2010,115520,-153,25,-128,365,225
55117,117,55,2011,115209,-672,57,-615,1326,1023
55117,117,55,2012,114770,-727,90,-637,1248,1062
55117,117,55,2013,114702,-312,121,-191,1291,1163
55117,117,55,2014,114994,44,118,162,1176,1024
55117,117,55,2015,115209,-31,102,71,1279,1123
55117,117,55,2016,115043,-414,82,-332,1292,1123
55117,117,55,2017,115085,-78,71,-7,1229,1175
55117,117,55,2018,115161,-72,35,-37,1244,1127
55117,117,55,2019,115232,-73,42,-31,1215,1114
55117,117,55,2020,115240,-122,48,-74,1229,1150
55119,119,55,2010,20660,-31,2,-29,65,66
55119,119,55,2011,20656,-49,2,-47,234,190
55119,119,55,2012,20369,-378,7,-371,218,153
55119,119,55,2013,20422,25,1,26,211,182
55119,119,55,2014,20414,-75,10,-65,225,170
55119,119,55,2015,20314,-167,14,-153,234,182
55119,119,55,2016,20295,-78,7,-71,247,193
55119,119,55,2017,20302,-25,6,-19,209,183
55119,119,55,2018,20346,25,5,30,218,202
55119,119,55,2019,20340,-46,6,-40,210,176
55119,119,55,2020,20318,-44,4,-40,212,193
55121,121,55,2010,28846,15,7,22,96,83
55121,121,55,2011,28994,7,10,17,375,245
55121,121,55,2012,29294,152,28,180,397,271
55121,121,55,2013,29468,51,17,68,415,305
55121,121,55,2014,29417,-214,19,-195,395,252
55121,121,55,2015,29444,-147,27,-120,411,264
55121,121,55,2016,29531,-34,28,-6,407,313
55121,121,55,2017,29352,-345,18,-327,444,296
55121,121,55,2018,29479,-50,45,-5,430,298
55121,121,55,2019,29583,-29,14,-15,406,287
55121,121,55,2020,29681,-37,12,-25,404,281
55123,123,55,2010,29771,-18,0,-18,113,95
55123,123,55,2011,29874,1,2,3,393,290
55123,123,55,2012,30029,18,8,26,413,279
55123,123,55,2013,30101,-117,7,-110,445,263
55123,123,55,2014,30199,-31,4,-27,417,286
55123,123,55,2015,30331,10,7,17,437,318
55123,123,55,2016,30554,109,6,115,396,287
55123,123,55,2017,30729,79,12,91,409,321
55123,123,55,2018,30775,-81,5,-76,428,306
55123,123,55,2019,30877,-51,7,-44,429,283
55123,123,55,2020,30861,-102,4,-98,409,329
55125,125,55,2010,21454,38,0,38,56,82
55125,125,55,2011,21414,65,6,71,168,278
55125,125,55,2012,21315,10,13,23,176,294
55125,125,55,2013,21401,173,24,197,173,288
55125,125,55,2014,21422,84,21,105,193,274
55125,125,55,2015,21455,133,17,150,192,308
55125,125,55,2016,21488,153,7,160,160,285
55125,125,55,2017,21667,332,4,336,173,330
55125,125,55,2018,21949,351,2,353,195,269
55125,125,55,2019,22153,354,2,356,176,327
55125,125,55,2020,22356,358,2,360,179,332
55127,127,55,2010,102195,-145,22,-123,292,196
55127,127,55,2011,102641,312,-20,292,1022,865
55127,127,55,2012,102881,70,10,80,1031,849
55127,127,55,2013,102805,-188,28,-160,1038,941
55127,127,55,2014,103190,285,31,316,1028,937
55127,127,55,2015,102508,-866,42,-824,1090,954
55127,127,55,2016,102668,3,19,22,1013,873
55127,127,55,2017,102890,233,13,246,937,955
55127,127,55,2018,103547,701,5,706,911,961
55127,127,55,2019,103898,360,-14,346,966,963
55127,127,55,2020,103953,149,-9,140,933,1021
55129,129,55,2010,15927,8,0,8,35,22
55129,129,55,2011,15838,-35,2,-33,161,217
55129,129,55,2012,15844,73,3,76,154,220
55129,129,55,2013,15655,-109,8,-101,149,236
55129,129,55,2014,15654,33,10,43,159,200
55129,129,55,2015,15515,-96,9,-87,147,197
55129,129,55,2016,15587,160,5,165,115,208
55129,129,55,2017,15728,196,5,201,149,210
55129,129,55,2018,15841,178,3,181,132,199
55129,129,55,2019,15764,-25,4,-21,136,191
55129,129,55,2020,15712,67,3,70,117,238
55131,131,55,2010,131990,-24,14,-10,373,251
55131,131,55,2011,132341,-46,34,-12,1387,1021
55131,131,55,2012,132743,58,85,143,1317,1036
55131,131,55,2013,132938,-166,108,-58,1294,1037
55131,131,55,2014,133610,249,104,353,1398,1053
55131,131,55,2015,133920,66,93,159,1324,1159
55131,131,55,2016,134324,117,70,187,1346,1121
55131,131,55,2017,134961,395,64,459,1356,1168
55131,131,55,2018,135615,535,36,571,1280,1189
55131,131,55,2019,136302,535,43,578,1293,1181
55131,131,55,2020,136445,77,41,118,1280,1259
55133,133,55,2010,390051,-155,71,-84,961,777
55133,133,55,2011,390895,-204,305,101,3810,3061
55133,133,55,2012,392893,1000,386,1386,3804,3100
55133,133,55,2013,394257,229,595,824,3755,3184
55133,133,55,2014,395518,138,585,723,3861,3273
55133,133,55,2015,396377,-186,641,455,3802,3369
55133,133,55,2016,398664,1288,517,1805,3818,3305
55133,133,55,2017,401099,1481,552,2033,3920,3483
55133,133,55,2018,402705,1050,247,1297,3959,3624
55133,133,55,2019,404545,1146,371,1517,3788,3454
55133,133,55,2020,406172,1261,322,1583,3810,3765
55135,135,55,2010,52396,16,4,20,130,159
55135,135,55,2011,52293,155,11,166,494,760
55135,135,55,2012,51922,-201,22,-179,537,732
55135,135,55,2013,52068,289,13,302,516,662
55135,135,55,2014,51934,-2,13,11,534,668
55135,135,55,2015,51684,-45,21,-24,520,741
55135,135,55,2016,51301,-117,11,-106,494,770
55135,135,55,2017,51108,38,11,49,488,727
55135,135,55,2018,51051,158,9,167,526,747
55135,135,55,2019,50863,-40,8,-32,528,684
55135,135,55,2020,50664,10,5,15,527,742
55137,137,55,2010,24526,0,1,1,64,45
55137,137,55,2011,24563,82,0,82,224,269
55137,137,55,2012,24433,-89,6,-83,238,282
55137,137,55,2013,24260,-126,5,-121,228,278
55137,137,55,2014,24110,-135,6,-129,224,244
55137,137,55,2015,23966,-121,5,-116,247,272
55137,137,55,2016,24104,196,12,208,209,281
55137,137,55,2017,24215,160,10,170,221,280
55137,137,55,2018,24245,133,15,148,186,303
55137,137,55,2019,24388,204,7,211,216,283
55137,137,55,2020,24326,23,4,27,195,283
55139,139,55,2010,167144,-73,22,-51,504,364
55139,139,55,2011,167579,-33,47,14,1877,1449
55139,139,55,2012,168623,455,111,566,1924,1425
55139,139,55,2013,169388,178,144,322,1896,1424
55139,139,55,2014,169445,-488,147,-341,1829,1404
55139,139,55,2015,169383,-592,182,-410,1827,1471
55139,139,55,2016,169809,-221,182,-39,1937,1467
55139,139,55,2017,170568,202,191,393,1903,1529
55139,139,55,2018,170811,-134,114,-20,1834,1565
55139,139,55,2019,171801,671,119,790,1719,1522
55139,139,55,2020,171631,-458,109,-349,1770,1598
55141,141,55,2010,74812,0,7,7,226,162
55141,141,55,2011,74653,-295,20,-275,857,740
55141,141,55,2012,74326,-419,16,-403,823,752
55141,141,55,2013,73930,-507,23,-484,861,780
55141,141,55,2014,73595,-448,31,-417,767,686
55141,141,55,2015,73360,-218,47,-171,811,873
55141,141,55,2016,73224,-183,36,-147,829,816
55141,141,55,2017,73053,-186,21,-165,849,851
55141,141,55,2018,72827,-183,13,-170,789,843
55141,141,55,2019,72795,-38,15,-23,808,817
55141,141,55,2020,72560,-204,9,-195,778,819
56001,001,56,2010,36471,45,48,93,103,29
56001,001,56,2011,36873,154,20,174,414,190
56001,001,56,2012,37404,89,190,279,442,193
56001,001,56,2013,37619,-96,90,-6,411,189
56001,001,56,2014,37702,-164,19,-145,428,197
56001,001,56,2015,38054,-159,278,119,413,177
56001,001,56,2016,38012,-443,202,-241,380,184
56001,001,56,2017,38600,107,303,410,377,201
56001,001,56,2018,38937,-84,290,206,336,205
56001,001,56,2019,38819,-339,50,-289,354,185
56001,001,56,2020,38950,-39,45,6,335,213
56003,003,56,2010,11665,23,-1,22,24,50
56003,003,56,2011,11723,42,-4,38,151,131
56003,003,56,2012,11761,33,0,33,133,127
56003,003,56,2013,11941,171,3,174,139,136
56003,003,56,2014,11864,-96,-4,-100,162,142
56003,003,56,2015,11965,65,-2,63,160,121
56003,003,56,2016,11949,-12,4,-8,127,135
56003,003,56,2017,11888,-56,5,-51,140,149
56003,003,56,2018,11887,-18,5,-13,154,142
56003,003,56,2019,11746,-106,1,-105,109,145
56003,003,56,2020,11575,-133,1,-132,116,153
56005,005,56,2010,46253,-25,17,-8,209,83
56005,005,56,2011,46570,-146,-19,-165,722,240
56005,005,56,2012,47887,758,8,766,766,241
56005,005,56,2013,48080,-305,-17,-322,734,223
56005,005,56,2014,48195,-364,-31,-395,752,249
56005,005,56,2015,49336,602,42,644,766,275
56005,005,56,2016,48900,-1100,35,-1065,840,217
56005,005,56,2017,46445,-2913,11,-2902,643,214
56005,005,56,2018,46349,-466,16,-450,618,267
56005,005,56,2019,46420,-212,-20,-232,577,277
56005,005,56,2020,46676,49,-12,37,583,367
56007,007,56,2010,15849,-70,1,-69,46,17
56007,007,56,2011,15842,-85,-8,-93,202,114
56007,007,56,2012,15719,-192,1,-191,191,125
56007,007,56,2013,15849,48,6,54,196,118
56007,007,56,2014,15889,5,-10,-5,205,158
56007,007,56,2015,15630,-347,3,-344,216,134
56007,007,56,2016,15719,-19,10,-9,237,139
56007,007,56,2017,15261,-519,9,-510,201,151
56007,007,56,2018,14841,-457,7,-450,175,147
56007,007,56,2019,14832,-87,10,-77,171,102
56007,007,56,2020,14711,-155,9,-146,168,143
56009,009,56,2010,13823,-29,1,-28,56,39
56009,009,56,2011,13739,-147,-1,-148,163,99
56009,009,56,2012,14032,214,11,225,192,132
56009,009,56,2013,14369,273,9,282,177,127
56009,009,56,2014,14207,-244,-3,-247,198,118
56009,009,56,2015,14303,-5,16,11,217,132
56009,009,56,2016,14104,-265,7,-258,185,129
56009,009,56,2017,13756,-407,16,-391,166,126
56009,009,56,2018,13682,-123,16,-107,152,120
56009,009,56,2019,13865,125,7,132,162,110
56009,009,56,2020,13804,-100,4,-96,161,126
56011,011,56,2010,7119,20,3,23,36,20
56011,011,56,2011,7117,-20,2,-18,80,64
56011,011,56,2012,7137,-32,6,-26,100,54
56011,011,56,2013,7149,3,0,3,87,77
56011,011,56,2014,7237,41,3,44,100,56
56011,011,56,2015,7441,126,24,150,116,62
56011,011,56,2016,7497,-5,19,14,99,56
56011,011,56,2017,7393,-150,7,-143,101,62
56011,011,56,2018,7452,9,7,16,116,72
56011,011,56,2019,7573,65,2,67,108,53
56011,011,56,2020,7593,-14,2,-12,104,73
56013,013,56,2010,40199,59,5,64,161,148
56013,013,56,2011,40525,94,-1,93,614,379
56013,013,56,2012,41029,288,-1,287,615,409
56013,013,56,2013,40937,-222,21,-201,574,463
56013,013,56,2014,40595,-575,-3,-578,619,396
56013,013,56,2015,40261,-481,1,-480,575,434
56013,013,56,2016,40250,-120,-5,-125,560,444
56013,013,56,2017,39865,-508,-2,-510,542,417
56013,013,56,2018,39656,-277,-3,-280,493,423
56013,013,56,2019,39467,-242,-10,-252,524,460
56013,013,56,2020,39317,-113,-5,-118,493,525
56015,015,56,2010,13425,150,3,153,30,23
56015,015,56,2011,13575,180,-3,177,116,143
56015,015,56,2012,13647,59,7,66,139,132
56015,015,56,2013,13560,-112,21,-91,146,142
56015,015,56,2014,13541,-43,9,-34,154,141
56015,015,56,2015,13566,-7,29,22,146,142
56015,015,56,2016,13329,-234,3,-231,139,145
56015,015,56,2017,13384,30,5,35,154,133
56015,015,56,2018,13334,-39,5,-34,136,152
56015,015,56,2019,13225,-74,-1,-75,111,145
56015,015,56,2020,13235,45,2,47,112,149
56017,017,56,2010,4809,-1,4,3,13,19
56017,017,56,2011,4806,14,-1,13,57,72
56017,017,56,2012,4834,31,-2,29,56,57
56017,017,56,2013,4838,21,-1,20,49,65
56017,017,56,2014,4795,-21,0,-21,52,76
56017,017,56,2015,4722,-37,0,-37,43,78
56017,017,56,2016,4664,-33,2,-31,50,77
56017,017,56,2017,4693,52,2,54,43,69
56017,017,56,2018,4554,-112,1,-111,46,72
56017,017,56,2019,4415,-108,0,-108,42,73
56017,017,56,2020,4425,49,1,50,45,85
56019,019,56,2010,8591,-3,5,2,29,9
56019,019,56,2011,8650,40,1,41,104,86
56019,019,56,2012,8645,-23,9,-14,90,79
56019,019,56,2013,8648,-9,2,-7,103,93
56019,019,56,2014,8589,-67,-2,-69,95,85
56019,019,56,2015,8622,46,3,49,80,95
56019,019,56,2016,8492,-115,1,-114,80,96
56019,019,56,2017,8457,-18,0,-18,78,95
56019,019,56,2018,8505,81,0,81,70,102
56019,019,56,2019,8548,70,0,70,70,98
56019,019,56,2020,8588,56,0,56,71,88
56021,021,56,2010,92246,168,60,228,357,234
56021,021,56,2011,92610,-121,-30,-151,1288,770
56021,021,56,2012,94751,1358,222,1580,1216,717
56021,021,56,2013,95786,423,110,533,1250,745
56021,021,56,2014,96122,-163,15,-148,1230,726
56021,021,56,2015,97090,323,191,514,1312,849
56021,021,56,2016,98039,390,44,434,1331,814
56021,021,56,2017,98599,-38,93,55,1285,774
56021,021,56,2018,99264,163,55,218,1289,840
56021,021,56,2019,99865,342,-23,319,1205,924
56021,021,56,2020,100595,480,-6,474,1212,960
56023,023,56,2010,18098,-56,4,-52,86,45
56023,023,56,2011,18021,-192,1,-191,244,130
56023,023,56,2012,17957,-203,4,-199,247,116
56023,023,56,2013,18342,246,4,250,232,100
56023,023,56,2014,18601,140,-10,130,245,116
56023,023,56,2015,18788,70,7,77,247,135
56023,023,56,2016,19141,221,4,225,272,146
56023,023,56,2017,19334,75,8,83,237,126
56023,023,56,2018,19537,111,7,118,214,128
56023,023,56,2019,19934,316,0,316,229,147
56023,023,56,2020,20253,248,3,251,231,162
56025,025,56,2010,75477,-63,26,-37,258,186
56025,025,56,2011,76431,585,-3,582,1033,665
56025,025,56,2012,78620,1676,50,1726,1045,650
56025,025,56,2013,81175,2018,47,2065,1137,711
56025,025,56,2014,81453,-190,-30,-220,1211,701
56025,025,56,2015,82218,225,101,326,1180,733
56025,025,56,2016,81025,-1706,80,-1626,1162,737
56025,025,56,2017,79622,-1790,64,-1726,1033,722
56025,025,56,2018,79140,-815,61,-754,980,710
56025,025,56,2019,79734,389,21,410,933,751
56025,025,56,2020,80815,938,19,957,931,804
56027,027,56,2010,2491,4,0,4,6,3
56027,027,56,2011,2485,-4,0,-4,18,21
56027,027,56,2012,2480,4,0,4,20,29
56027,027,56,2013,2550,67,0,67,29,29
56027,027,56,2014,2494,-56,0,-56,24,25
56027,027,56,2015,2504,13,0,13,36,39
56027,027,56,2016,2470,-33,0,-33,28,29
56027,027,56,2017,2398,-78,0,-78,35,29
56027,027,56,2018,2403,-5,0,-5,26,17
56027,027,56,2019,2340,-69,0,-69,28,21
56027,027,56,2020,2275,-77,0,-77,26,14
56029,029,56,2010,28243,45,2,47,74,85
56029,029,56,2011,28462,172,9,181,300,261
56029,029,56,2012,28829,238,59,297,326,261
56029,029,56,2013,29079,157,55,212,304,268
56029,029,56,2014,29000,-132,-9,-141,321,258
56029,029,56,2015,28973,-91,-2,-93,346,278
56029,029,56,2016,29262,248,3,251,311,272
56029,029,56,2017,29272,0,12,12,295,296
56029,029,56,2018,29309,25,12,37,289,287
56029,029,56,2019,29192,-82,-1,-83,270,302
56029,029,56,2020,29331,178,0,178,269,306
56031,031,56,2010,8665,18,0,18,13,34
56031,031,56,2011,8695,57,-3,54,80,103
56031,031,56,2012,8729,48,-1,47,94,105
56031,031,56,2013,8712,-17,6,-11,94,101
56031,031,56,2014,8778,83,-4,79,82,94
56031,031,56,2015,8803,30,4,34,89,97
56031,031,56,2016,8673,-114,-4,-118,88,99
56031,031,56,2017,8557,-109,-3,-112,85,89
56031,031,56,2018,8571,53,-3,50,65,100
56031,031,56,2019,8475,-69,-3,-72,85,110
56031,031,56,2020,8578,127,-1,126,76,98
56033,033,56,2010,29148,-1,27,26,87,85
56033,033,56,2011,29257,52,14,66,341,298
56033,033,56,2012,29538,195,38,233,332,286
56033,033,56,2013,29754,158,42,200,305,291
56033,033,56,2014,29884,65,2,67,362,295
56033,033,56,2015,29925,30,13,43,331,330
56033,033,56,2016,30027,68,21,89,335,321
56033,033,56,2017,30222,176,38,214,324,340
56033,033,56,2018,30277,73,28,101,293,337
56033,033,56,2019,30597,290,57,347,298,326
56033,033,56,2020,30863,282,45,327,293,352
56035,035,56,2010,10262,-26,12,-14,33,3
56035,035,56,2011,10194,-154,4,-150,134,53
56035,035,56,2012,10489,184,6,190,137,38
56035,035,56,2013,10190,-405,8,-397,132,48
56035,035,56,2014,10170,-83,-6,-89,126,57
56035,035,56,2015,10064,-199,-8,-207,144,47
56035,035,56,2016,9997,-113,-2,-115,109,60
56035,035,56,2017,9778,-271,-1,-272,101,49
56035,035,56,2018,9827,6,-3,3,104,59
56035,035,56,2019,9867,33,5,38,72,70
56035,035,56,2020,9856,-18,5,-13,77,75
56037,037,56,2010,43580,-344,4,-340,166,75
56037,037,56,2011,44000,65,-31,34,636,249
56037,037,56,2012,45032,702,-16,686,593,273
56037,037,56,2013,45189,-279,79,-200,653,296
56037,037,56,2014,44996,-548,-27,-575,629,263
56037,037,56,2015,44780,-648,44,-604,642,260
56037,037,56,2016,44319,-831,43,-788,626,303
56037,037,56,2017,43663,-1062,141,-921,571,312
56037,037,56,2018,43188,-808,131,-677,529,331
56037,037,56,2019,42917,-511,61,-450,481,301
56037,037,56,2020,42673,-454,47,-407,481,319
56039,039,56,2010,21298,-71,1,-70,76,10
56039,039,56,2011,21422,-39,-11,-50,261,87
56039,039,56,2012,21643,29,21,50,234,61
56039,039,56,2013,22335,400,112,512,261,97
56039,039,56,2014,22801,310,-24,286,246,79
56039,039,56,2015,23083,36,76,112,264,92
56039,039,56,2016,23255,-33,57,24,245,97
56039,039,56,2017,23383,-103,67,-36,244,78
56039,039,56,2018,23261,-366,60,-306,255,72
56039,039,56,2019,23385,-19,23,4,211,90
56039,039,56,2020,23497,-9,18,9,225,124
56041,041,56,2010,21090,-52,-4,-56,71,49
56041,041,56,2011,20901,-358,-18,-376,323,139
56041,041,56,2012,21008,-80,-7,-87,310,115
56041,041,56,2013,20969,-212,-11,-223,316,136
56041,041,56,2014,20835,-301,-13,-314,319,148
56041,041,56,2015,20777,-217,1,-216,305,150
56041,041,56,2016,20711,-233,-4,-237,312,143
56041,041,56,2017,20449,-390,6,-384,272,151
56041,041,56,2018,20299,-294,6,-288,267,130
56041,041,56,2019,20196,-177,-2,-179,232,156
56041,041,56,2020,20215,-42,-2,-44,232,171
56043,043,56,2010,8531,11,-1,10,27,34
56043,043,56,2011,8451,-107,-2,-109,109,79
56043,043,56,2012,8410,-25,-1,-26,89,105
56043,043,56,2013,8417,-10,-1,-11,96,77
56043,043,56,2014,8277,-157,-2,-159,89,73
56043,043,56,2015,8282,4,-4,0,100,93
56043,043,56,2016,8180,-119,-5,-124,101,78
56043,043,56,2017,8013,-125,-5,-130,61,101
56043,043,56,2018,7886,-121,-7,-128,88,86
56043,043,56,2019,7824,-53,-7,-60,81,81
56043,043,56,2020,7760,-50,-3,-53,73,85
56045,045,56,2010,7198,-31,2,-29,25,9
56045,045,56,2011,7142,-62,-1,-63,79,71
56045,045,56,2012,7075,-79,5,-74,72,67
56045,045,56,2013,7132,35,9,44,95,81
56045,045,56,2014,7134,0,3,3,74,75
56045,045,56,2015,7202,23,43,66,72,68
56045,045,56,2016,7228,-8,15,7,89,69
56045,045,56,2017,6962,-275,19,-256,58,69
56045,045,56,2018,6895,-85,17,-68,67,68
56045,045,56,2019,6880,-3,3,0,53,67
56045,045,56,2020,6743,-119,2,-117,53,72
01001,001,01,2020,58915,100,0,100,162,176
01001,001,01,2021,59203,242,15,257,686,696
01001,001,01,2022,59726,507,22,529,706,687
01001,001,01,2023,60342,491,34,525,714,621
01003,003,01,2020,233227,1613,11,1624,560,602
01003,003,01,2021,239439,6972,105,7077,2337,2948
01003,003,01,2022,246531,7036,250,7286,2511,3022
01003,003,01,2023,253507,6804,291,7095,2531,2640
01005,005,01,2020,24969,-186,0,-186,60,92
01005,005,01,2021,24533,-313,0,-313,270,390
01005,005,01,2022,24700,237,2,239,278,363
01005,005,01,2023,24585,-45,13,-32,267,350
01007,007,01,2020,22188,-101,0,-101,56,55
01007,007,01,2021,22359,254,1,255,240,325
01007,007,01,2022,21986,-303,1,-302,236,314
01007,007,01,2023,21868,-69,1,-68,240,290
01009,009,01,2020,59107,21,1,22,137,199
01009,009,01,2021,59079,141,9,150,654,875
01009,009,01,2022,59516,589,8,597,693,846
01009,009,01,2023,59816,358,24,382,698,776
01011,011,01,2020,10229,-94,0,-94,24,41
01011,011,01,2021,10143,-42,1,-41,111,160
01011,011,01,2022,10143,32,5,37,103,138
01011,011,01,2023,9897,-219,6,-213,102,133
01013,013,01,2020,19025,15,0,15,47,88
01013,013,01,2021,18890,-75,5,-70,227,297
01013,013,01,2022,18668,-117,6,-111,207,312
01013,013,01,2023,18382,-207,8,-199,212,299
01015,015,01,2020,116243,-115,0,-115,305,397
01015,015,01,2021,115678,-70,12,-58,1250,1843
01015,015,01,2022,115780,635,22,657,1334,1852
01015,015,01,2023,116429,923,29,952,1346,1649
01017,017,01,2020,34651,-51,2,-49,87,167
01017,017,01,2021,34488,-6,22,16,392,592
01017,017,01,2022,34164,-208,49,-159,401,558
01017,017,01,2023,34079,-26,55,29,398,511
01019,019,01,2020,24969,59,0,59,62,122
01019,019,01,2021,25074,284,7,291,254,442
01019,019,01,2022,25353,476,14,490,238,456
01019,019,01,2023,25666,482,14,496,230,409
01021,021,01,2020,45057,26,1,27,147,143
01021,021,01,2021,45259,289,20,309,534,659
01021,021,01,2022,45848,656,26,682,540,643
01021,021,01,2023,46431,577,49,626,548,588
01023,023,01,2020,12626,-22,0,-22,33,53
01023,023,01,2021,12548,-12,1,-11,131,205
01023,023,01,2022,12431,-41,2,-39,141,213
01023,023,01,2023,12252,-88,2,-86,108,200
01025,025,01,2020,22987,-56,0,-56,57,101
01025,025,01,2021,22740,-120,0,-120,300,435
01025,025,01,2022,22574,-58,0,-58,289,390
01025,025,01,2023,22337,-165,0,-165,293,366
01027,027,01,2020,14212,-20,0,-20,33,39
01027,027,01,2021,14170,78,-1,77,142,268
01027,027,01,2022,14183,103,-3,100,154,235
01027,027,01,2023,14111,2,-3,-1,159,230
01029,029,01,2020,15064,14,0,14,37,48
01029,029,01,2021,15156,175,0,175,176,261
01029,029,01,2022,15372,267,-1,266,183,242
01029,029,01,2023,15639,322,-1,321,177,229
01031,031,01,2020,53549,91,1,92,159,174
01031,031,01,2021,54199,618,26,644,726,733
01031,031,01,2022,54840,602,57,659,673,691
01031,031,01,2023,55643,695,68,763,676,630
01033,033,01,2020,57304,68,2,70,166,176
01033,033,01,2021,57644,542,10,552,656,880
01033,033,01,2022,57993,590,11,601,633,891
01033,033,01,2023,58361,489,47,536,636,801
01035,035,01,2020,11554,-27,0,-27,29,45
01035,035,01,2021,11320,-123,0,-123,114,226
01035,035,01,2022,11224,-4,0,-4,134,221
01035,035,01,2023,11174,20,0,20,134,205
01037,037,01,2020,10335,-33,0,-33,27,29
01037,037,01,2021,10314,77,-1,76,82,180
01037,037,01,2022,10307,90,-2,88,86,183
01037,037,01,2023,10268,49,-1,48,89,174
01039,039,01,2020,37506,3,0,3,88,157
01039,039,01,2021,37570,308,1,309,455,710
01039,039,01,2022,37603,336,-1,335,418,711
01039,039,01,2023,37952,589,-1,588,418,653
01041,041,01,2020,13163,-13,1,-12,41,60
01041,041,01,2021,13069,-14,6,-8,145,240
01041,041,01,2022,13048,55,14,69,156,240
01041,041,01,2023,13101,95,27,122,157,225
01043,043,01,2020,88136,290,0,290,252,254
01043,043,01,2021,89639,1909,-6,1903,998,1345
01043,043,01,2022,90663,1293,-2,1291,1003,1300
01043,043,01,2023,92016,1471,16,1487,1015,1146
01045,045,01,2020,49257,-78,-1,-79,149,137
01045,045,01,2021,49395,118,10,128,673,700
01045,045,01,2022,49495,110,29,139,689,707
01045,045,01,2023,49871,257,49,306,692,623
01047,047,01,2020,38171,-202,1,-201,101,162
01047,047,01,2021,37515,-417,10,-407,437,686
01047,047,01,2022,36729,-635,34,-601,428,625
01047,047,01,2023,36165,-458,37,-421,428,572
01049,049,01,2020,71659,48,4,52,188,222
01049,049,01,2021,71912,422,35,457,828,1071
01049,049,01,2022,72082,363,71,434,834,1063
01049,049,01,2023,72569,495,100,595,835,945
01051,051,01,2020,87861,-84,0,-84,213,245
01051,051,01,2021,88789,1055,16,1071,914,1070
01051,051,01,2022,89600,915,21,936,931,1051
01051,051,01,2023,90441,822,29,851,935,942
01053,053,01,2020,36685,-49,0,-49,93,132
01053,053,01,2021,36660,171,0,171,441,659
01053,053,01,2022,36636,207,1,208,420,644
01053,053,01,2023,36558,74,2,76,428,582
01055,055,01,2020,103453,58,0,58,289,362
01055,055,01,2021,103010,249,19,268,1097,1880
01055,055,01,2022,102903,522,64,586,1156,1813
01055,055,01,2023,103241,733,69,802,1170,1630
01057,057,01,2020,16331,14,0,14,42,53
01057,057,01,2021,16127,-72,0,-72,181,320
01057,057,01,2022,16082,84,0,84,177,301
01057,057,01,2023,15967,-18,0,-18,180,276
01059,059,01,2020,32078,-32,1,-31,97,107
01059,059,01,2021,31998,-38,33,-5,388,486
01059,059,01,2022,31910,-48,37,-11,430,491
01059,059,01,2023,31802,-144,54,-90,430,449
01061,061,01,2020,26698,64,0,64,69,94
01061,061,01,2021,26620,165,6,171,271,531
01061,061,01,2022,26760,328,14,342,289,491
01061,061,01,2023,26988,369,17,386,294,451
01063,063,01,2020,7700,-21,0,-21,28,36
01063,063,01,2021,7614,-49,0,-49,110,151
01063,063,01,2022,7452,-113,0,-113,84,135
01063,063,01,2023,7341,-68,0,-68,84,126
01065,065,01,2020,14772,8,0,8,45,72
01065,065,01,2021,14726,30,1,31,183,269
01065,065,01,2022,14599,-77,0,-77,209,254
01065,065,01,2023,14888,327,1,328,213,251
01067,067,01,2020,17169,50,0,50,40,63
01067,067,01,2021,17433,391,0,391,159,274
01067,067,01,2022,17670,333,0,333,172,269
01067,067,01,2023,17899,319,0,319,173,261
01069,069,01,2020,107284,54,0,54,312,316
01069,069,01,2021,107470,385,21,406,1300,1579
01069,069,01,2022,108047,766,64,830,1299,1535
01069,069,01,2023,108462,374,83,457,1306,1349
01071,071,01,2020,52545,25,0,25,127,201
01071,071,01,2021,52719,594,12,606,526,963
01071,071,01,2022,52923,566,27,593,559,957
01071,071,01,2023,53467,809,29,838,549,841
01073,073,01,2020,674717,343,23,366,1919,2031
01073,073,01,2021,669990,-4025,266,-3759,7890,9170
01073,073,01,2022,665084,-4468,633,-3835,7899,8754
01073,073,01,2023,662895,-3417,818,-2599,7967,7573
01075,075,01,2020,13953,-1,0,-1,29,51
01075,075,01,2021,13736,-122,0,-122,167,262
01075,075,01,2022,13706,52,-1,51,168,241
01075,075,01,2023,13661,38,-1,37,155,238
01077,077,01,2020,94025,607,1,608,220,305
01077,077,01,2021,94853,1306,32,1338,926,1425
01077,077,01,2022,95875,1323,51,1374,943,1312
01077,077,01,2023,96814,1103,58,1161,948,1183
01079,079,01,2020,33089,44,0,44,76,112
01079,079,01,2021,33073,208,0,208,370,607
01079,079,01,2022,33187,273,0,273,383,543
01079,079,01,2023,33502,420,-1,419,386,492
01081,081,01,2020,174754,299,20,319,460,324
01081,081,01,2021,177596,2258,182,2440,1786,1407
01081,081,01,2022,180698,2116,510,2626,1942,1461
01081,081,01,2023,183215,1357,575,1932,1899,1313
01083,083,01,2020,104203,575,2,577,289,214
01083,083,01,2021,107303,3284,19,3303,1098,1187
01083,083,01,2022,110868,3255,99,3354,1189,1142
01083,083,01,2023,114654,3523,104,3627,1204,1040
01085,085,01,2020,10285,-9,0,-9,32,62
01085,085,01,2021,9945,-274,0,-274,125,181
01085,085,01,2022,9783,-94,0,-94,121,187
01085,085,01,2023,9717,-17,1,-16,120,169
01087,087,01,2020,19464,-17,0,-17,29,77
01087,087,01,2021,18905,-438,1,-437,193,294
01087,087,01,2022,18532,-287,8,-279,162,257
01087,087,01,2023,18370,-107,24,-83,162,241
01089,089,01,2020,390503,2269,9,2278,1076,844
01089,089,01,2021,396671,5814,212,6026,4284,4100
01089,089,01,2022,403605,5782,690,6472,4412,4114
01089,089,01,2023,412600,7340,789,8129,4470,3616
01091,091,01,2020,19270,-26,0,-26,56,86
01091,091,01,2021,18985,-181,0,-181,247,353
01091,091,01,2022,18791,-90,2,-88,226,324
01091,091,01,2023,18684,-41,14,-27,220,301
01093,093,01,2020,29176,-100,0,-100,98,145
01093,093,01,2021,29001,35,12,47,280,522
01093,093,01,2022,29182,335,0,335,318,474
01093,093,01,2023,29244,192,1,193,309,441
01095,095,01,2020,97702,27,4,31,340,314
01095,095,01,2021,98286,534,46,580,1459,1506
01095,095,01,2022,99428,915,137,1052,1514,1423
01095,095,01,2023,100756,866,181,1047,1535,1256
01097,097,01,2020,414377,-457,11,-446,1288,1347
01097,097,01,2021,413383,-1131,125,-1006,5197,5456
01097,097,01,2022,411398,-1528,285,-1243,5053,5613
01097,097,01,2023,411640,-405,325,-80,5075,4765
01099,099,01,2020,19706,-26,0,-26,41,82
01099,099,01,2021,19550,-20,0,-20,217,366
01099,099,01,2022,19412,-21,1,-20,233,341
01099,099,01,2023,19229,-98,1,-97,231,319
01101,101,01,2020,228342,-652,7,-645,782,713
01101,101,01,2021,226935,-1756,129,-1627,3082,2918
01101,101,01,2022,226301,-1226,358,-868,2997,2682
01101,101,01,2023,224980,-2418,439,-1979,3003,2360
01103,103,01,2020,123288,-103,1,-102,343,382
01103,103,01,2021,123375,368,18,386,1425,1813
01103,103,01,2022,124231,1043,79,1122,1437,1689
01103,103,01,2023,125133,840,106,946,1461,1506
01105,105,01,2020,8458,-49,0,-49,30,31
01105,105,01,2021,8328,-65,0,-65,100,168
01105,105,01,2022,7904,-390,1,-389,91,152
01105,105,01,2023,7738,-114,1,-113,89,141
01107,107,01,2020,18969,-99,0,-99,33,78
01107,107,01,2021,18618,-182,3,-179,169,341
01107,107,01,2022,18749,233,11,244,181,308
01107,107,01,2023,18688,22,14,36,186,283
01109,109,01,2020,32900,-86,2,-84,89,100
01109,109,01,2021,32746,-100,26,-74,355,454
01109,109,01,2022,33008,278,63,341,359,439
01109,109,01,2023,33137,100,66,166,360,396
01111,111,01,2020,22086,163,0,163,63,82
01111,111,01,2021,22184,219,1,220,265,389
01111,111,01,2022,22460,368,2,370,252,355
01111,111,01,2023,22786,404,10,414,249,336
01113,113,01,2020,59258,34,8,42,184,166
01113,113,01,2021,58681,-555,8,-547,788,828
01113,113,01,2022,58594,-106,16,-90,829,801
01113,113,01,2023,58744,149,24,173,688,710
01115,115,01,2020,91657,207,0,207,233,265
01115,115,01,2021,92874,1597,8,1605,959,1327
01115,115,01,2022,93881,1246,15,1261,1021,1294
01115,115,01,2023,95552,1777,18,1795,1032,1156
01117,117,01,2020,223912,762,8,770,537,444
01117,117,01,2021,227453,3075,137,3212,2243,1930
01117,117,01,2022,230033,2019,212,2231,2370,1941
01117,117,01,2023,233000,2078,248,2326,2390,1727
01119,119,01,2020,12191,-101,0,-101,28,59
01119,119,01,2021,11967,-181,6,-175,126,169
01119,119,01,2022,11889,-61,20,-41,133,165
01119,119,01,2023,11727,-136,21,-115,114,161
01121,121,01,2020,81575,-444,0,-444,219,265
01121,121,01,2021,80734,-436,15,-421,881,1329
01121,121,01,2022,80748,436,15,451,868,1302
01121,121,01,2023,81132,633,25,658,871,1147
01123,123,01,2020,41284,6,0,6,103,144
01123,123,01,2021,41099,114,4,118,397,718
01123,123,01,2022,40913,120,13,133,389,697
01123,123,01,2023,40677,-11,19,8,392,637
01125,125,01,2020,231547,5189,4,5193,611,511
01125,125,01,2021,235670,3949,129,4078,2486,2343
01125,125,01,2022,236690,679,257,936,2488,2292
01125,125,01,2023,237373,-128,298,170,2510,2004
01127,127,01,2020,65138,-73,1,-72,165,309
01127,127,01,2021,64636,58,18,76,766,1391
01127,127,01,2022,64438,228,37,265,786,1224
01127,127,01,2023,64728,539,39,578,808,1096
01129,129,01,2020,15329,-51,0,-51,48,52
01129,129,01,2021,15223,-65,1,-64,187,236
01129,129,01,2022,15094,-75,-1,-76,190,241
01129,129,01,2023,15022,-29,-1,-30,187,229
01131,131,01,2020,10534,-38,0,-38,28,50
01131,131,01,2021,10423,-54,4,-50,113,175
01131,131,01,2022,10139,-232,2,-230,116,177
01131,131,01,2023,9944,-147,2,-145,116,166
01133,133,01,2020,23493,-15,0,-15,56,100
01133,133,01,2021,23655,363,8,371,215,421
01133,133,01,2022,23741,247,17,264,242,419
01133,133,01,2023,23611,-8,18,10,249,388
02013,013,02,2020,3427,0,0,0,6,2
02013,013,02,2021,3417,-26,16,-10,8,11
02013,013,02,2022,3430,-82,97,15,9,11
02013,013,02,2023,3461,-53,77,24,17,10
02016,016,02,2020,5214,-17,0,-17,12,5
02016,016,02,2021,5147,-138,65,-73,28,18
02016,016,02,2022,5090,-226,155,-71,25,19
02016,016,02,2023,5160,-67,131,64,25,16
02020,020,02,2020,290893,-881,46,-835,966,482
02020,020,02,2021,289169,-3816,524,-3292,3658,2090
02020,020,02,2022,286983,-4631,1298,-3333,3600,2501
02020,020,02,2023,286075,-3412,1115,-2297,3573,2177
02050,050,02,2020,18661,-71,0,-71,109,31
02050,050,02,2021,18594,-292,2,-290,394,165
02050,050,02,2022,18259,-590,6,-584,400,168
02050,050,02,2023,18224,-276,5,-271,389,155
02060,060,02,2020,830,-11,0,-11,2,2
02060,060,02,2021,842,10,3,13,6,7
02060,060,02,2022,870,18,8,26,11,11
02060,060,02,2023,844,-34,6,-28,11,7
02068,068,02,2020,1614,-12,0,-12,3,0
02068,068,02,2021,1595,-35,9,-26,21,11
02068,068,02,2022,1575,-41,6,-35,21,9
02068,068,02,2023,1584,-9,6,-3,20,9
02070,070,02,2020,4838,-26,0,-26,19,8
02070,070,02,2021,4796,-89,2,-87,89,42
02070,070,02,2022,4724,-111,12,-99,79,55
02070,070,02,2023,4607,-156,12,-144,75,47
02090,090,02,2020,95337,-519,9,-510,336,114
02090,090,02,2021,95593,-635,15,-620,1400,584
02090,090,02,2022,95202,-1356,204,-1152,1448,684
02090,090,02,2023,94840,-1391,214,-1177,1427,606
02100,100,02,2020,2084,9,0,9,6,8
02100,100,02,2021,2074,-10,0,-10,19,20
02100,100,02,2022,2070,-12,6,-6,22,19
02100,100,02,2023,2070,-12,6,-6,24,17
02105,105,02,2020,2358,-1,0,-1,5,7
02105,105,02,2021,2330,-21,1,-20,26,33
02105,105,02,2022,2279,-53,4,-49,18,21
02105,105,02,2023,2262,-9,3,-6,18,28
02110,110,02,2020,32209,-77,2,-75,70,46
02110,110,02,2021,31979,-344,43,-301,278,208
02110,110,02,2022,31740,-412,124,-288,286,237
02110,110,02,2023,31555,-314,58,-256,284,214
02122,122,02,2020,58942,94,1,95,149,111
02122,122,02,2021,59946,776,20,796,679,468
02122,122,02,2022,60611,599,48,647,634,605
02122,122,02,2023,61223,486,38,524,636,549
02130,130,02,2020,13915,-48,0,-48,42,30
02130,130,02,2021,13866,-118,15,-103,137,87
02130,130,02,2022,13772,-127,32,-95,121,121
02130,130,02,2023,13738,-72,29,-43,119,109
02150,150,02,2020,13047,-81,5,-76,43,13
02150,150,02,2021,12878,-301,62,-239,166,86
02150,150,02,2022,12639,-429,98,-331,160,85
02150,150,02,2023,12565,-234,91,-143,158,88
02158,158,02,2020,8371,-41,0,-41,63,18
02158,158,02,2021,8377,-149,0,-149,225,66
02158,158,02,2022,8214,-307,1,-306,219,87
02158,158,02,2023,8001,-356,1,-355,216,72
02164,164,02,2020,1450,-20,0,-20,5,6
02164,164,02,2021,1419,-41,0,-41,26,15
02164,164,02,2022,1377,-48,1,-47,18,14
02164,164,02,2023,1331,-51,1,-50,16,11
02170,170,02,2020,107504,244,0,244,339,164
02170,170,02,2021,110998,3044,39,3083,1323,810
02170,170,02,2022,113472,1978,68,2046,1376,1006
02170,170,02,2023,115239,1198,57,1255,1370,862
02180,180,02,2020,10029,-42,0,-42,48,25
02180,180,02,2021,9894,-226,2,-224,182,89
02180,180,02,2022,9791,-189,9,-180,172,99
02180,180,02,2023,9763,-124,8,-116,169,84
02185,185,02,2020,11004,-51,0,-51,34,9
02185,185,02,2021,11054,-30,11,-19,131,65
02185,185,02,2022,10811,-368,52,-316,131,68
02185,185,02,2023,10603,-313,43,-270,126,63
02188,188,02,2020,7797,-24,0,-24,38,13
02188,188,02,2021,7635,-263,0,-263,177,64
02188,188,02,2022,7453,-259,-1,-260,142,78
02188,188,02,2023,7361,-154,-1,-155,141,79
02195,195,02,2020,3403,2,0,2,13,9
02195,195,02,2021,3381,-35,10,-25,30,25
02195,195,02,2022,3370,-35,27,-8,27,30
02195,195,02,2023,3427,37,25,62,25,28
02198,198,02,2020,5741,-16,0,-16,11,9
02198,198,02,2021,5720,-11,0,-11,66,77
02198,198,02,2022,5650,-74,3,-71,74,74
02198,198,02,2023,5696,48,2,50,73,76
02220,220,02,2020,8426,-29,0,-29,17,7
02220,220,02,2021,8383,-68,16,-52,75,70
02220,220,02,2022,8353,-66,32,-34,78,66
02220,220,02,2023,8282,-98,21,-77,76,69
02230,230,02,2020,1238,-2,0,-2,0,2
02230,230,02,2021,1147,-88,1,-87,11,9
02230,230,02,2022,1092,-63,4,-59,9,8
02230,230,02,2023,1095,-4,4,0,9,8
02240,240,02,2020,6821,3,0,3,26,16
02240,240,02,2021,7007,140,9,149,102,62
02240,240,02,2022,7016,-59,28,-31,102,62
02240,240,02,2023,7077,-8,23,15,98,54
02275,275,02,2020,2126,2,0,2,4,5
02275,275,02,2021,2102,-24,1,-23,21,21
02275,275,02,2022,2071,-22,0,-22,19,28
02275,275,02,2023,2064,-1,0,-1,19,24
02282,282,02,2020,682,21,0,21,1,0
02282,282,02,2021,710,20,-1,19,10,1
02282,282,02,2022,685,-23,1,-22,2,6
02282,282,02,2023,687,0,1,1,3,2
02290,290,02,2020,5309,-40,0,-40,18,15
02290,290,02,2021,5278,-35,1,-34,60,59
02290,290,02,2022,5169,-100,16,-84,54,79
02290,290,02,2023,5129,-34,14,-20,55,75
04001,001,04,2020,65913,-48,0,-48,233,314
04001,001,04,2021,65389,-154,23,-131,734,1166
04001,001,04,2022,65533,418,53,471,762,1071
04001,001,04,2023,65036,-302,56,-246,724,975
04003,003,04,2020,125527,97,9,106,319,361
04003,003,04,2021,126119,1003,120,1123,1221,1782
04003,003,04,2022,125487,-331,260,-71,1249,1795
04003,003,04,2023,124640,-695,228,-467,1246,1612
04005,005,04,2020,145192,-13,-4,-17,335,289
04005,005,04,2021,142897,-2497,99,-2398,1336,1140
04005,005,04,2022,144223,811,286,1097,1323,1126
04005,005,04,2023,144472,-296,292,-4,1315,1059
04007,007,04,2020,53351,206,1,207,110,213
04007,007,04,2021,53549,761,9,770,441,994
04007,007,04,2022,53922,898,-6,892,454,1006
04007,007,04,2023,54003,562,-6,556,453,931
04009,009,04,2020,38646,64,0,64,107,76
04009,009,04,2021,38921,197,-1,196,481,422
04009,009,04,2022,38822,-169,-2,-171,502,445
04009,009,04,2023,39525,614,-2,612,493,408
04011,011,04,2020,9528,-44,0,-44,32,18
04011,011,04,2021,9400,-173,6,-167,127,81
04011,011,04,2022,9327,-124,29,-95,119,97
04011,011,04,2023,9369,-9,31,22,118,98
04012,012,04,2020,16569,71,1,72,39,78
04012,012,04,2021,16385,36,12,48,157,392
04012,012,04,2022,16535,294,84,378,165,400
04012,012,04,2023,16710,312,78,390,165,376
04013,013,04,2020,4445059,18682,135,18817,11597,9639
04013,013,04,2021,4499438,42990,5514,48504,48709,43801
04013,013,04,2022,4555833,32979,15356,48335,51145,43452
04013,013,04,2023,4585871,2179,15217,17396,50795,38287
04015,015,04,2020,214185,1733,2,1735,400,1016
04015,015,04,2021,217164,5700,33,5733,1738,4267
04015,015,04,2022,220905,5991,90,6081,1802,4460
04015,015,04,2023,223682,4952,81,5033,1736,3993
04017,017,04,2020,106763,157,0,157,318,435
04017,017,04,2021,107726,1450,11,1461,1265,1750
04017,017,04,2022,108800,1520,41,1561,1236,1754
04017,017,04,2023,109175,707,38,745,1228,1597
04019,019,04,2020,1045175,2257,66,2323,2351,2994
04019,019,04,2021,1048914,5189,1161,6350,9815,12945
04019,019,04,2022,1057476,7927,3224,11151,10093,12750
04019,019,04,2023,1063162,3823,3105,6928,10006,11276
04021,021,04,2020,430187,4607,14,4621,1069,1055
04021,021,04,2021,448993,19359,340,19699,4667,4661
04021,021,04,2022,465037,14075,1099,15174,5051,4835
04021,021,04,2023,484239,17463,1033,18496,5015,4293
04023,023,04,2020,47712,-19,4,-15,148,94
04023,023,04,2021,47956,46,164,210,503,500
04023,023,04,2022,48680,175,420,595,550,405
04023,023,04,2023,49158,-27,332,305,554,382
04025,025,04,2020,237217,1670,1,1671,406,871
04025,025,04,2021,242352,7677,74,7751,1658,3925
04025,025,04,2022,246230,5699,184,5883,1783,4082
04025,025,04,2023,249081,4514,153,4667,1777,3587
04027,027,04,2020,205659,560,24,584,646,572
04027,027,04,2021,207284,706,445,1151,2841,2450
04027,027,04,2022,208874,-365,1178,813,2903,2129
04027,027,04,2023,213221,2382,999,3381,2869,1918
05001,001,05,2020,17107,-22,0,-22,52,71
05001,001,05,2021,16687,-290,1,-289,194,319
05001,001,05,2022,16498,-38,-1,-39,184,328
05001,001,05,2023,16307,-71,-1,-72,186,305
05003,003,05,2020,18957,-69,0,-69,40,62
05003,003,05,2021,18654,-191,-1,-192,216,328
05003,003,05,2022,18348,-178,-2,-180,205,327
05003,003,05,2023,18262,36,-2,34,199,315
05005,005,05,2020,41686,198,0,198,77,196
05005,005,05,2021,42224,1099,-1,1098,344,861
05005,005,05,2022,42485,799,-5,794,348,911
05005,005,05,2023,42875,843,-4,839,349,801
05007,007,05,2020,286618,1954,34,1988,916,491
05007,007,05,2021,294297,6395,329,6724,3564,2453
05007,007,05,2022,302822,6089,885,6974,3882,2551
05007,007,05,2023,311013,5376,1096,6472,3908,2211
05009,009,05,2020,37381,37,0,37,91,121
05009,009,05,2021,37894,706,4,710,381,566
05009,009,05,2022,38280,568,-4,564,406,583
05009,009,05,2023,38530,376,-2,374,406,526
05011,011,05,2020,10495,-33,0,-33,28,44
05011,011,05,2021,10343,-87,-1,-88,110,174
05011,011,05,2022,10168,-127,-4,-131,118,163
05011,011,05,2023,10104,-24,-5,-29,118,154
05013,013,05,2020,4736,0,0,0,16,22
05013,013,05,2021,4728,39,0,39,41,86
05013,013,05,2022,4687,-2,0,-2,52,89
05013,013,05,2023,4641,-8,0,-8,51,88
05015,015,05,2020,28240,-22,0,-22,84,84
05015,015,05,2021,28539,296,41,337,348,385
05015,015,05,2022,28717,216,26,242,328,404
05015,015,05,2023,28814,104,36,140,326,371
05017,017,05,2020,10156,-41,0,-41,28,37
05017,017,05,2021,10052,-26,0,-26,99,185
05017,017,05,2022,9834,-127,-1,-128,91,182
05017,017,05,2023,9538,-209,-1,-210,88,173
05019,019,05,2020,21385,-50,0,-50,60,68
05019,019,05,2021,21244,-88,4,-84,240,300
05019,019,05,2022,21276,103,4,107,239,302
05019,019,05,2023,21274,40,8,48,239,289
05021,021,05,2020,14529,-14,0,-14,40,47
05021,021,05,2021,14362,-51,0,-51,172,292
05021,021,05,2022,14271,16,-2,14,164,263
05021,021,05,2023,14201,17,-2,15,157,242
05023,023,05,2020,24704,33,0,33,48,89
05023,023,05,2021,25028,608,-1,607,212,474
05023,023,05,2022,25253,452,-3,449,219,466
05023,023,05,2023,25445,399,-3,396,223,427
05025,025,05,2020,7552,14,0,14,16,28
05025,025,05,2021,7486,-9,0,-9,74,136
05025,025,05,2022,7467,36,1,37,81,135
05025,025,05,2023,7378,-41,1,-40,82,129
05027,027,05,2020,22744,-36,0,-36,57,79
05027,027,05,2021,22490,-157,6,-151,268,370
05027,027,05,2022,22286,-165,15,-150,274,319
05027,027,05,2023,22150,-114,20,-94,256,298
05029,029,05,2020,20730,34,0,34,46,61
05029,029,05,2021,20902,260,11,271,208,309
05029,029,05,2022,21021,187,18,205,232,316
05029,029,05,2023,21077,98,26,124,228,298
05031,031,05,2020,111619,272,4,276,356,264
05031,031,05,2021,111794,-180,35,-145,1511,1232
05031,031,05,2022,112863,721,48,769,1553,1219
05031,031,05,2023,113993,617,61,678,1540,1091
05033,033,05,2020,60142,2,2,4,172,168
05033,033,05,2021,60430,326,63,389,726,857
05033,033,05,2022,61041,648,126,774,725,875
05033,033,05,2023,61891,752,151,903,727,779
05035,035,05,2020,48076,-85,0,-85,156,156
05035,035,05,2021,47438,-611,11,-600,672,700
05035,035,05,2022,47051,-436,30,-406,703,674
05035,035,05,2023,47139,106,32,138,570,620
05037,037,05,2020,16795,-36,0,-36,50,45
05037,037,05,2021,16672,-32,3,-29,187,290
05037,037,05,2022,16590,-22,30,8,189,271
05037,037,05,2023,16420,-120,30,-90,183,265
05039,039,05,2020,6444,-23,0,-23,15,27
05039,039,05,2021,6309,-70,-1,-71,72,135
05039,039,05,2022,6196,-49,-1,-50,57,119
05039,039,05,2023,6185,54,-1,53,57,120
05041,041,05,2020,11324,-58,1,-57,27,39
05041,041,05,2021,11048,-203,12,-191,115,194
05041,041,05,2022,10758,-235,6,-229,111,178
05041,041,05,2023,10479,-235,9,-226,113,164
05043,043,05,2020,17313,-34,0,-34,64,65
05043,043,05,2021,17057,-186,-1,-187,199,268
05043,043,05,2022,16912,-112,8,-104,195,233
05043,043,05,2023,16945,56,9,65,193,226
05045,045,05,2020,123820,153,3,156,379,250
05045,045,05,2021,125608,1475,76,1551,1434,1212
05045,045,05,2022,127565,1616,120,1736,1469,1247
05045,045,05,2023,129951,1892,145,2037,1468,1117
05047,047,05,2020,17139,51,0,51,47,62
05047,047,05,2021,17166,112,1,113,187,282
05047,047,05,2022,17270,195,0,195,189,278
05047,047,05,2023,17468,270,0,270,188,258
05049,049,05,2020,12054,-7,1,-6,26,42
05049,049,05,2021,12147,223,3,226,118,247
05049,049,05,2022,12355,328,-1,327,118,250
05049,049,05,2023,12421,184,-1,183,117,235
05051,051,05,2020,100258,204,2,206,230,353
05051,051,05,2021,100393,806,40,846,956,1690
05051,051,05,2022,99982,372,55,427,969,1763
05051,051,05,2023,99784,295,74,369,970,1535
05053,053,05,2020,18018,50,0,50,46,39
05053,053,05,2021,18123,184,2,186,205,291
05053,053,05,2022,18129,107,7,114,183,284
05053,053,05,2023,18383,324,7,331,184,258
05055,055,05,2020,45864,82,0,82,151,115
05055,055,05,2021,46341,559,-3,556,523,609
05055,055,05,2022,46408,185,4,189,523,622
05055,055,05,2023,46743,361,6,367,526,562
05057,057,05,2020,19989,-71,0,-71,54,61
05057,057,05,2021,19667,-277,2,-275,247,292
05057,057,05,2022,19481,-209,6,-203,309,289
05057,057,05,2023,19343,-91,17,-74,214,281
05059,059,05,2020,33075,52,0,52,74,101
05059,059,05,2021,33079,245,4,249,298,552
05059,059,05,2022,33149,292,-1,291,308,529
05059,059,05,2023,33258,279,-1,278,304,475
05061,061,05,2020,12757,-22,0,-22,30,38
05061,061,05,2021,12695,-40,2,-38,159,190
05061,061,05,2022,12622,-95,2,-93,202,182
05061,061,05,2023,12533,-58,4,-54,139,175
05063,063,05,2020,37940,-9,0,-9,109,103
05063,063,05,2021,38100,270,2,272,438,553
05063,063,05,2022,38254,243,1,244,471,544
05063,063,05,2023,38320,78,2,80,474,487
05065,065,05,2020,13602,43,0,43,33,48
05065,065,05,2021,13921,500,-1,499,103,260
05065,065,05,2022,14029,253,-2,251,114,259
05065,065,05,2023,14169,266,-2,264,113,238
05067,067,05,2020,16761,6,0,6,41,56
05067,067,05,2021,16781,159,0,159,149,290
05067,067,05,2022,16654,-20,6,-14,154,257
05067,067,05,2023,16784,217,7,224,157,252
05069,069,05,2020,66830,-339,2,-337,198,257
05069,069,05,2021,65637,-915,24,-891,757,1044
05069,069,05,2022,64295,-1133,54,-1079,707,997
05069,069,05,2023,63661,-524,83,-441,723,916
05071,071,05,2020,25724,-33,0,-33,76,71
05071,071,05,2021,25957,261,11,272,294,340
05071,071,05,2022,25970,70,18,88,298,357
05071,071,05,2023,26129,177,20,197,296,334
05073,073,05,2020,6293,-1,0,-1,14,25
05073,073,05,2021,6159,-88,7,-81,66,120
05073,073,05,2022,6129,-6,18,12,68,106
05073,073,05,2023,6095,3,28,31,42,106
05075,075,05,2020,16218,19,0,19,38,62
05075,075,05,2021,16329,193,3,196,174,259
05075,075,05,2022,16194,-77,8,-69,198,254
05075,075,05,2023,16318,164,9,173,192,239
05077,077,05,2020,8526,-51,1,-50,23,36
05077,077,05,2021,8560,119,6,125,80,167
05077,077,05,2022,8367,-132,5,-127,80,150
05077,077,05,2023,8201,-118,11,-107,82,139
05079,079,05,2020,12890,-23,0,-23,27,51
05079,079,05,2021,13168,360,2,362,109,176
05079,079,05,2022,12910,-187,-1,-188,101,178
05079,079,05,2023,12898,59,-2,57,100,170
05081,081,05,2020,11974,-33,0,-33,29,47
05081,081,05,2021,11973,53,0,53,162,219
05081,081,05,2022,11865,-43,-2,-45,147,201
05081,081,05,2023,11805,41,-2,39,95,194
05083,083,05,2020,21100,0,0,0,44,75
05083,083,05,2021,21229,235,1,236,250,361
05083,083,05,2022,21258,153,1,154,258,386
05083,083,05,2023,21400,244,2,246,260,362
05085,085,05,2020,74055,34,0,34,175,194
05085,085,05,2021,74770,660,15,675,844,829
05085,085,05,2022,75199,420,26,446,891,861
05085,085,05,2023,75944,606,43,649,886,789
05087,087,05,2020,16545,24,0,24,39,39
05087,087,05,2021,16944,407,3,410,231,231
05087,087,05,2022,17463,530,13,543,219,260
05087,087,05,2023,17775,331,13,344,217,248
05089,089,05,2020,16873,89,0,89,26,62
05089,089,05,2021,16984,303,0,303,131,312
05089,089,05,2022,17289,462,-2,460,139,316
05089,089,05,2023,17514,392,-2,390,137,301
05091,091,05,2020,42588,-16,0,-16,132,139
05091,091,05,2021,42494,13,-5,8,499,628
05091,091,05,2022,42608,174,-29,145,621,641
05091,091,05,2023,42415,52,-29,23,356,573
05093,093,05,2020,40538,-141,0,-141,139,135
05093,093,05,2021,39534,-834,5,-829,536,682
05093,093,05,2022,38863,-617,16,-601,530,610
05093,093,05,2023,38663,-173,17,-156,526,571
05095,095,05,2020,6776,-26,0,-26,24,21
05095,095,05,2021,6648,-42,-1,-43,69,153
05095,095,05,2022,6568,-27,0,-27,85,137
05095,095,05,2023,6512,-8,0,-8,86,134
05097,097,05,2020,8485,10,0,10,23,30
05097,097,05,2021,8635,246,0,246,95,180
05097,097,05,2022,8543,9,-1,8,78,175
05097,097,05,2023,8620,163,-1,162,80,162
05099,099,05,2020,8284,-14,0,-14,16,30
05099,099,05,2021,8184,-41,0,-41,72,132
05099,099,05,2022,8179,42,-2,40,79,122
05099,099,05,2023,8120,-10,-2,-12,75,121
05101,101,05,2020,7196,-12,0,-12,15,33
05101,101,05,2021,7167,55,0,55,59,144
05101,101,05,2022,7101,0,0,0,67,132
05101,101,05,2023,7071,26,0,26,67,123
05103,103,05,2020,22615,-24,0,-24,70,84
05103,103,05,2021,22312,-125,0,-125,235,423
05103,103,05,2022,21994,-159,0,-159,249,402
05103,103,05,2023,21793,-79,0,-79,247,370
05105,105,05,2020,9997,-9,0,-9,23,37
05105,105,05,2021,9995,38,1,39,84,131
05105,105,05,2022,10073,127,5,132,99,155
05105,105,05,2023,10184,157,6,163,99,151
05107,107,05,2020,16440,-85,0,-85,40,75
05107,107,05,2021,15825,-490,0,-490,233,337
05107,107,05,2022,15350,-428,27,-401,207,292
05107,107,05,2023,14961,-350,31,-319,208,278
05109,109,05,2020,10162,-4,0,-4,27,31
05109,109,05,2021,10114,-5,0,-5,122,168
05109,109,05,2022,10159,114,2,116,115,180
05109,109,05,2023,10208,105,2,107,113,170
05111,111,05,2020,22954,-26,0,-26,81,67
05111,111,05,2021,22691,-105,8,-97,272,452
05111,111,05,2022,22453,-130,27,-103,292,425
05111,111,05,2023,22397,15,35,50,292,398
05113,113,05,2020,19177,-25,0,-25,52,65
05113,113,05,2021,19333,292,2,294,204,340
05113,113,05,2022,19334,148,5,153,204,357
05113,113,05,2023,19436,208,11,219,202,316
05115,115,05,2020,63410,10,0,10,175,182
05115,115,05,2021,63778,387,19,406,696,770
05115,115,05,2022,64053,313,20,333,730,760
05115,115,05,2023,64593,478,23,501,729,682
05117,117,05,2020,8249,-19,0,-19,15,33
05117,117,05,2021,8095,-72,0,-72,69,152
05117,117,05,2022,8077,57,-1,56,79,151
05117,117,05,2023,8036,23,-1,22,79,143
05119,119,05,2020,399274,-116,17,-99,1188,1085
05119,119,05,2021,398108,-1758,167,-1591,4935,4723
05119,119,05,2022,399387,804,378,1182,4979,4737
05119,119,05,2023,400009,-804,489,-315,5002,4064
05121,121,05,2020,18595,21,0,21,54,59
05121,121,05,2021,18839,305,25,330,218,303
05121,121,05,2022,18852,20,30,50,259,285
05121,121,05,2023,18907,41,32,73,246,265
05123,123,05,2020,23021,-53,0,-53,60,79
05123,123,05,2021,22715,-308,24,-284,300,321
05123,123,05,2022,22402,-285,38,-247,282,344
05123,123,05,2023,22101,-282,42,-240,269,329
05125,125,05,2020,123826,352,1,353,332,295
05125,125,05,2021,125382,1681,14,1695,1331,1472
05125,125,05,2022,127415,2114,58,2172,1417,1575
05125,125,05,2023,129574,2050,86,2136,1414,1385
05127,127,05,2020,9834,-6,0,-6,33,32
05127,127,05,2021,9795,23,0,23,110,175
05127,127,05,2022,9796,68,1,69,121,186
05127,127,05,2023,9851,107,1,108,122,178
05129,129,05,2020,7840,10,0,10,25,24
05129,129,05,2021,7893,124,1,125,72,141
05129,129,05,2022,7906,99,1,100,72,159
05129,129,05,2023,7806,-21,1,-20,74,154
05131,131,05,2020,127808,-66,4,-62,373,336
05131,131,05,2021,128342,587,69,656,1545,1737
05131,131,05,2022,129109,736,124,860,1614,1692
05131,131,05,2023,129098,-286,181,-105,1604,1511
05133,133,05,2020,15778,-68,1,-67,48,40
05133,133,05,2021,15714,-69,5,-64,221,228
05133,133,05,2022,15738,-14,-2,-16,262,215
05133,133,05,2023,15632,-91,5,-86,180,201
05135,135,05,2020,17314,63,0,63,45,64
05135,135,05,2021,17691,532,1,533,180,315
05135,135,05,2022,17836,284,0,284,186,336
05135,135,05,2023,17968,254,0,254,180,302
05137,137,05,2020,12349,32,0,32,25,60
05137,137,05,2021,12441,204,-2,202,119,225
05137,137,05,2022,12585,262,-6,256,126,244
05137,137,05,2023,12671,188,-6,182,126,220
05139,139,05,2020,38931,-71,0,-71,99,149
05139,139,05,2021,38375,-369,6,-363,440,635
05139,139,05,2022,37813,-458,37,-421,467,618
05139,139,05,2023,37397,-358,53,-305,462,573
05141,141,05,2020,15799,33,0,33,36,64
05141,141,05,2021,15777,105,2,107,137,270
05141,141,05,2022,16103,485,7,492,141,324
05141,141,05,2023,16142,189,7,196,140,298
05143,143,05,2020,246774,591,17,608,741,467
05143,143,05,2021,251767,3720,248,3968,3059,1987
05143,143,05,2022,256682,2788,912,3700,3244,2106
05143,143,05,2023,261549,2296,1125,3421,3279,1869
05145,145,05,2020,76860,33,2,35,200,225
05145,145,05,2021,77109,428,24,452,831,1078
05145,145,05,2022,77616,711,37,748,898,1119
05145,145,05,2023,78452,886,42,928,902,990
05147,147,05,2020,6224,-32,0,-32,13,25
05147,147,05,2021,6146,-28,0,-28,66,119
05147,147,05,2022,6057,-53,0,-53,69,106
05147,147,05,2023,5964,-61,0,-61,70,102
05149,149,05,2020,20212,-44,2,-42,57,58
05149,149,05,2021,20135,-40,19,-21,250,319
05149,149,05,2022,20091,-11,22,11,255,299
05149,149,05,2023,20044,-53,27,-26,254,277
06001,001,06,2020,1680466,-3845,160,-3685,4368,2755
06001,001,06,2021,1644047,-43641,4234,-39407,16743,11819
06001,001,06,2022,1628259,-33468,11409,-22059,16847,11100
06001,001,06,2023,1622188,-24633,12740,-11893,16418,10571
06003,003,06,2020,1205,3,0,3,3,3
06003,003,06,2021,1229,45,0,45,10,27
06003,003,06,2022,1190,-36,1,-35,10,15
06003,003,06,2023,1141,-33,1,-32,7,22
06005,005,06,2020,40525,135,0,135,54,126
06005,005,06,2021,41228,926,8,934,320,513
06005,005,06,2022,41493,451,19,470,335,552
06005,005,06,2023,41811,517,25,542,331,553
06007,007,06,2020,210151,-1307,1,-1306,488,514
06007,007,06,2021,206336,-3279,64,-3215,2006,2501
06007,007,06,2022,207369,1289,198,1487,2016,2500
06007,007,06,2023,207172,12,238,250,1947,2388
06009,009,06,2020,45348,122,0,122,88,128
06009,009,06,2021,46249,1165,8,1173,367,591
06009,009,06,2022,46556,496,15,511,388,610
06009,009,06,2023,46565,214,15,229,376,594
06011,011,06,2020,21864,-4,0,-4,64,38
06011,011,06,2021,21919,-64,6,-58,294,193
06011,011,06,2022,21909,-114,3,-111,287,186
06011,011,06,2023,22037,2,31,33,283,188
06013,013,06,2020,1166069,-1000,131,-869,2939,2151
06013,013,06,2021,1163941,-6791,1675,-5116,11760,9260
06013,013,06,2022,1157019,-14649,4660,-9989,11774,8998
06013,013,06,2023,1155025,-10314,5258,-5056,11573,8599
06015,015,06,2020,27604,-119,0,-119,72,72
06015,015,06,2021,27584,25,11,36,260,330
06015,015,06,2022,27112,-407,1,-406,261,343
06015,015,06,2023,26589,-404,2,-402,236,359
06017,017,06,2020,191245,31,0,31,395,408
06017,017,06,2021,193704,2758,86,2844,1512,1846
06017,017,06,2022,192787,-817,173,-644,1594,1808
06017,017,06,2023,192215,-530,216,-314,1495,1748
06019,019,06,2020,1009552,-827,4,-823,3319,1874
06019,019,06,2021,1013103,-1833,560,-1273,13656,9524
06019,019,06,2022,1015359,-4302,1710,-2592,14101,8900
06019,019,06,2023,1017162,-6015,2261,-3754,13879,8384
06021,021,06,2020,28904,-53,0,-53,92,55
06021,021,06,2021,28718,-261,10,-251,372,309
06021,021,06,2022,28360,-415,8,-407,364,329
06021,021,06,2023,28129,-287,28,-259,354,327
06023,023,06,2020,136262,-182,0,-182,298,335
06023,023,06,2021,134897,-1129,40,-1089,1222,1510
06023,023,06,2022,134944,334,111,445,1239,1613
06023,023,06,2023,133985,-744,131,-613,1225,1566
06025,025,06,2020,179612,-233,7,-226,536,432
06025,025,06,2021,179138,-1109,53,-1056,2318,1795
06025,025,06,2022,178940,-1417,182,-1235,2487,1449
06025,025,06,2023,179057,-1410,493,-917,2424,1403
06027,027,06,2020,18987,-7,0,-7,28,55
06027,027,06,2021,18924,-41,2,-39,175,212
06027,027,06,2022,18742,-152,0,-152,166,188
06027,027,06,2023,18527,-154,1,-153,161,222
06029,029,06,2020,905910,-3897,-17,-3914,2944,1721
06029,029,06,2021,912709,1956,320,2276,12252,8360
06029,029,06,2022,916751,-1383,1149,-234,12751,8070
06029,029,06,2023,913820,-9169,1659,-7510,12077,7622
06031,031,06,2020,152844,-12,2,-10,559,249
06031,031,06,2021,152775,-1086,-1,-1087,2174,1205
06031,031,06,2022,152987,-691,55,-636,2118,1184
06031,031,06,2023,152682,-1465,188,-1277,2084,1116
06033,033,06,2020,68199,49,0,49,168,185
06033,033,06,2021,68645,681,14,695,682,926
06033,033,06,2022,68172,-183,39,-144,683,977
06033,033,06,2023,67878,-61,57,-4,683,972
06035,035,06,2020,32315,-351,0,-351,67,58
06035,035,06,2021,31885,-489,4,-485,302,224
06035,035,06,2022,30020,-2118,32,-2086,289,234
06035,035,06,2023,28861,-1179,36,-1143,264,287
06037,037,06,2020,9992813,-25491,156,-25335,23767,19922
06037,037,06,2021,9809462,-194712,12107,-182605,94553,88930
06037,037,06,2022,9719765,-143724,34341,-109383,96988,77365
06037,037,06,2023,9663345,-119037,40388,-78649,95354,73138
06039,039,06,2020,156345,-120,0,-120,486,283
06039,039,06,2021,158966,2025,-26,1999,2079,1437
06039,039,06,2022,160329,736,30,766,2110,1458
06039,039,06,2023,162858,1744,119,1863,2078,1419
06041,041,06,2020,261306,-879,3,-876,507,529
06041,041,06,2021,259278,-2386,388,-1998,2185,2244
06041,041,06,2022,256154,-4319,940,-3379,2301,2168
06041,041,06,2023,254407,-2953,1038,-1915,2255,2088
06043,043,06,2020,17119,3,0,3,36,44
06043,043,06,2021,17127,80,5,85,142,222
06043,043,06,2022,17053,-23,34,11,155,235
06043,043,06,2023,16919,-106,54,-52,145,225
06045,045,06,2020,91367,-199,0,-199,219,232
06045,045,06,2021,91321,65,47,112,906,1104
06045,045,06,2022,90007,-1258,69,-1189,907,1047
06045,045,06,2023,89108,-871,129,-742,856,1013
06047,047,06,2020,281830,123,3,126,906,528
06047,047,06,2021,284610,1053,116,1169,3820,2364
06047,047,06,2022,290210,3446,383,3829,3897,2254
06047,047,06,2023,291920,-593,660,67,3787,2169
06049,049,06,2020,8681,-11,0,-11,15,27
06049,049,06,2021,8641,-6,3,-3,70,111
06049,049,06,2022,8619,6,10,16,71,103
06049,049,06,2023,8500,-50,13,-37,34,115
06051,051,06,2020,13228,-14,1,-13,44,7
06051,051,06,2021,13271,-48,19,-29,114,49
06051,051,06,2022,13002,-422,66,-356,129,51
06051,051,06,2023,13066,-78,90,12,114,61
06053,053,06,2020,438322,-1401,8,-1393,1456,693
06053,053,06,2021,437158,-3564,247,-3317,5374,3338
06053,053,06,2022,432884,-7930,816,-7114,5584,2982
06053,053,06,2023,430723,-6190,1340,-4850,5548,2857
06055,055,06,2020,137459,-474,0,-474,299,330
06055,055,06,2021,136265,-1148,41,-1107,1212,1327
06055,055,06,2022,134370,-2021,205,-1816,1185,1309
06055,055,06,2023,133216,-1339,279,-1060,1167,1262
06057,057,06,2020,102265,117,0,117,205,271
06057,057,06,2021,103517,1748,2,1750,797,1216
06057,057,06,2022,102401,-788,33,-755,817,1139
06057,057,06,2023,102037,-39,50,11,741,1110
06059,059,06,2020,3185734,-4224,77,-4147,7632,5294
06059,059,06,2021,3160611,-32784,3839,-28945,30035,26407
06059,059,06,2022,3150372,-27681,11011,-16670,31084,23944
06059,059,06,2023,3135755,-35597,12859,-22738,30677,22619
06061,061,06,2020,405927,1075,2,1077,888,831
06061,061,06,2021,413047,7246,217,7463,3580,3803
06061,061,06,2022,418074,4590,675,5265,3816,3923
06061,061,06,2023,423561,4920,790,5710,3607,3803
06063,063,06,2020,19746,-17,0,-17,32,64
06063,063,06,2021,19958,274,2,276,166,213
06063,063,06,2022,19443,-522,16,-506,161,178
06063,063,06,2023,19131,-257,19,-238,145,216
06065,065,06,2020,2422993,2407,27,2434,6377,4826
06065,065,06,2021,2453399,25998,643,26641,27112,23863
06065,065,06,2022,2474241,13039,2275,15314,27814,21705
06065,065,06,2023,2492442,7807,3378,11185,27497,20536
06067,067,06,2020,1586566,-663,177,-486,4497,3077
06067,067,06,2021,1588810,-5074,2428,-2646,17913,14077
06067,067,06,2022,1584380,-15700,6897,-8803,18391,13765
06067,067,06,2023,1584288,-12390,7784,-4606,17698,13202
06069,069,06,2020,64530,251,0,251,170,102
06069,069,06,2021,66709,1945,-12,1933,756,446
06069,069,06,2022,67643,534,-4,530,873,474
06069,069,06,2023,68175,126,17,143,850,462
06071,071,06,2020,2183391,-1347,12,-1335,6513,4013
06071,071,06,2021,2193087,2597,607,3204,26277,21385
06071,071,06,2022,2194908,-7940,2279,-5661,26741,18392
06071,071,06,2023,2195611,-11384,3211,-8173,26188,17486
06073,073,06,2020,3295298,-6905,161,-6744,9170,5945
06073,073,06,2021,3274432,-33741,2708,-31033,36651,26911
06073,073,06,2022,3277176,-15956,8431,-7525,38064,25494
06073,073,06,2023,3269973,-30745,10767,-19978,37145,24263
06075,075,06,2020,870518,-3744,84,-3660,2098,1601
06075,075,06,2021,811935,-57177,2041,-55136,7532,6790
06075,075,06,2022,807774,-10206,5601,-4605,7343,6510
06075,075,06,2023,808988,-5925,6201,276,7240,6200
06077,077,06,2020,780617,175,35,210,2394,1502
06077,077,06,2021,788354,4537,678,5215,9661,7511
06077,077,06,2022,794293,611,2368,2979,10133,6690
06077,077,06,2023,800965,386,2983,3369,9570,6313
06079,079,06,2020,281884,-515,0,-515,608,609
06079,079,06,2021,279464,-2210,77,-2133,2372,2679
06079,079,06,2022,282046,2461,235,2696,2445,2676
06079,079,06,2023,281639,-568,332,-236,2389,2563
06081,081,06,2020,762479,-2538,101,-2437,1890,1319
06081,081,06,2021,739149,-25829,1716,-24113,7437,5299
06081,081,06,2022,728929,-17841,4718,-13123,7537,5131
06081,081,06,2023,726353,-10335,5269,-5066,7394,4872
06083,083,06,2020,448424,-445,22,-423,1328,819
06083,083,06,2021,437521,-12215,440,-11775,5305,3733
06083,083,06,2022,443915,3061,1074,4135,5599,3547
06083,083,06,2023,441257,-6246,1424,-4822,5560,3423
06085,085,06,2020,1931168,-7099,191,-6908,4882,2763
06085,085,06,2021,1885173,-56757,6704,-50053,18827,12068
06085,085,06,2022,1878335,-33302,18322,-14980,19424,11300
06085,085,06,2023,1877592,-29077,20405,-8672,18707,10741
06087,087,06,2020,270474,-556,4,-552,552,404
06087,087,06,2021,260475,-9536,94,-9442,2184,2127
06087,087,06,2022,264240,2898,283,3181,2301,1989
06087,087,06,2023,261547,-3455,396,-3059,2261,1903
06089,089,06,2020,182002,-92,1,-91,460,563
06089,089,06,2021,182135,761,95,856,1806,2616
06089,089,06,2022,180937,-457,220,-237,1806,2675
06089,089,06,2023,180366,-15,254,239,1734,2543
06091,091,06,2020,3225,-4,0,-4,6,8
06091,091,06,2021,3294,84,0,84,24,35
06091,091,06,2022,3222,-64,0,-64,25,32
06091,091,06,2023,3200,-11,0,-11,23,34
06093,093,06,2020,43995,-37,0,-37,92,139
06093,093,06,2021,44139,344,7,351,428,637
06093,093,06,2022,43786,-76,17,-59,370,638
06093,093,06,2023,42905,-579,22,-557,323,644
06095,095,06,2020,452723,-991,0,-991,1209,950
06095,095,06,2021,450653,-3420,315,-3105,4911,3995
06095,095,06,2022,448885,-3754,1101,-2653,4960,4007
06095,095,06,2023,449218,-1965,1312,-653,4792,3819
06097,097,06,2020,488282,-668,5,-663,1151,1076
06097,097,06,2021,484519,-3858,228,-3630,4420,4657
06097,097,06,2022,482669,-2089,579,-1510,4543,4595
06097,097,06,2023,481812,-1765,813,-952,4480,4388
06099,099,06,2020,553257,-466,6,-460,1761,1051
06099,099,06,2021,552723,-2280,321,-1959,6906,5765
06099,099,06,2022,551226,-4404,931,-3473,7253,5252
06099,099,06,2023,551430,-3144,1229,-1915,7077,5013
06101,101,06,2020,99479,-225,3,-222,295,225
06101,101,06,2021,99152,-718,90,-628,1237,958
06101,101,06,2022,98569,-1096,254,-842,1231,972
06101,101,06,2023,97948,-1167,307,-860,1181,945
06103,103,06,2020,65687,-136,0,-136,171,175
06103,103,06,2021,65446,-132,-11,-143,738,876
06103,103,06,2022,65299,48,-23,25,769,900
06103,103,06,2023,64896,-274,-7,-281,745,870
06105,105,06,2020,16091,-5,0,-5,18,35
06105,105,06,2021,16082,50,-2,48,122,177
06105,105,06,2022,15778,-207,-6,-213,105,193
06105,105,06,2023,15670,-14,-5,-19,100,188
06107,107,06,2020,473914,-46,0,-46,1600,919
06107,107,06,2021,477176,423,46,469,6583,4164
06107,107,06,2022,477884,-2273,219,-2054,6846,3977
06107,107,06,2023,479468,-2119,616,-1503,6746,3712
06109,109,06,2020,55379,-132,0,-132,105,193
06109,109,06,2021,55131,100,7,107,403,783
06109,109,06,2022,54587,-158,19,-139,453,825
06109,109,06,2023,54204,-50,23,-27,437,791
06111,111,06,2020,843371,-1078,-1,-1079,2023,1533
06111,111,06,2021,839471,-5456,259,-5197,8390,7387
06111,111,06,2022,832871,-9549,923,-8626,8823,6873
06111,111,06,2023,829590,-6754,1390,-5364,8581,6524
06113,113,06,2020,216291,-297,15,-282,503,378
06113,113,06,2021,213141,-3893,513,-3380,1947,1550
06113,113,06,2022,222018,6521,1321,7842,1946,1541
06113,113,06,2023,220544,-3414,1523,-1891,1900,1507
06115,115,06,2020,81958,233,2,235,286,148
06115,115,06,2021,83227,919,23,942,1106,782
06115,115,06,2022,84353,606,89,695,1212,780
06115,115,06,2023,85722,805,130,935,1177,746
08001,001,08,2020,520500,53,36,89,1643,965
08001,001,08,2021,523544,-535,481,-54,6631,3869
08001,001,08,2022,527509,348,1130,1478,6838,4209
08001,001,08,2023,533365,1717,1241,2958,6534,3680
08003,003,08,2020,16377,-18,0,-18,54,42
08003,003,08,2021,16579,161,10,171,192,166
08003,003,08,2022,16587,-5,25,20,189,193
08003,003,08,2023,16655,35,24,59,191,183
08005,005,08,2020,655272,-536,89,-447,1904,1484
08005,005,08,2021,656855,-2683,968,-1715,7592,4703
08005,005,08,2022,656269,-5566,2683,-2883,7677,5154
08005,005,08,2023,656061,-6254,3029,-3225,7639,4633
08007,007,08,2020,13424,73,0,73,28,24
08007,007,08,2021,13806,406,2,408,119,126
08007,007,08,2022,13989,202,8,210,102,142
08007,007,08,2023,14189,236,7,243,104,146
08009,009,08,2020,3480,-13,0,-13,5,20
08009,009,08,2021,3490,46,1,47,35,72
08009,009,08,2022,3435,-20,6,-14,37,76
08009,009,08,2023,3344,-52,7,-45,30,75
08011,011,08,2020,5473,-132,0,-132,7,21
08011,011,08,2021,5339,-84,0,-84,36,77
08011,011,08,2022,5439,131,0,131,36,77
08011,011,08,2023,5681,273,0,273,39,73
08013,013,08,2020,330938,-23,23,0,623,571
08013,013,08,2021,327084,-4415,334,-4081,2481,2144
08013,013,08,2022,327339,-538,819,281,2478,2270
08013,013,08,2023,326831,-1919,960,-959,2486,2038
08014,014,08,2020,74490,409,1,410,150,149
08014,014,08,2021,75411,643,58,701,654,452
08014,014,08,2022,76195,482,126,608,651,469
08014,014,08,2023,76860,341,142,483,643,461
08015,015,08,2020,19484,44,0,44,33,67
08015,015,08,2021,19741,287,4,291,149,172
08015,015,08,2022,20265,510,4,514,151,187
08015,015,08,2023,20617,379,5,384,150,184
08017,017,08,2020,1746,-7,0,-7,8,5
08017,017,08,2021,1719,-27,4,-23,21,24
08017,017,08,2022,1731,15,10,25,14,26
08017,017,08,2023,1727,-3,10,7,14,26
08019,019,08,2020,9393,6,0,6,15,19
08019,019,08,2021,9457,60,3,63,72,65
08019,019,08,2022,9367,-80,2,-78,67,71
08019,019,08,2023,9147,-206,2,-204,54,69
08021,021,08,2020,7451,-9,0,-9,29,30
08021,021,08,2021,7582,142,0,142,99,107
08021,021,08,2022,7587,21,-1,20,101,113
08021,021,08,2023,7521,-56,-1,-57,99,107
08023,023,08,2020,3502,10,0,10,6,11
08023,023,08,2021,3613,122,-1,121,41,43
08023,023,08,2022,3615,27,0,27,35,59
08023,023,08,2023,3628,39,0,39,33,60
08025,025,08,2020,5688,-177,0,-177,4,17
08025,025,08,2021,5735,87,-1,86,30,65
08025,025,08,2022,5627,-71,-1,-72,29,68
08025,025,08,2023,5636,48,-1,47,29,67
08027,027,08,2020,4723,23,0,23,8,10
08027,027,08,2021,5063,384,0,384,40,59
08027,027,08,2022,5337,279,1,280,38,61
08027,027,08,2023,5534,215,2,217,41,61
08029,029,08,2020,31056,-82,0,-82,66,103
08029,029,08,2021,31392,532,8,540,304,495
08029,029,08,2022,31560,400,11,411,261,516
08029,029,08,2023,31746,378,11,389,273,475
08031,031,08,2020,717606,1558,49,1607,2139,1589
08031,031,08,2021,711467,-10331,703,-9628,8580,5138
08031,031,08,2022,713453,-2552,1882,-670,8332,5433
08031,031,08,2023,716577,-2599,2150,-449,8632,4981
08033,033,08,2020,2331,14,0,14,3,10
08033,033,08,2021,2375,61,0,61,16,30
08033,033,08,2022,2460,100,0,100,16,36
08033,033,08,2023,2513,69,0,69,19,35
08035,035,08,2020,360323,1984,19,2003,924,525
08035,035,08,2021,369783,7759,248,8007,3529,1899
08035,035,08,2022,375937,3942,562,4504,3835,2132
08035,035,08,2023,383906,5465,660,6125,3812,1954
08037,037,08,2020,55657,-149,5,-144,126,40
08037,037,08,2021,55774,-303,38,-265,518,170
08037,037,08,2022,55218,-975,68,-907,520,187
08037,037,08,2023,54381,-1242,75,-1167,515,185
08039,039,08,2020,26216,162,0,162,50,39
08039,039,08,2021,27159,935,4,939,224,189
08039,039,08,2022,27842,629,1,630,263,219
08039,039,08,2023,28806,924,2,926,263,219
08041,041,08,2020,732384,974,-13,961,2203,1331
08041,041,08,2021,737287,911,53,964,9301,5877
08041,041,08,2022,740596,9,538,547,9193,6161
08041,041,08,2023,744215,-619,777,158,9147,5702
08043,043,08,2020,48878,-12,0,-12,98,147
08043,043,08,2021,49237,653,7,660,383,680
08043,043,08,2022,49616,703,1,704,366,743
08043,043,08,2023,50318,1014,6,1020,351,676
08045,045,08,2020,61794,-12,3,-9,180,84
08045,045,08,2021,62107,-73,47,-26,732,431
08045,045,08,2022,62256,-249,148,-101,717,438
08045,045,08,2023,62707,-6,155,149,714,412
08047,047,08,2020,5820,6,1,7,17,9
08047,047,08,2021,5893,65,8,73,35,34
08047,047,08,2022,5886,-32,25,-7,45,41
08047,047,08,2023,5926,5,28,33,48,41
08049,049,08,2020,15747,7,0,7,39,13
08049,049,08,2021,15851,83,9,92,113,100
08049,049,08,2022,15734,-146,27,-119,118,108
08049,049,08,2023,15935,152,29,181,121,103
08051,051,08,2020,16950,24,0,24,30,26
08051,051,08,2021,17294,300,1,301,132,79
08051,051,08,2022,17320,-18,4,-14,137,89
08051,051,08,2023,17321,-53,6,-47,134,85
08053,053,08,2020,788,7,0,7,0,2
08053,053,08,2021,773,-11,0,-11,2,5
08053,053,08,2022,771,3,0,3,2,8
08053,053,08,2023,765,-5,0,-5,4,5
08055,055,08,2020,6827,25,0,25,16,28
08055,055,08,2021,6934,211,-1,210,42,134
08055,055,08,2022,7097,244,-1,243,44,140
08055,055,08,2023,7055,53,-1,52,40,135
08057,057,08,2020,1379,-2,0,-2,3,3
08057,057,08,2021,1359,-9,0,-9,6,16
08057,057,08,2022,1314,-46,0,-46,11,12
08057,057,08,2023,1309,2,0,2,6,13
08059,059,08,2020,583081,-75,11,-64,1460,1336
08059,059,08,2021,580703,-2960,225,-2735,5396,5402
08059,059,08,2022,575811,-5000,580,-4420,5474,5617
08059,059,08,2023,576366,-584,662,78,5493,4997
08061,061,08,2020,1455,8,0,8,0,3
08061,061,08,2021,1454,0,0,0,19,20
08061,061,08,2022,1434,-18,1,-17,18,21
08061,061,08,2023,1384,-50,1,-49,20,21
08063,063,08,2020,7062,-13,0,-13,20,26
08063,063,08,2021,6927,-119,0,-119,82,95
08063,063,08,2022,6983,33,30,63,96,99
08063,063,08,2023,6994,-17,31,14,93,95
08065,065,08,2020,7408,-30,0,-30,15,8
08065,065,08,2021,7395,-38,1,-37,71,51
08065,065,08,2022,7346,-97,12,-85,85,45
08065,065,08,2023,7365,-31,12,-19,85,46
08067,067,08,2020,55673,1,0,1,119,103
08067,067,08,2021,56169,482,10,492,435,442
08067,067,08,2022,56553,371,27,398,426,462
08067,067,08,2023,56407,-134,29,-105,414,455
08069,069,08,2020,359923,656,3,659,790,652
08069,069,08,2021,362747,2202,180,2382,3039,2753
08069,069,08,2022,367577,4148,400,4548,3111,2968
08069,069,08,2023,370771,2249,471,2720,3094,2638
08071,071,08,2020,14490,-36,0,-36,30,56
08071,071,08,2021,14334,-84,4,-80,130,207
08071,071,08,2022,14311,91,17,108,113,248
08071,071,08,2023,14348,147,19,166,111,243
08073,073,08,2020,5662,-6,0,-6,10,17
08073,073,08,2021,5473,-159,2,-157,40,62
08073,073,08,2022,5510,51,4,55,50,67
08073,073,08,2023,5480,-18,4,-14,52,69
08075,075,08,2020,21210,-268,0,-268,60,55
08075,075,08,2021,21006,-100,7,-93,188,307
08075,075,08,2022,20792,-143,24,-119,192,282
08075,075,08,2023,20619,-121,26,-95,192,270
08077,077,08,2020,156011,334,1,335,395,425
08077,077,08,2021,157439,1769,30,1799,1525,1903
08077,077,08,2022,158531,1561,55,1616,1445,2004
08077,077,08,2023,159681,1405,68,1473,1454,1780
08079,079,08,2020,874,8,0,8,1,2
08079,079,08,2021,929,62,0,62,4,7
08079,079,08,2022,931,3,0,3,9,10
08079,079,08,2023,944,19,0,19,7,11
08081,081,08,2020,13269,-25,1,-24,31,33
08081,081,08,2021,13165,-97,0,-97,148,159
08081,081,08,2022,13205,53,-2,51,132,137
08081,081,08,2023,13327,105,-3,102,135,113
08083,083,08,2020,25887,31,0,31,62,57
08083,083,08,2021,26234,432,16,448,261,352
08083,083,08,2022,26467,313,51,364,243,379
08083,083,08,2023,26531,124,57,181,240,357
08085,085,08,2020,42818,176,1,177,95,120
08085,085,08,2021,43236,552,24,576,381,532
08085,085,08,2022,43807,682,68,750,397,597
08085,085,08,2023,44156,424,72,496,395,542
08087,087,08,2020,29076,-51,2,-49,119,103
08087,087,08,2021,29006,-245,94,-151,382,310
08087,087,08,2022,29266,-9,198,189,407,320
08087,087,08,2023,29524,-64,218,154,407,303
08089,089,08,2020,18664,-4,0,-4,32,56
08089,089,08,2021,18527,-32,2,-30,206,322
08089,089,08,2022,18311,-132,-2,-134,203,285
08089,089,08,2023,18136,-98,-2,-100,203,279
08091,091,08,2020,4882,2,0,2,10,9
08091,091,08,2021,5063,182,1,183,39,31
08091,091,08,2022,5103,37,9,46,32,39
08091,091,08,2023,5176,71,10,81,32,40
08093,093,08,2020,17418,18,0,18,41,31
08093,093,08,2021,17744,351,2,353,127,127
08093,093,08,2022,17921,143,11,154,138,131
08093,093,08,2023,18117,177,11,188,138,132
08095,095,08,2020,4527,-4,0,-4,12,15
08095,095,08,2021,4502,-15,10,-5,58,80
08095,095,08,2022,4448,-67,35,-32,50,72
08095,095,08,2023,4476,13,36,49,51,70
08097,097,08,2020,17355,-27,1,-26,38,16
08097,097,08,2021,17337,-90,18,-72,127,82
08097,097,08,2022,16847,-600,25,-575,128,69
08097,097,08,2023,16640,-299,29,-270,130,68
08099,099,08,2020,12017,-2,0,-2,50,33
08099,099,08,2021,11990,-15,12,-3,147,179
08099,099,08,2022,11873,-129,22,-107,145,157
08099,099,08,2023,11751,-151,22,-129,142,135
08101,101,08,2020,168337,250,0,250,396,518
08101,101,08,2021,169316,1596,27,1623,1695,2370
08101,101,08,2022,169472,953,44,997,1692,2517
08101,101,08,2023,169422,485,47,532,1646,2232
08103,103,08,2020,6520,-5,0,-5,13,16
08103,103,08,2021,6442,-74,7,-67,57,66
08103,103,08,2022,6549,108,7,115,60,71
08103,103,08,2023,6569,27,7,34,58,70
08105,105,08,2020,11541,11,0,11,28,40
08105,105,08,2021,11406,-97,1,-96,122,166
08105,105,08,2022,11337,-11,-2,-13,124,179
08105,105,08,2023,11188,-97,-2,-99,121,168
08107,107,08,2020,24832,-19,0,-19,61,42
08107,107,08,2021,25058,144,10,154,181,119
08107,107,08,2022,25072,-58,22,-36,203,137
08107,107,08,2023,25064,-103,26,-77,206,137
08109,109,08,2020,6389,34,0,34,8,14
08109,109,08,2021,6511,130,0,130,65,68
08109,109,08,2022,6627,122,1,123,60,73
08109,109,08,2023,6688,73,2,75,61,76
08111,111,08,2020,711,9,0,9,1,2
08111,111,08,2021,741,35,0,35,5,7
08111,111,08,2022,806,59,0,59,8,7
08111,111,08,2023,802,-4,0,-4,6,7
08113,113,08,2020,8054,-20,0,-20,13,8
08113,113,08,2021,8080,-10,4,-6,55,25
08113,113,08,2022,8008,-102,13,-89,49,30
08113,113,08,2023,7868,-169,15,-154,48,35
08115,115,08,2020,2389,-1,0,-1,6,16
08115,115,08,2021,2326,-32,0,-32,15,46
08115,115,08,2022,2286,-8,0,-8,15,49
08115,115,08,2023,2299,40,0,40,14,40
08117,117,08,2020,31001,-95,1,-94,64,24
08117,117,08,2021,30998,-213,13,-200,251,73
08117,117,08,2022,30636,-619,82,-537,258,89
08117,117,08,2023,30465,-423,84,-339,262,89
08119,119,08,2020,24744,55,0,55,44,57
08119,119,08,2021,24945,282,5,287,167,241
08119,119,08,2022,24860,-8,9,1,181,262
08119,119,08,2023,24617,-184,9,-175,179,243
08121,121,08,2020,4813,3,0,3,7,16
08121,121,08,2021,4868,75,1,76,49,70
08121,121,08,2022,4847,-9,5,-4,53,68
08121,121,08,2023,4855,15,7,22,52,66
08123,123,08,2020,331458,2057,9,2066,1126,593
08123,123,08,2021,339897,6209,179,6388,4429,2263
08123,123,08,2022,350266,7480,480,7960,4649,2566
08123,123,08,2023,359442,6254,527,6781,4658,2286
08125,125,08,2020,9971,-10,1,-9,25,28
08125,125,08,2021,9925,-96,40,-56,132,123
08125,125,08,2022,9895,-173,109,-64,133,104
08125,125,08,2023,9862,-176,111,-65,134,102
10001,001,10,2020,182315,422,9,431,522,516
10001,001,10,2021,185043,2835,106,2941,2002,2180
10001,001,10,2022,187758,2541,283,2824,2157,2274
10001,001,10,2023,189789,1788,263,2051,2153,2169
10003,003,10,2020,570918,-9,47,38,1513,1556
10003,003,10,2021,572029,-249,695,446,6025,5801
10003,003,10,2022,575254,1531,1613,3144,6240,5829
10003,003,10,2023,578592,1203,1582,2785,6080,5527
10005,005,10,2020,238629,1782,6,1788,544,887
10005,005,10,2021,247809,10698,138,10836,2147,3247
10005,005,10,2022,256447,8597,482,9079,2486,3385
10005,005,10,2023,263509,7329,432,7761,2492,3201
11001,001,11,2020,670839,-15475,50,-15425,2187,2004
11001,001,11,2021,669037,-6551,1745,-4806,8508,5837
11001,001,11,2022,670949,-4917,4527,-390,8399,5572
11001,001,11,2023,678972,-1509,6969,5460,7627,5020
12001,001,12,2020,279737,1279,15,1294,597,540
12001,001,12,2021,281889,1384,429,1813,2521,2340
12001,001,12,2022,284041,1058,1075,2133,2649,2456
12001,001,12,2023,285994,-95,1606,1511,2679,2249
12003,003,12,2020,28116,-141,0,-141,103,72
12003,003,12,2021,28669,539,4,543,342,321
12003,003,12,2022,27786,-980,12,-968,356,364
12003,003,12,2023,28368,553,20,573,354,345
12005,005,12,2020,174525,-616,4,-612,424,471
12005,005,12,2021,179520,5406,181,5587,2017,2397
12005,005,12,2022,185210,5293,459,5752,2119,2442
12005,005,12,2023,190769,4911,707,5618,2127,2188
12007,007,12,2020,28222,-64,0,-64,76,83
12007,007,12,2021,28050,-90,0,-90,293,377
12007,007,12,2022,27296,-718,-7,-725,306,392
12007,007,12,2023,27858,632,-7,625,306,367
12009,009,12,2020,608775,3160,15,3175,1162,1924
12009,009,12,2021,617900,13112,376,13488,4860,8826
12009,009,12,2022,630707,15452,913,16365,5173,9349
12009,009,12,2023,643979,14886,1440,16326,5217,8261
12011,011,12,2020,1943398,-2367,383,-1984,4890,4277
12011,011,12,2021,1935575,-16080,6714,-9366,19378,18326
12011,011,12,2022,1946889,-7209,17333,10124,20964,18740
12011,011,12,2023,1962531,-14303,25427,11124,21028,16483
12013,013,12,2020,13707,98,0,98,28,52
12013,013,12,2021,13518,-107,5,-102,143,225
12013,013,12,2022,13465,47,8,55,132,234
12013,013,12,2023,13470,83,9,92,138,225
12015,015,12,2020,187995,1965,1,1966,255,784
12015,015,12,2021,194934,9586,114,9700,1039,3285
12015,015,12,2022,202582,9164,307,9471,1087,3462
12015,015,12,2023,206134,5057,492,5549,1095,3103
12017,017,12,2020,154568,1399,0,1399,256,763
12017,017,12,2021,158167,6262,20,6282,1017,3385
12017,017,12,2022,162508,6452,63,6515,1026,3561
12017,017,12,2023,166696,6183,113,6296,1045,3149
12019,019,12,2020,218951,679,7,686,513,526
12019,019,12,2021,222648,3927,108,4035,2129,2421
12019,019,12,2022,226634,4109,198,4307,2277,2665
12019,019,12,2023,232439,5550,333,5883,2303,2355
12021,021,12,2020,377310,1930,53,1983,743,962
12021,021,12,2021,387226,10651,890,11541,3084,4274
12021,021,12,2022,397516,8969,2231,11200,3355,4641
12021,021,12,2023,404310,4197,3382,7579,3388,4166
12023,023,12,2020,69740,40,0,40,196,189
12023,023,12,2021,69932,416,45,461,740,1042
12023,023,12,2022,71870,2099,110,2209,749,1144
12023,023,12,2023,73063,1324,163,1487,751,1045
12027,027,12,2020,34086,158,0,158,79,115
12027,027,12,2021,34333,302,39,341,361,459
12027,027,12,2022,35320,939,75,1014,402,465
12027,027,12,2023,35979,548,132,680,409,435
12029,029,12,2020,16687,-22,0,-22,21,59
12029,029,12,2021,16933,337,0,337,189,272
12029,029,12,2022,17120,326,1,327,155,304
12029,029,12,2023,17465,470,2,472,156,285
12031,031,12,2020,997784,1341,89,1430,2968,2309
12031,031,12,2021,1002774,1399,1355,2754,12449,10777
12031,031,12,2022,1017011,8817,3680,12497,12724,11195
12031,031,12,2023,1030822,5112,5507,10619,12873,9766
12033,033,12,2020,322568,697,13,710,921,980
12033,033,12,2021,323459,1364,160,1524,3715,4464
12033,033,12,2022,323860,762,507,1269,3757,4502
12033,033,12,2023,326928,2464,823,3287,3761,4012
12035,035,12,2020,116028,1041,2,1043,152,418
12035,035,12,2021,120974,6107,58,6165,769,1672
12035,035,12,2022,126758,6313,125,6438,865,1864
12035,035,12,2023,131439,5286,219,5505,874,1695
12037,037,12,2020,12468,33,0,33,15,30
12037,037,12,2021,12183,-208,0,-208,109,177
12037,037,12,2022,12492,388,1,389,89,202
12037,037,12,2023,12594,194,8,202,88,188
12039,039,12,2020,43411,-317,1,-316,109,147
12039,039,12,2021,43599,250,22,272,513,596
12039,039,12,2022,43393,-59,43,-16,487,649
12039,039,12,2023,43833,493,67,560,486,605
12041,041,12,2020,17882,27,0,27,50,53
12041,041,12,2021,18316,501,17,518,187,254
12041,041,12,2022,19002,692,39,731,207,279
12041,041,12,2023,19587,575,63,638,209,260
12043,043,12,2020,12078,-18,1,-17,15,34
12043,043,12,2021,12266,297,6,303,61,164
12043,043,12,2022,12463,255,24,279,71,165
12043,043,12,2023,12786,371,40,411,72,162
12045,045,12,2020,14259,89,0,89,32,50
12045,045,12,2021,14462,340,2,342,121,247
12045,045,12,2022,15299,885,10,895,110,247
12045,045,12,2023,15693,502,19,521,113,242
12047,047,12,2020,13729,-221,0,-221,42,42
12047,047,12,2021,13072,-563,3,-560,156,211
12047,047,12,2022,13194,171,1,172,167,220
12047,047,12,2023,13471,315,2,317,167,207
12049,049,12,2020,25339,-23,1,-22,81,57
12049,049,12,2021,25322,-97,15,-82,354,297
12049,049,12,2022,25651,287,31,318,358,351
12049,049,12,2023,25760,23,53,76,361,328
12051,051,12,2020,39723,62,4,66,121,94
12051,051,12,2021,40215,293,96,389,514,424
12051,051,12,2022,41391,760,256,1016,558,433
12051,051,12,2023,43333,1392,404,1796,562,412
12053,053,12,2020,195624,1647,3,1650,383,746
12053,053,12,2021,200693,7164,75,7239,1562,3414
12053,053,12,2022,206935,7594,221,7815,1656,3617
12053,053,12,2023,212807,7086,345,7431,1649,3199
12055,055,12,2020,101349,404,6,410,183,439
12055,055,12,2021,103279,3255,65,3320,794,2041
12055,055,12,2022,105649,3261,204,3465,857,2092
12055,055,12,2023,107614,2700,307,3007,870,1907
12057,057,12,2020,1466255,5444,273,5717,3982,3021
12057,057,12,2021,1484607,11610,3311,14921,16541,13609
12057,057,12,2022,1513473,15989,9297,25286,17359,14113
12057,057,12,2023,1535564,3301,13707,17008,17429,12440
12059,059,12,2020,19578,-44,0,-44,41,70
12059,059,12,2021,19309,-123,0,-123,212,347
12059,059,12,2022,19653,455,0,455,204,347
12059,059,12,2023,19944,381,0,381,229,320
12061,061,12,2020,160446,1097,6,1103,278,599
12061,061,12,2021,163869,4810,124,4934,1212,2518
12061,061,12,2022,167267,4435,286,4721,1256,2770
12061,061,12,2023,169795,3296,465,3761,1273,2501
12063,063,12,2020,47096,-145,0,-145,114,163
12063,063,12,2021,47119,352,13,365,457,815
12063,063,12,2022,48255,1280,36,1316,492,761
12063,063,12,2023,48622,511,50,561,521,715
12065,065,12,2020,14399,-65,0,-65,31,59
12065,065,12,2021,14494,175,10,185,128,212
12065,065,12,2022,15069,596,19,615,134,220
12065,065,12,2023,15450,423,31,454,136,209
12067,067,12,2020,8218,-6,0,-6,16,14
12067,067,12,2021,7952,-187,0,-187,67,128
12067,067,12,2022,7777,-140,1,-139,72,119
12067,067,12,2023,8078,338,5,343,71,112
12069,069,12,2020,386216,2904,21,2925,806,1183
12069,069,12,2021,396352,12372,340,12712,3358,5429
12069,069,12,2022,410090,14409,779,15188,3654,5785
12069,069,12,2023,424462,14670,1150,15820,3689,5126
12071,071,12,2020,765547,5743,84,5827,1644,2069
12071,071,12,2021,790888,27550,1199,28749,6785,8930
12071,071,12,2022,822391,28916,3220,32136,7434,9721
12071,071,12,2023,834573,8374,4906,13280,7477,8597
12073,073,12,2020,293955,1706,3,1709,727,541
12073,073,12,2021,296007,1343,289,1632,2827,2581
12073,073,12,2022,297282,527,711,1238,2805,2563
12073,073,12,2023,296913,-1941,1075,-866,2791,2309
12075,075,12,2020,43059,226,1,227,98,153
12075,075,12,2021,44156,1449,17,1466,397,702
12075,075,12,2022,45253,1318,53,1371,391,732
12075,075,12,2023,46545,1491,75,1566,395,670
12077,077,12,2020,7804,-141,0,-141,21,19
12077,077,12,2021,7290,-431,0,-431,60,109
12077,077,12,2022,7613,307,0,307,73,84
12077,077,12,2023,7706,96,0,96,74,78
12079,079,12,2020,17869,-66,0,-66,52,73
12079,079,12,2021,18099,304,15,319,210,294
12079,079,12,2022,18230,213,40,253,178,309
12079,079,12,2023,18519,360,57,417,173,302
12081,081,12,2020,401619,2548,14,2562,826,1226
12081,081,12,2021,413716,13765,445,14210,3480,4965
12081,081,12,2022,429169,15268,976,16244,3716,5348
12081,081,12,2023,441095,11300,1597,12897,3761,4744
12083,083,12,2020,377472,2296,14,2310,817,1350
12083,083,12,2021,385135,11095,191,11286,3449,6628
12083,083,12,2022,396437,13409,594,14003,3603,6975
12083,083,12,2023,409959,15167,848,16015,3638,6118
12085,085,12,2020,158671,506,2,508,303,539
12085,085,12,2021,160197,2719,103,2822,1249,2473
12085,085,12,2022,161987,2607,292,2899,1278,2465
12085,085,12,2023,163315,1838,441,2279,1294,2241
12086,086,12,2020,2695685,-7286,739,-6547,6613,6052
12086,086,12,2021,2669748,-41367,15109,-26258,26905,25913
12086,086,12,2022,2673056,-38132,37480,-652,29159,25316
12086,086,12,2023,2686867,-47597,54457,6860,29339,22335
12087,087,12,2020,82847,0,0,0,170,193
12087,087,12,2021,82220,-629,139,-490,647,813
12087,087,12,2022,81618,-745,307,-438,726,846
12087,087,12,2023,80614,-1413,482,-931,734,799
12089,089,12,2020,91031,800,-1,799,200,244
12089,089,12,2021,94399,3867,16,3883,793,1128
12089,089,12,2022,97826,3638,-3,3635,840,1224
12089,089,12,2023,101501,3940,15,3955,851,1126
12091,091,12,2020,212085,184,18,202,640,470
12091,091,12,2021,213641,1058,143,1201,2637,2355
12091,091,12,2022,216464,1841,618,2459,2660,2363
12091,091,12,2023,218464,473,962,1435,2686,2136
12093,093,12,2020,39652,-21,1,-20,149,122
12093,093,12,2021,40031,436,35,471,501,602
12093,093,12,2022,40373,400,33,433,552,642
12093,093,12,2023,41427,1029,59,1088,552,586
12095,095,12,2020,1431679,-850,437,-413,3770,2201
12095,095,12,2021,1427761,-14408,5211,-9197,15347,10339
12095,095,12,2022,1451761,5184,13460,18644,16563,10830
12095,095,12,2023,1471416,-6560,19160,12600,16620,9597
12097,097,12,2020,391141,1985,155,2140,1077,665
12097,097,12,2021,403990,10349,1608,11957,4449,3270
12097,097,12,2022,422543,12308,4348,16656,4866,3446
12097,097,12,2023,437784,7418,5994,13412,4916,3104
12099,099,12,2020,1494282,2717,268,2985,3324,4269
12099,099,12,2021,1503435,8316,3771,12087,13946,17492
12099,099,12,2022,1519867,9520,10022,19542,15109,17867
12099,099,12,2023,1533801,-162,14841,14679,15166,15837
12101,101,12,2020,566156,5311,7,5318,1169,1708
12101,101,12,2021,585191,22180,399,22579,5081,7649
12101,101,12,2022,609141,24283,1104,25387,5534,8166
12101,101,12,2023,632996,23750,1691,25441,5625,7184
12103,103,12,2020,959793,2219,27,2246,1752,3194
12103,103,12,2021,959583,5308,796,6104,7201,13706
12103,103,12,2022,961792,6747,1971,8718,7444,14098
12103,103,12,2023,961596,1693,3087,4780,7488,12433
12105,105,12,2020,730158,5696,88,5784,1854,2000
12105,105,12,2021,755598,26681,826,27507,8175,9119
12105,105,12,2022,788382,29606,2340,31946,8854,9537
12105,105,12,2023,818330,26029,3335,29364,8932,8352
12107,107,12,2020,73372,133,0,133,188,273
12107,107,12,2021,74095,1216,25,1241,816,1308
12107,107,12,2022,74736,1116,50,1166,815,1390
12107,107,12,2023,75955,1542,82,1624,821,1233
12109,109,12,2020,277099,4142,2,4144,504,558
12109,109,12,2021,293251,17181,133,17314,2220,2532
12109,109,12,2022,307072,13171,485,13656,2449,2760
12109,109,12,2023,320110,12309,804,13113,2469,2486
12111,111,12,2020,331441,2681,12,2693,719,944
12111,111,12,2021,344246,14359,263,14622,3086,4241
12111,111,12,2022,358886,14146,737,14883,3552,4475
12111,111,12,2023,373586,14011,1125,15136,3605,4021
12113,113,12,2020,189011,940,10,950,460,381
12113,113,12,2021,193750,5053,-2,5051,1904,2057
12113,113,12,2022,198199,4362,54,4416,2057,2149
12113,113,12,2023,203162,4703,128,4831,2075,1929
12115,115,12,2020,436237,3686,0,3686,674,1662
12115,115,12,2021,448636,17249,290,17539,2731,7005
12115,115,12,2022,462552,16521,819,17340,2969,7225
12115,115,12,2023,469013,8526,1354,9880,3003,6402
12117,117,12,2020,471455,179,37,216,1136,932
12117,117,12,2021,470857,-1614,774,-840,4255,4270
12117,117,12,2022,478623,5481,2075,7556,4649,4430
12117,117,12,2023,484271,1923,3039,4962,4677,3987
12119,119,12,2020,130290,1176,2,1178,105,573
12119,119,12,2021,134870,7073,32,7105,483,2598
12119,119,12,2022,144767,11472,51,11523,532,2830
12119,119,12,2023,151565,8684,104,8788,541,2530
12121,121,12,2020,43524,109,0,109,97,157
12121,121,12,2021,44125,871,4,875,430,692
12121,121,12,2022,45405,1523,12,1535,438,783
12121,121,12,2023,46130,977,15,992,442,709
12123,123,12,2020,21743,-28,0,-28,47,75
12123,123,12,2021,20807,-785,24,-761,211,329
12123,123,12,2022,21313,535,57,592,224,338
12123,123,12,2023,21582,294,80,374,223,329
12125,125,12,2020,15425,-563,0,-563,38,57
12125,125,12,2021,15850,584,1,585,145,280
12125,125,12,2022,15514,-256,-1,-257,149,250
12125,125,12,2023,15532,114,0,114,152,248
12127,127,12,2020,555776,3449,22,3471,1100,1984
12127,127,12,2021,566368,14623,396,15019,4783,8662
12127,127,12,2022,579665,15795,921,16716,5011,9174
12127,127,12,2023,590357,12284,1398,13682,5051,8054
12129,129,12,2020,33893,125,0,125,88,84
12129,129,12,2021,34270,465,2,467,306,404
12129,129,12,2022,35169,946,-1,945,342,418
12129,129,12,2023,36449,1349,1,1350,342,410
12131,131,12,2020,75941,708,0,708,197,199
12131,131,12,2021,80021,4305,4,4309,814,818
12131,131,12,2022,83404,3133,40,3173,944,920
12131,131,12,2023,86354,2761,94,2855,958,863
12133,133,12,2020,25320,27,0,27,52,91
12133,133,12,2021,24867,-302,10,-292,227,379
12133,133,12,2022,25405,612,30,642,260,396
12133,133,12,2023,25602,247,42,289,278,370
13001,001,13,2020,18376,-38,0,-38,39,72
13001,001,13,2021,18423,96,2,98,203,263
13001,001,13,2022,18437,68,10,78,215,270
13001,001,13,2023,18457,16,34,50,207,238
13003,003,13,2020,8308,14,0,14,30,22
13003,003,13,2021,8348,19,18,37,121,123
13003,003,13,2022,8160,-234,53,-181,125,134
13003,003,13,2023,8293,41,85,126,131,125
13005,005,13,2020,11112,-18,0,-18,33,46
13005,005,13,2021,11068,-31,2,-29,161,181
13005,005,13,2022,11173,136,2,138,140,175
13005,005,13,2023,11124,-18,2,-16,133,166
13007,007,13,2020,2852,-15,0,-15,8,14
13007,007,13,2021,2824,-9,0,-9,19,39
13007,007,13,2022,2792,-15,1,-14,29,48
13007,007,13,2023,2743,-38,5,-33,27,43
13009,009,13,2020,43790,37,0,37,98,148
13009,009,13,2021,43695,30,10,40,433,602
13009,009,13,2022,43633,149,10,159,390,600
13009,009,13,2023,43396,-110,13,-97,386,525
13011,011,13,2020,18081,44,0,44,50,45
13011,011,13,2021,18538,509,0,509,211,243
13011,011,13,2022,19342,783,-2,781,246,268
13011,011,13,2023,19789,444,0,444,245,241
13013,013,13,2020,83981,438,0,438,241,181
13013,013,13,2021,86727,2508,49,2557,1099,822
13013,013,13,2022,89245,2078,79,2157,1141,882
13013,013,13,2023,92792,3087,109,3196,1151,800
13015,015,13,2020,109314,436,1,437,309,317
13015,015,13,2021,110936,1551,43,1594,1313,1280
13015,015,13,2022,112815,1691,71,1762,1364,1291
13015,015,13,2023,115041,1953,79,2032,1326,1139
13017,017,13,2020,17168,-15,0,-15,51,64
13017,017,13,2021,17128,67,4,71,201,324
13017,017,13,2022,17057,19,4,23,206,291
13017,017,13,2023,17128,128,4,132,211,273
13019,019,13,2020,18144,-13,0,-13,54,60
13019,019,13,2021,18117,55,0,55,194,289
13019,019,13,2022,18215,161,0,161,212,279
13019,019,13,2023,18570,387,1,388,229,259
13021,021,13,2020,157035,-360,0,-360,495,476
13021,021,13,2021,155980,-886,49,-837,1933,2217
13021,021,13,2022,156126,345,101,446,1981,2180
13021,021,13,2023,156512,133,106,239,2060,1916
13023,023,13,2020,12523,-39,0,-39,32,47
13023,023,13,2021,12270,-190,2,-188,132,189
13023,023,13,2022,12279,86,-2,84,123,189
13023,023,13,2023,12465,232,-2,230,128,171
13025,025,13,2020,18044,25,0,25,50,57
13025,025,13,2021,18119,142,0,142,191,265
13025,025,13,2022,18210,138,23,161,211,275
13025,025,13,2023,18401,206,23,229,208,246
13027,027,13,2020,16272,-27,1,-26,49,54
13027,027,13,2021,16276,85,4,89,164,254
13027,027,13,2022,16284,43,36,79,176,240
13027,027,13,2023,16245,-15,36,21,161,220
13029,029,13,2020,45043,240,4,244,141,82
13029,029,13,2021,46974,1781,2,1783,577,362
13029,029,13,2022,48218,966,30,996,611,372
13029,029,13,2023,49739,1172,62,1234,628,340
13031,031,13,2020,79922,205,0,205,216,158
13031,031,13,2021,80671,505,28,533,873,703
13031,031,13,2022,83038,2085,54,2139,875,757
13031,031,13,2023,84327,1047,60,1107,855,674
13033,033,13,2020,24635,36,0,36,72,72
13033,033,13,2021,24362,-270,1,-269,287,294
13033,033,13,2022,24434,102,3,105,283,306
13033,033,13,2023,24438,6,3,9,270,276
13035,035,13,2020,25549,147,0,147,71,95
13035,035,13,2021,26164,695,10,705,272,334
13035,035,13,2022,26745,614,21,635,280,364
13035,035,13,2023,26887,170,22,192,293,343
13037,037,13,2020,5574,6,0,6,13,19
13037,037,13,2021,5541,-6,0,-6,37,66
13037,037,13,2022,5474,-34,1,-33,36,68
13037,037,13,2023,5457,0,3,3,45,65
13039,039,13,2020,54931,78,1,79,170,99
13039,039,13,2021,55786,599,2,601,713,469
13039,039,13,2022,56971,961,14,975,732,529
13039,039,13,2023,58118,832,35,867,767,491
13043,043,13,2020,11022,42,0,42,27,36
13043,043,13,2021,10947,21,2,23,138,242
13043,043,13,2022,10962,87,-2,85,148,211
13043,043,13,2023,11059,148,-2,146,145,195
13045,045,13,2020,119498,250,0,250,395,320
13045,045,13,2021,121595,1983,36,2019,1490,1398
13045,045,13,2022,124530,2631,135,2766,1522,1437
13045,045,13,2023,127098,2131,143,2274,1567,1270
13047,047,13,2020,68006,143,0,143,169,192
13047,047,13,2021,68436,649,-11,638,692,927
13047,047,13,2022,68836,612,-15,597,738,929
13047,047,13,2023,68910,327,-13,314,573,816
13049,049,13,2020,12534,33,0,33,18,34
13049,049,13,2021,12820,355,5,360,113,173
13049,049,13,2022,12788,30,1,31,117,171
13049,049,13,2023,12934,174,1,175,122,154
13051,051,13,2020,295089,-439,23,-416,853,705
13051,051,13,2021,295690,-173,235,62,3412,3060
13051,051,13,2022,301025,3968,739,4707,3644,3235
13051,051,13,2023,303655,972,811,1783,3676,2829
13053,053,13,2020,9475,-120,15,-105,44,15
13053,053,13,2021,9044,-515,-19,-534,162,33
13053,053,13,2022,8746,-478,25,-453,178,39
13053,053,13,2023,8661,-262,46,-216,174,38
13055,055,13,2020,24925,-19,0,-19,57,87
13055,055,13,2021,24844,26,9,35,258,390
13055,055,13,2022,24962,234,33,267,256,400
13055,055,13,2023,25222,353,33,386,247,375
13057,057,13,2020,268156,1363,7,1370,692,451
13057,057,13,2021,274732,5990,169,6159,2770,2208
13057,057,13,2022,281194,5206,407,5613,3021,2298
13057,057,13,2023,286602,3993,450,4443,2944,1984
13059,059,13,2020,128551,-258,2,-256,319,206
13059,059,13,2021,129206,39,162,201,1295,906
13059,059,13,2022,129726,-120,403,283,1296,979
13059,059,13,2023,129933,-672,443,-229,1331,888
13061,061,13,2020,2828,-3,0,-3,5,17
13061,061,13,2021,2867,55,3,58,21,40
13061,061,13,2022,2853,10,6,16,27,55
13061,061,13,2023,2853,10,6,16,28,45
13063,063,13,2020,299439,-493,9,-484,1004,567
13063,063,13,2021,299210,-2022,283,-1739,3894,2507
13063,063,13,2022,298399,-2734,717,-2017,3895,2615
13063,063,13,2023,298300,-2364,859,-1505,3596,2194
13065,065,13,2020,6720,-17,0,-17,21,24
13065,065,13,2021,6702,-1,2,1,94,119
13065,065,13,2022,6679,-18,4,-14,92,96
13065,065,13,2023,6746,55,4,59,94,85
13067,067,13,2020,766378,-745,77,-668,2064,1359
13067,067,13,2021,766662,-4232,1256,-2976,8411,5523
13067,067,13,2022,771840,-937,3432,2495,8758,5594
13067,067,13,2023,776743,-3010,3861,851,8847,4858
13069,069,13,2020,43060,-36,0,-36,126,135
13069,069,13,2021,43046,-68,20,-48,577,564
13069,069,13,2022,43247,134,56,190,575,551
13069,069,13,2023,43317,-88,86,-2,566,498
13071,071,13,2020,45891,-20,2,-18,148,143
13071,071,13,2021,45763,-162,60,-102,598,646
13071,071,13,2022,45830,-70,175,105,622,630
13071,071,13,2023,46167,84,208,292,622,577
13073,073,13,2020,156865,686,13,699,448,296
13073,073,13,2021,159662,2286,64,2350,1781,1341
13073,073,13,2022,162471,2110,218,2328,1865,1364
13073,073,13,2023,165162,1840,246,2086,1835,1211
13075,075,13,2020,17236,17,0,17,47,62
13075,075,13,2021,17262,41,23,64,191,241
13075,075,13,2022,17409,110,58,168,217,236
13075,075,13,2023,17714,264,57,321,222,238
13077,077,13,2020,146747,505,6,511,380,306
13077,077,13,2021,149973,3117,107,3224,1513,1453
13077,077,13,2022,152879,2515,189,2704,1658,1527
13077,077,13,2023,155892,2452,203,2655,1688,1321
13079,079,13,2020,12103,-11,0,-11,34,49
13079,079,13,2021,12139,132,0,132,93,192
13079,079,13,2022,12169,130,-1,129,118,218
13079,079,13,2023,12277,211,0,211,100,202
13081,081,13,2020,20053,-50,0,-50,61,83
13081,081,13,2021,20000,89,0,89,249,402
13081,081,13,2022,19729,-197,-3,-200,236,305
13081,081,13,2023,19631,-53,-3,-56,242,282
13083,083,13,2020,16239,4,0,4,36,53
13083,083,13,2021,16221,92,2,94,139,262
13083,083,13,2022,16090,-41,6,-35,151,238
13083,083,13,2023,16165,176,6,182,126,230
13085,085,13,2020,27059,290,0,290,64,63
13085,085,13,2021,28498,1508,1,1509,309,301
13085,085,13,2022,30189,1572,19,1591,325,317
13085,085,13,2023,31732,1489,21,1510,333,298
13087,087,13,2020,29326,-10,0,-10,59,98
13087,087,13,2021,29091,-205,4,-201,372,416
13087,087,13,2022,29019,5,5,10,338,404
13087,087,13,2023,29087,84,10,94,351,377
13089,089,13,2020,764489,-1407,150,-1257,2506,1441
13089,089,13,2021,759113,-10973,1754,-9219,9888,6060
13089,089,13,2022,761779,-5019,4197,-822,10058,6125
13089,089,13,2023,762992,-8049,4427,-3622,10127,5199
13091,091,13,2020,19949,-31,0,-31,40,64
13091,091,13,2021,19734,-70,3,-67,189,346
13091,091,13,2022,19873,252,16,268,187,320
13091,091,13,2023,19776,-7,20,13,182,291
13093,093,13,2020,11156,-15,0,-15,21,56
13093,093,13,2021,10869,-187,5,-182,91,192
13093,093,13,2022,10585,-242,15,-227,97,169
13093,093,13,2023,10981,411,39,450,98,158
13095,095,13,2020,85155,-471,1,-470,268,383
13095,095,13,2021,82235,-2715,14,-2701,1108,1147
13095,095,13,2022,82895,681,49,730,1061,1186
13095,095,13,2023,82645,-359,70,-289,1101,1066
13097,097,13,2020,144648,200,1,201,390,302
13097,097,13,2021,145748,593,75,668,1636,1295
13097,097,13,2022,147453,1129,218,1347,1700,1302
13097,097,13,2023,149160,932,233,1165,1698,1142
13099,099,13,2020,10794,-25,0,-25,33,63
13099,099,13,2021,10635,-67,0,-67,98,187
13099,099,13,2022,10560,4,0,4,113,187
13099,099,13,2023,10563,60,0,60,117,175
13101,101,13,2020,3721,7,0,7,14,5
13101,101,13,2021,3698,-18,1,-17,46,55
13101,101,13,2022,3686,-26,2,-24,49,36
13101,101,13,2023,3709,7,3,10,49,35
13103,103,13,2020,65169,314,1,315,194,110
13103,103,13,2021,66764,1388,4,1392,836,611
13103,103,13,2022,69034,2008,11,2019,848,666
13103,103,13,2023,71541,2250,10,2260,847,597
13105,105,13,2020,19668,58,0,58,47,75
13105,105,13,2021,19571,40,0,40,206,355
13105,105,13,2022,19873,402,-3,399,224,331
13105,105,13,2023,20013,220,3,223,223,306
13107,107,13,2020,22893,148,0,148,65,72
13107,107,13,2021,22899,78,3,81,297,388
13107,107,13,2022,22946,132,10,142,287,385
13107,107,13,2023,23119,200,21,221,288,338
13109,109,13,2020,10792,-8,0,-8,46,21
13109,109,13,2021,10697,-42,2,-40,118,177
13109,109,13,2022,10659,-10,3,-7,120,146
13109,109,13,2023,10754,104,3,107,122,133
13111,111,13,2020,25436,188,0,188,37,86
13111,111,13,2021,25797,643,-1,642,177,431
13111,111,13,2022,25733,222,-6,216,185,476
13111,111,13,2023,25955,476,-3,473,186,434
13113,113,13,2020,119491,337,1,338,214,266
13113,113,13,2021,120715,1306,139,1445,828,1099
13113,113,13,2022,121981,1339,294,1633,906,1169
13113,113,13,2023,123351,1236,307,1543,916,1061
13115,115,13,2020,98583,4,3,7,260,293
13115,115,13,2021,98487,101,69,170,1104,1449
13115,115,13,2022,99437,1057,199,1256,1109,1431
13115,115,13,2023,100113,608,216,824,1119,1267
13117,117,13,2020,252901,1410,12,1422,556,340
13117,117,13,2021,260783,7002,359,7361,2341,1641
13117,117,13,2022,267312,4845,970,5815,2466,1769
13117,117,13,2023,272887,3704,1061,4765,2411,1559
13119,119,13,2020,23471,54,0,54,67,76
13119,119,13,2021,23510,133,10,143,265,382
13119,119,13,2022,24146,654,36,690,276,367
13119,119,13,2023,24782,668,36,704,279,341
13121,121,13,2020,1069394,1669,135,1804,2800,2024
13121,121,13,2021,1062451,-11771,1886,-9885,11142,8215
13121,121,13,2022,1073698,3366,4745,8111,11526,8125
13121,121,13,2023,1079105,-4327,4986,659,11842,7153
13123,123,13,2020,31427,102,0,102,80,91
13123,123,13,2021,32106,868,18,886,293,464
13123,123,13,2022,32403,439,21,460,304,490
13123,123,13,2023,32860,563,20,583,297,424
13125,125,13,2020,2899,9,0,9,7,3
13125,125,13,2021,2901,26,0,26,30,54
13125,125,13,2022,2928,47,0,47,31,51
13125,125,13,2023,2954,45,0,45,32,50
13127,127,13,2020,84482,37,0,37,184,252
13127,127,13,2021,84786,455,51,506,881,1124
13127,127,13,2022,85145,559,93,652,880,1160
13127,127,13,2023,86172,1045,114,1159,900,1032
13129,129,13,2020,57722,182,3,185,147,155
13129,129,13,2021,58239,556,45,601,640,739
13129,129,13,2022,58855,673,46,719,655,759
13129,129,13,2023,59757,867,64,931,660,688
13131,131,13,2020,26224,-22,0,-22,74,66
13131,131,13,2021,25850,-308,2,-306,293,359
13131,131,13,2022,25994,192,17,209,298,351
13131,131,13,2023,26066,64,37,101,298,328
13133,133,13,2020,19028,164,0,164,27,53
13133,133,13,2021,19544,676,11,687,143,280
13133,133,13,2022,20111,650,19,669,139,275
13133,133,13,2023,20722,691,30,721,141,254
13135,135,13,2020,958359,-599,186,-413,2647,1361
13135,135,13,2021,965338,-107,1907,1800,10737,6043
13135,135,13,2022,976173,276,5591,5867,11385,5929
13135,135,13,2023,983526,-5069,6165,1096,11245,5081
13137,137,13,2020,46142,130,3,133,134,160
13137,137,13,2021,46748,647,42,689,489,569
13137,137,13,2022,47465,707,82,789,530,601
13137,137,13,2023,48757,1212,107,1319,526,552
13139,139,13,2020,203473,417,4,421,613,475
13139,139,13,2021,207080,3062,122,3184,2507,2052
13139,139,13,2022,212621,4217,477,4694,2698,2012
13139,139,13,2023,217267,3027,671,3698,2694,1758
13141,141,13,2020,8711,30,0,30,12,65
13141,141,13,2021,8677,98,0,98,51,183
13141,141,13,2022,8417,-159,1,-158,51,159
13141,141,13,2023,8676,353,2,355,51,148
13143,143,13,2020,30036,144,0,144,83,102
13143,143,13,2021,30595,685,-2,683,359,465
13143,143,13,2022,31355,832,-2,830,346,447
13143,143,13,2023,32038,759,-1,758,345,418
13145,145,13,2020,34898,273,2,275,69,95
13145,145,13,2021,35589,768,6,774,302,372
13145,145,13,2022,36257,689,17,706,311,364
13145,145,13,2023,36654,410,19,429,305,334
13147,147,13,2020,25878,72,0,72,63,84
13147,147,13,2021,26319,611,2,613,256,411
13147,147,13,2022,26886,656,7,663,285,424
13147,147,13,2023,27556,790,7,797,266,392
13149,149,13,2020,11444,47,0,47,34,44
13149,149,13,2021,11532,122,0,122,125,162
13149,149,13,2022,11716,241,0,241,123,180
13149,149,13,2023,12034,371,0,371,114,167
13151,151,13,2020,241852,1020,1,1021,574,475
13151,151,13,2021,245085,2630,71,2701,2582,2150
13151,151,13,2022,248472,2747,222,2969,2718,2194
13151,151,13,2023,254613,5076,252,5328,2777,1922
13153,153,13,2020,164356,595,2,597,465,359
13153,153,13,2021,167228,2474,86,2560,1996,1684
13153,153,13,2022,169775,2096,122,2218,2024,1690
13153,153,13,2023,171974,1496,131,1627,2033,1454
13155,155,13,2020,9647,-11,0,-11,30,37
13155,155,13,2021,9369,-212,0,-212,100,156
13155,155,13,2022,9114,-221,2,-219,99,155
13155,155,13,2023,9120,57,2,59,99,150
13157,157,13,2020,76731,877,0,877,206,191
13157,157,13,2021,80374,3627,35,3662,949,811
13157,157,13,2022,84009,3234,84,3318,1014,845
13157,157,13,2023,88615,4209,126,4335,1040,756
13159,159,13,2020,14662,78,0,78,29,32
13159,159,13,2021,15263,688,2,690,159,215
13159,159,13,2022,15979,706,9,715,177,212
13159,159,13,2023,16455,484,13,497,180,197
13161,161,13,2020,14800,22,0,22,45,48
13161,161,13,2021,14860,100,2,102,158,205
13161,161,13,2022,14891,87,2,89,166,220
13161,161,13,2023,14906,61,3,64,163,212
13163,163,13,2020,15676,-7,0,-7,29,61
13163,163,13,2021,15476,-65,4,-61,164,312
13163,163,13,2022,15294,-61,3,-58,160,280
13163,163,13,2023,15183,-18,8,-10,166,266
13165,165,13,2020,8663,3,0,3,16,35
13165,165,13,2021,8764,132,8,140,93,129
13165,165,13,2022,8655,-74,7,-67,96,137
13165,165,13,2023,8627,-1,7,6,94,129
13167,167,13,2020,9183,-1,0,-1,22,27
13167,167,13,2021,8999,-96,0,-96,82,169
13167,167,13,2022,9211,244,1,245,95,146
13167,167,13,2023,9282,107,4,111,97,138
13169,169,13,2020,28402,51,0,51,66,76
13169,169,13,2021,28406,132,1,133,254,399
13169,169,13,2022,28512,227,0,227,282,395
13169,169,13,2023,28969,562,0,562,253,354
13171,171,13,2020,18549,71,0,71,46,64
13171,171,13,2021,18697,201,2,203,230,294
13171,171,13,2022,19473,795,6,801,214,284
13171,171,13,2023,20401,952,6,958,222,254
13173,173,13,2020,9929,38,2,40,29,22
13173,173,13,2021,10051,72,22,94,136,108
13173,173,13,2022,10177,44,65,109,142,121
13173,173,13,2023,10452,187,74,261,129,114
13175,175,13,2020,49535,-8,1,-7,139,179
13175,175,13,2021,49524,107,26,133,603,783
13175,175,13,2022,49710,308,69,377,596,777
13175,175,13,2023,49941,229,69,298,609,675
13177,177,13,2020,33222,39,0,39,93,85
13177,177,13,2021,33209,-22,4,-18,298,301
13177,177,13,2022,33678,445,26,471,318,316
13177,177,13,2023,33872,154,26,180,315,299
13179,179,13,2020,65317,-216,11,-205,336,99
13179,179,13,2021,66800,789,-8,781,1285,551
13179,179,13,2022,67919,195,148,343,1356,575
13179,179,13,2023,69210,251,175,426,1382,518
13181,181,13,2020,7702,27,0,27,13,24
13181,181,13,2021,7749,99,0,99,75,126
13181,181,13,2022,7859,141,3,144,85,120
13181,181,13,2023,7879,43,3,46,87,113
13183,183,13,2020,16270,88,2,90,60,35
13183,183,13,2021,17108,729,-3,726,280,139
13183,183,13,2022,18395,1074,9,1083,298,153
13183,183,13,2023,19594,1055,12,1067,278,145
13185,185,13,2020,118416,-2,4,2,364,237
13185,185,13,2021,118916,13,13,26,1598,1211
13185,185,13,2022,119499,212,73,285,1573,1207
13185,185,13,2023,120712,579,97,676,1618,1088
13187,187,13,2020,33641,145,1,146,74,61
13187,187,13,2021,32843,-644,48,-596,288,425
13187,187,13,2022,34706,1721,77,1798,333,420
13187,187,13,2023,35258,526,74,600,324,373
13189,189,13,2020,21607,-28,0,-28,74,70
13189,189,13,2021,21619,84,-6,78,238,315
13189,189,13,2022,21690,125,-6,119,266,314
13189,189,13,2023,21799,147,-6,141,265,298
13191,191,13,2020,10985,30,0,30,20,35
13191,191,13,2021,11054,186,1,187,95,208
13191,191,13,2022,11183,242,1,243,89,211
13191,191,13,2023,11501,415,1,416,96,193
13193,193,13,2020,12021,-35,0,-35,34,57
13193,193,13,2021,11852,-127,0,-127,125,167
13193,193,13,2022,11777,-12,1,-11,123,180
13193,193,13,2023,11817,83,9,92,124,175
13195,195,13,2020,30276,142,0,142,85,74
13195,195,13,2021,30887,633,6,639,366,380
13195,195,13,2022,31450,549,-2,547,401,403
13195,195,13,2023,32191,721,-1,720,403,382
13197,197,13,2020,7530,34,0,34,14,20
13197,197,13,2021,7434,-55,7,-48,75,124
13197,197,13,2022,7436,58,13,71,65,128
13197,197,13,2023,7440,40,15,55,71,122
13199,199,13,2020,20617,23,0,23,64,89
13199,199,13,2021,20725,266,0,266,249,401
13199,199,13,2022,20890,263,0,263,259,364
13199,199,13,2023,20931,126,0,126,241,327
13201,201,13,2020,5992,-5,0,-5,19,24
13201,201,13,2021,5853,-49,0,-49,47,133
13201,201,13,2022,5774,-11,-1,-12,56,120
13201,201,13,2023,5747,35,-1,34,56,114
13205,205,13,2020,21671,-47,0,-47,50,97
13205,205,13,2021,21318,-296,-1,-297,264,310
13205,205,13,2022,21192,-53,-3,-56,234,298
13205,205,13,2023,21114,-24,-3,-27,234,282
13207,207,13,2020,28057,131,0,131,69,98
13207,207,13,2021,28753,849,-1,848,266,390
13207,207,13,2022,29469,801,5,806,281,396
13207,207,13,2023,30625,1247,5,1252,268,359
13209,209,13,2020,8576,-28,0,-28,22,25
13209,209,13,2021,8646,100,3,103,105,141
13209,209,13,2022,8643,22,6,28,110,140
13209,209,13,2023,8761,128,17,145,107,134
13211,211,13,2020,20201,104,0,104,54,49
13211,211,13,2021,20650,546,0,546,199,280
13211,211,13,2022,21024,428,1,429,209,281
13211,211,13,2023,21460,483,3,486,210,257
13213,213,13,2020,40012,8,0,8,117,103
13213,213,13,2021,39975,66,8,74,397,538
13213,213,13,2022,40410,520,-6,514,471,547
13213,213,13,2023,41035,660,1,661,454,490
13215,215,13,2020,207006,-126,28,-98,665,561
13215,215,13,2021,205060,-2246,86,-2160,2738,2528
13215,215,13,2022,202432,-3179,312,-2867,2653,2451
13215,215,13,2023,201877,-1488,368,-1120,2700,2140
13217,217,13,2020,112890,282,1,283,321,266
13217,217,13,2021,115341,2454,57,2511,1258,1273
13217,217,13,2022,117752,2077,225,2302,1303,1219
13217,217,13,2023,120135,1859,280,2139,1306,1055
13219,219,13,2020,42016,212,1,213,82,81
13219,219,13,2021,43034,1023,18,1041,336,347
13219,219,13,2022,43624,562,53,615,359,352
13219,219,13,2023,44182,491,54,545,356,333
13221,221,13,2020,14869,57,0,57,40,52
13221,221,13,2021,15187,350,6,356,158,187
13221,221,13,2022,15531,360,4,364,179,204
13221,221,13,2023,15754,245,4,249,162,187
13223,223,13,2020,169580,740,5,745,475,319
13223,223,13,2021,173989,3764,60,3824,1996,1344
13223,223,13,2022,178753,3729,301,4030,2114,1425
13223,223,13,2023,183164,3326,320,3646,2007,1223
13225,225,13,2020,28036,58,0,58,76,87
13225,225,13,2021,28245,274,-1,273,288,359
13225,225,13,2022,28486,338,-4,334,275,377
13225,225,13,2023,28805,366,4,370,310,362
13227,227,13,2020,33337,177,0,177,75,108
13227,227,13,2021,34021,861,1,862,283,430
13227,227,13,2022,34825,939,-7,932,316,500
13227,227,13,2023,35969,1287,-5,1282,317,456
13229,229,13,2020,19747,23,0,23,57,54
13229,229,13,2021,19975,319,-1,318,235,323
13229,229,13,2022,20190,288,-1,287,249,318
13229,229,13,2023,20425,258,-1,257,253,276
13231,231,13,2020,18946,47,0,47,47,43
13231,231,13,2021,19540,657,2,659,199,241
13231,231,13,2022,19955,487,3,490,187,265
13231,231,13,2023,20461,554,3,557,196,245
13233,233,13,2020,42924,58,0,58,126,119
13233,233,13,2021,43316,470,15,485,530,631
13233,233,13,2022,43669,415,21,436,566,650
13233,233,13,2023,44223,519,22,541,584,574
13235,235,13,2020,9870,18,0,18,30,33
13235,235,13,2021,9570,-228,0,-228,97,157
13235,235,13,2022,9963,427,1,428,92,163
13235,235,13,2023,10095,195,1,196,96,158
13237,237,13,2020,22170,149,0,149,52,65
13237,237,13,2021,22614,612,8,620,208,357
13237,237,13,2022,22933,439,7,446,220,364
13237,237,13,2023,23129,317,7,324,211,339
13239,239,13,2020,2227,-2,0,-2,6,15
13239,239,13,2021,2242,30,0,30,24,39
13239,239,13,2022,2259,39,0,39,22,45
13239,239,13,2023,2280,46,0,46,18,43
13241,241,13,2020,16912,73,1,74,35,69
13241,241,13,2021,17120,342,6,348,159,289
13241,241,13,2022,17267,233,25,258,154,281
13241,241,13,2023,17442,254,28,282,151,256
13243,243,13,2020,6368,-19,0,-19,18,50
13243,243,13,2021,6263,-58,0,-58,63,112
13243,243,13,2022,6126,-88,1,-87,57,112
13243,243,13,2023,6078,-1,3,2,57,106
13245,245,13,2020,206524,-279,2,-277,691,554
13245,245,13,2021,205274,-1319,42,-1277,2575,2638
13245,245,13,2022,206344,893,141,1034,2620,2567
13245,245,13,2023,205414,-1550,163,-1387,2688,2245
13247,247,13,2020,93611,49,0,49,235,215
13247,247,13,2021,93888,220,45,265,939,993
13247,247,13,2022,94945,939,107,1046,961,922
13247,247,13,2023,95987,784,122,906,974,833
13249,249,13,2020,4536,-13,0,-13,14,11
13249,249,13,2021,4486,-55,0,-55,59,52
13249,249,13,2022,4497,21,0,21,48,56
13249,249,13,2023,4526,35,0,35,50,57
13251,251,13,2020,14077,24,0,24,34,47
13251,251,13,2021,14062,33,0,33,176,234
13251,251,13,2022,13970,2,-1,1,152,237
13251,251,13,2023,14174,264,0,264,153,211
13253,253,13,2020,9133,1,0,1,16,37
13253,253,13,2021,9162,73,1,74,97,145
13253,253,13,2022,9144,49,2,51,90,157
13253,253,13,2023,9092,-7,2,-5,96,143
13255,255,13,2020,67471,175,0,175,213,229
13255,255,13,2021,67765,486,3,489,832,1046
13255,255,13,2022,69008,1343,37,1380,863,1071
13255,255,13,2023,69946,968,50,1018,848,927
13257,257,13,2020,26818,47,0,47,74,85
13257,257,13,2021,26765,95,7,102,268,433
13257,257,13,2022,26746,170,5,175,291,474
13257,257,13,2023,27228,593,9,602,297,422
13259,259,13,2020,5303,-6,0,-6,10,17
13259,259,13,2021,4915,-378,68,-310,26,73
13259,259,13,2022,4604,-407,105,-302,33,79
13259,259,13,2023,4674,9,109,118,33,80
13261,261,13,2020,29520,-71,0,-71,86,113
13261,261,13,2021,28981,-445,12,-433,332,423
13261,261,13,2022,28864,-34,16,-18,343,424
13261,261,13,2023,28890,49,17,66,349,390
13263,263,13,2020,5726,1,0,1,11,21
13263,263,13,2021,5755,79,0,79,48,97
13263,263,13,2022,5757,53,0,53,43,98
13263,263,13,2023,5718,9,0,9,46,93
13265,265,13,2020,1559,8,0,8,2,9
13265,265,13,2021,1569,18,0,18,17,25
13265,265,13,2022,1608,58,0,58,15,37
13265,265,13,2023,1609,22,0,22,13,32
13267,267,13,2020,24321,14,0,14,72,56
13267,267,13,2021,24092,-145,6,-139,235,328
13267,267,13,2022,23988,-24,-7,-31,271,329
13267,267,13,2023,24296,307,-7,300,290,283
13269,269,13,2020,7818,9,0,9,22,28
13269,269,13,2021,7769,-11,-1,-12,86,128
13269,269,13,2022,7762,46,9,55,75,136
13269,269,13,2023,7758,48,9,57,69,129
13271,271,13,2020,12465,14,0,14,29,55
13271,271,13,2021,12317,-71,19,-52,125,226
13271,271,13,2022,12378,100,24,124,120,184
13271,271,13,2023,10920,-1455,32,-1423,126,177
13273,273,13,2020,9140,-11,0,-11,17,52
13273,273,13,2021,8924,-165,0,-165,84,129
13273,273,13,2022,8792,-80,1,-79,87,139
13273,273,13,2023,8718,-25,1,-24,88,137
13275,275,13,2020,45775,3,0,3,133,164
13275,275,13,2021,45818,149,-3,146,520,653
13275,275,13,2022,45551,-92,-1,-93,506,664
13275,275,13,2023,45649,168,6,174,526,602
13277,277,13,2020,41387,-2,0,-2,139,122
13277,277,13,2021,41082,-254,3,-251,498,569
13277,277,13,2022,41335,286,20,306,502,546
13277,277,13,2023,41554,165,29,194,513,491
13279,279,13,2020,27078,35,2,37,105,96
13279,279,13,2021,26847,-165,17,-148,362,458
13279,279,13,2022,26813,-8,38,30,377,429
13279,279,13,2023,27040,168,56,224,384,382
13281,281,13,2020,12547,100,0,100,17,45
13281,281,13,2021,12880,483,7,490,105,236
13281,281,13,2022,12961,233,5,238,94,245
13281,281,13,2023,13035,196,5,201,99,226
13283,283,13,2020,6397,-5,0,-5,19,20
13283,283,13,2021,6365,28,0,28,59,118
13283,283,13,2022,6359,36,0,36,77,119
13283,283,13,2023,6341,2,0,2,79,97
13285,285,13,2020,69333,-47,0,-47,184,238
13285,285,13,2021,69518,159,37,196,858,918
13285,285,13,2022,70247,661,71,732,900,907
13285,285,13,2023,70742,283,86,369,920,795
13287,287,13,2020,8986,-11,0,-11,25,33
13287,287,13,2021,8919,-31,0,-31,98,139
13287,287,13,2022,8836,-53,-1,-54,110,135
13287,287,13,2023,8909,90,-1,89,115,131
13289,289,13,2020,8013,2,0,2,20,34
13289,289,13,2021,7881,-34,0,-34,73,174
13289,289,13,2022,7676,-114,0,-114,69,161
13289,289,13,2023,7691,113,0,113,56,153
13291,291,13,2020,24802,260,0,260,40,94
13291,291,13,2021,25552,1081,7,1088,159,445
13291,291,13,2022,26390,1034,22,1056,176,445
13291,291,13,2023,27124,932,28,960,175,399
13293,293,13,2020,27745,76,0,76,88,119
13293,293,13,2021,27689,111,6,117,325,515
13293,293,13,2022,28093,567,-4,563,331,514
13293,293,13,2023,28263,296,-5,291,329,451
13295,295,13,2020,67738,135,0,135,188,243
13295,295,13,2021,68417,962,7,969,684,971
13295,295,13,2022,68965,751,7,758,776,1002
13295,295,13,2023,69489,794,7,801,603,879
13297,297,13,2020,97158,538,1,539,245,265
13297,297,13,2021,99814,2864,25,2889,1036,1181
13297,297,13,2022,103064,3145,88,3233,1093,1194
13297,297,13,2023,106702,3455,89,3544,1146,1035
13299,299,13,2020,36229,-2,0,-2,120,148
13299,299,13,2021,35545,-502,3,-499,444,617
13299,299,13,2022,35597,213,21,234,441,613
13299,299,13,2023,36243,696,34,730,459,547
13301,301,13,2020,5207,8,0,8,9,20
13301,301,13,2021,5208,51,0,51,57,109
13301,301,13,2022,5157,-10,1,-9,51,93
13301,301,13,2023,5106,-20,1,-19,51,84
13303,303,13,2020,19952,-37,0,-37,49,56
13303,303,13,2021,19758,-57,0,-57,191,342
13303,303,13,2022,19765,110,3,113,204,303
13303,303,13,2023,19820,117,3,120,205,273
13305,305,13,2020,30142,5,0,5,77,89
13305,305,13,2021,30220,145,53,198,327,464
13305,305,13,2022,30737,614,41,655,337,497
13305,305,13,2023,31373,696,43,739,339,442
13307,307,13,2020,2351,7,0,7,4,8
13307,307,13,2021,2362,17,1,18,20,26
13307,307,13,2022,2337,-14,1,-13,17,29
13307,307,13,2023,2337,4,6,10,18,28
13309,309,13,2020,7449,-23,0,-23,11,19
13309,309,13,2021,7737,335,0,335,62,87
13309,309,13,2022,7310,-457,0,-457,68,79
13309,309,13,2023,7081,-225,0,-225,70,76
13311,311,13,2020,28108,154,0,154,50,82
13311,311,13,2021,28389,454,2,456,268,433
13311,311,13,2022,28804,557,9,566,273,446
13311,311,13,2023,29026,339,16,355,272,408
13313,313,13,2020,102784,-145,2,-143,282,228
13313,313,13,2021,102712,-272,37,-235,1227,1129
13313,313,13,2022,103095,213,126,339,1215,1118
13313,313,13,2023,103687,197,170,367,1204,979
13315,315,13,2020,8787,47,0,47,21,42
13315,315,13,2021,8737,31,0,31,71,150
13315,315,13,2022,8751,89,-2,87,78,155
13315,315,13,2023,8779,93,-2,91,83,146
13317,317,13,2020,9552,-3,0,-3,23,33
13317,317,13,2021,9489,29,3,32,95,194
13317,317,13,2022,9565,146,6,152,95,177
13317,317,13,2023,9518,22,7,29,94,169
13319,319,13,2020,8833,-17,0,-17,18,43
13319,319,13,2021,8786,20,0,20,101,172
13319,319,13,2022,8677,-42,2,-40,100,166
13319,319,13,2023,8725,94,2,96,108,156
13321,321,13,2020,20732,-30,0,-30,66,79
13321,321,13,2021,20565,-114,1,-113,227,289
13321,321,13,2022,20431,-27,-1,-28,220,319
13321,321,13,2023,20273,-67,-1,-68,208,299
15001,001,15,2020,200744,-28,13,-15,503,429
15001,001,15,2021,203875,2646,327,2973,2053,1871
15001,001,15,2022,206348,1757,742,2499,2109,2143
15001,001,15,2023,207615,784,583,1367,1945,2051
15003,003,15,2020,1012399,-4530,101,-4429,2748,1968
15003,003,15,2021,1004163,-12242,1369,-10873,10998,8386
15003,003,15,2022,994828,-15707,4293,-11414,11140,9172
15003,003,15,2023,989408,-10794,3399,-7395,10799,8770
15005,005,15,2020,80,0,0,0,0,0
15005,005,15,2021,81,0,0,0,1,0
15005,005,15,2022,81,0,0,0,0,0
15005,005,15,2023,81,0,0,0,0,0
15007,007,15,2020,73190,-126,0,-126,171,149
15007,007,15,2021,73829,262,108,370,785,558
15007,007,15,2022,73783,-409,245,-164,800,655
15007,007,15,2023,73851,-247,175,-72,779,640
15009,009,15,2020,164768,-147,5,-142,414,297
15009,009,15,2021,164797,-648,239,-409,1691,1337
15009,009,15,2022,164359,-1305,637,-668,1697,1405
15009,009,15,2023,164183,-936,470,-466,1644,1351
16001,001,16,2020,498278,3144,16,3160,1231,873
16001,001,16,2021,513025,14005,176,14181,4983,3962
16001,001,16,2022,519004,4890,391,5281,5039,4331
16001,001,16,2023,524673,2916,1435,4351,5080,3781
16003,003,16,2020,4428,53,0,53,13,14
16003,003,16,2021,4623,224,2,226,31,48
16003,003,16,2022,4791,183,3,186,30,58
16003,003,16,2023,4903,136,1,137,28,53
16005,005,16,2020,87276,148,1,149,282,192
16005,005,16,2021,88515,1008,31,1039,1077,888
16005,005,16,2022,89625,952,72,1024,1065,975
16005,005,16,2023,90400,361,223,584,1059,871
16007,007,16,2020,6367,0,0,0,23,27
16007,007,16,2021,6567,191,2,193,85,70
16007,007,16,2022,6730,148,7,155,79,77
16007,007,16,2023,6766,10,17,27,77,68
16009,009,16,2020,9576,47,0,47,25,23
16009,009,16,2021,9895,400,0,400,86,151
16009,009,16,2022,10291,442,0,442,95,159
16009,009,16,2023,10369,124,1,125,104,150
16011,011,16,2020,48097,55,1,56,152,107
16011,011,16,2021,48929,632,9,641,669,482
16011,011,16,2022,49973,870,8,878,664,519
16011,011,16,2023,50395,219,7,226,667,471
16013,013,16,2020,24348,72,6,78,38,44
16013,013,16,2021,24782,357,46,403,182,147
16013,013,16,2022,24901,-24,114,90,198,155
16013,013,16,2023,25041,-174,269,95,199,153
16015,015,16,2020,7664,50,1,51,12,7
16015,015,16,2021,8133,514,11,525,58,88
16015,015,16,2022,8360,212,26,238,67,91
16015,015,16,2023,8517,106,66,172,68,84
16017,017,16,2020,47403,331,0,331,97,98
16017,017,16,2021,49633,2407,11,2418,435,505
16017,017,16,2022,51407,1819,38,1857,455,631
16017,017,16,2023,52547,1139,107,1246,448,549
16019,019,16,2020,124737,554,2,556,452,229
16019,019,16,2021,128064,2707,14,2721,1805,1142
16019,019,16,2022,129543,813,1,814,1799,1122
16019,019,16,2023,131366,935,69,1004,1803,994
16021,021,16,2020,12139,82,0,82,35,29
16021,021,16,2021,12620,488,19,507,137,140
16021,021,16,2022,13272,630,25,655,149,177
16021,021,16,2023,13557,215,73,288,151,153
16023,023,16,2020,2584,9,0,9,9,10
16023,023,16,2021,2666,79,0,79,39,32
16023,023,16,2022,2698,44,-1,43,32,45
16023,023,16,2023,2758,65,0,65,33,37
16025,025,16,2020,1084,14,0,14,3,5
16025,025,16,2021,1137,53,1,54,9,6
16025,025,16,2022,1169,25,1,26,11,6
16025,025,16,2023,1232,58,0,58,11,6
16027,027,16,2020,233013,1572,10,1582,836,396
16027,027,16,2021,243710,9885,55,9940,3185,1989
16027,027,16,2022,250892,5653,209,5862,3326,2270
16027,027,16,2023,257674,4816,584,5400,3341,1970
16029,029,16,2020,7013,-13,0,-13,17,19
16029,029,16,2021,7109,85,6,91,92,88
16029,029,16,2022,7200,69,10,79,89,79
16029,029,16,2023,7219,8,4,12,85,76
16031,031,16,2020,24760,6,1,7,96,45
16031,031,16,2021,25244,294,41,335,385,242
16031,031,16,2022,25644,178,118,296,365,243
16031,031,16,2023,25696,-148,60,-88,366,228
16033,033,16,2020,792,0,0,0,3,0
16033,033,16,2021,793,-5,2,-3,10,7
16033,033,16,2022,810,7,-1,6,19,9
16033,033,16,2023,801,-20,-1,-21,19,5
16035,035,16,2020,8750,36,0,36,20,31
16035,035,16,2021,8925,236,2,238,64,118
16035,035,16,2022,9035,175,5,180,69,139
16035,035,16,2023,9214,240,7,247,67,136
16037,037,16,2020,4271,-1,0,-1,9,14
16037,037,16,2021,4446,197,3,200,36,50
16037,037,16,2022,4518,97,0,97,36,68
16037,037,16,2023,4523,38,0,38,33,66
16039,039,16,2020,28669,-40,6,-34,86,57
16039,039,16,2021,28978,31,39,70,460,229
16039,039,16,2022,29391,129,87,216,456,254
16039,039,16,2023,29724,-53,171,118,459,245
16041,041,16,2020,14282,62,0,62,52,25
16041,041,16,2021,14670,287,1,288,210,107
16041,041,16,2022,15170,406,4,410,222,138
16041,041,16,2023,15494,230,2,232,216,124
16043,043,16,2020,13419,8,0,8,47,27
16043,043,16,2021,13591,160,4,164,158,151
16043,043,16,2022,14017,383,11,394,183,163
16043,043,16,2023,14196,112,25,137,186,143
16045,045,16,2020,19272,162,0,162,60,59
16045,045,16,2021,19802,638,8,646,192,278
16045,045,16,2022,20454,616,90,706,204,289
16045,045,16,2023,21071,403,267,670,204,256
16047,047,16,2020,15649,61,2,63,35,51
16047,047,16,2021,15793,106,11,117,202,179
16047,047,16,2022,15879,37,13,50,220,178
16047,047,16,2023,16061,108,13,121,226,166
16049,049,16,2020,16594,67,0,67,26,42
16049,049,16,2021,17059,589,1,590,139,238
16049,049,16,2022,17637,628,12,640,168,256
16049,049,16,2023,17890,299,16,315,170,228
16051,051,16,2020,31080,111,1,112,125,47
16051,051,16,2021,32201,950,5,955,411,220
16051,051,16,2022,33336,898,18,916,445,251
16051,051,16,2023,34198,618,34,652,448,238
16053,053,16,2020,24270,-41,5,-36,94,35
16053,053,16,2021,24738,254,75,329,356,220
16053,053,16,2022,25244,267,121,388,363,248
16053,053,16,2023,25479,0,92,92,364,223
16055,055,16,2020,172785,1453,0,1453,456,362
16055,055,16,2021,180058,7644,-37,7607,1824,1817
16055,055,16,2022,183290,3366,-56,3310,1893,2065
16055,055,16,2023,185010,1613,12,1625,1879,1782
16057,057,16,2020,39638,55,4,59,109,64
16057,057,16,2021,40400,547,51,598,421,266
16057,057,16,2022,40924,310,121,431,434,315
16057,057,16,2023,41301,-128,368,240,431,295
16059,059,16,2020,7962,6,0,6,7,30
16059,059,16,2021,8160,278,1,279,64,130
16059,059,16,2022,8284,202,3,205,62,148
16059,059,16,2023,8441,221,0,221,64,129
16061,061,16,2020,3527,1,0,1,11,11
16061,061,16,2021,3690,197,0,197,34,58
16061,061,16,2022,3725,67,1,68,33,67
16061,061,16,2023,3739,38,4,42,33,61
16063,063,16,2020,5134,0,0,0,10,3
16063,063,16,2021,5285,134,6,140,66,49
16063,063,16,2022,5385,63,9,72,69,39
16063,063,16,2023,5450,32,3,35,66,38
16065,065,16,2020,52928,-219,-2,-221,277,44
16065,065,16,2021,54092,246,20,266,1074,200
16065,065,16,2022,54958,-80,109,29,1116,238
16065,065,16,2023,54547,-1703,388,-1315,1110,210
16067,067,16,2020,21668,64,1,65,67,46
16067,067,16,2021,21944,189,27,216,284,229
16067,067,16,2022,22208,165,35,200,306,235
16067,067,16,2023,22480,168,10,178,304,212
16069,069,16,2020,42145,57,0,57,114,125
16069,069,16,2021,42500,476,5,481,430,558
16069,069,16,2022,42909,650,16,666,395,648
16069,069,16,2023,42987,212,62,274,395,591
16071,071,16,2020,4566,3,0,3,8,11
16071,071,16,2021,4605,34,0,34,56,53
16071,071,16,2022,4740,135,0,135,59,60
16071,071,16,2023,4953,212,0,212,57,55
16073,073,16,2020,11996,81,0,81,34,28
16073,073,16,2021,12356,366,2,368,154,149
16073,073,16,2022,12645,269,8,277,150,142
16073,073,16,2023,12722,60,6,66,148,137
16075,075,16,2020,25590,203,0,203,68,55
16075,075,16,2021,26386,780,3,783,316,276
16075,075,16,2022,26929,545,-3,542,325,347
16075,075,16,2023,27279,335,-8,327,326,302
16077,077,16,2020,7879,-4,0,-4,18,11
16077,077,16,2021,7975,62,10,72,108,87
16077,077,16,2022,8136,89,36,125,107,71
16077,077,16,2023,8253,54,14,68,111,62
16079,079,16,2020,13199,26,0,26,38,33
16079,079,16,2021,13615,539,0,539,130,227
16079,079,16,2022,13935,393,-2,391,153,244
16079,079,16,2023,14026,160,1,161,154,227
16081,081,16,2020,11735,93,0,93,33,13
16081,081,16,2021,12273,504,-1,503,117,57
16081,081,16,2022,12519,154,12,166,132,67
16081,081,16,2023,12549,-51,16,-35,129,63
16083,083,16,2020,90372,264,3,267,289,232
16083,083,16,2021,92394,1890,37,1927,1092,955
16083,083,16,2022,93821,1223,93,1316,1140,1044
16083,083,16,2023,95156,926,194,1120,1137,923
16085,085,16,2020,11842,106,0,106,23,18
16085,085,16,2021,12256,451,-2,449,90,102
16085,085,16,2022,12450,208,-1,207,83,103
16085,085,16,2023,12644,208,-1,207,84,96
16087,087,16,2020,10558,76,0,76,27,37
16087,087,16,2021,10900,415,1,416,94,151
16087,087,16,2022,11147,280,16,296,113,174
16087,087,16,2023,11425,271,53,324,116,160
17001,001,17,2020,65614,-103,0,-103,169,183
17001,001,17,2021,65064,-378,2,-376,741,940
17001,001,17,2022,64556,-299,5,-294,707,903
17001,001,17,2023,64441,9,9,18,700,834
17003,003,17,2020,5169,-51,0,-51,10,23
17003,003,17,2021,5025,-79,0,-79,55,118
17003,003,17,2022,4841,-118,0,-118,36,104
17003,003,17,2023,4695,-73,0,-73,30,104
17005,005,17,2020,16684,-36,0,-36,44,47
17005,005,17,2021,16623,-16,3,-13,150,210
17005,005,17,2022,16536,-9,7,-2,137,214
17005,005,17,2023,16450,-21,8,-13,130,203
17007,007,17,2020,53343,-116,0,-116,135,118
17007,007,17,2021,53173,-195,-3,-198,513,501
17007,007,17,2022,53068,-75,-14,-89,515,515
17007,007,17,2023,53202,114,-1,113,512,485
17009,009,17,2020,6227,-16,0,-16,12,8
17009,009,17,2021,6432,231,2,233,53,71
17009,009,17,2022,6316,-111,0,-111,57,67
17009,009,17,2023,6294,-17,0,-17,56,61
17011,011,17,2020,33191,-44,0,-44,83,89
17011,011,17,2021,32959,-94,4,-90,334,495
17011,011,17,2022,32827,3,8,11,326,451
17011,011,17,2023,32729,-6,15,9,319,425
17013,013,17,2020,4407,-18,0,-18,6,17
17013,013,17,2021,4395,1,0,1,47,62
17013,013,17,2022,4353,-1,0,-1,34,72
17013,013,17,2023,4317,19,0,19,27,82
17015,015,17,2020,15672,-2,0,-2,36,69
17015,015,17,2021,15702,122,2,124,117,213
17015,015,17,2022,15579,-19,2,-17,130,227
17015,015,17,2023,15526,46,3,49,124,226
17017,017,17,2020,12991,-60,0,-60,38,30
17017,017,17,2021,12790,-211,26,-185,154,162
17017,017,17,2022,12638,-237,59,-178,163,142
17017,017,17,2023,12596,-128,67,-61,158,139
17019,019,17,2020,205654,-425,30,-395,524,348
17019,019,17,2021,206605,-380,708,328,2095,1628
17019,019,17,2022,206169,-2762,1789,-973,2089,1616
17019,019,17,2023,205644,-3275,2144,-1131,2090,1504
17021,021,17,2020,33960,-65,0,-65,83,98
17021,021,17,2021,33703,-74,1,-73,296,503
17021,021,17,2022,33390,-105,-1,-106,291,486
17021,021,17,2023,33228,3,0,3,284,449
17023,023,17,2020,15429,-35,0,-35,48,45
17023,023,17,2021,15352,-27,0,-27,179,237
17023,023,17,2022,15160,-73,-4,-77,125,233
17023,023,17,2023,15088,71,-4,67,87,225
17025,025,17,2020,13273,-11,0,-11,32,37
17025,025,17,2021,13163,-88,0,-88,169,195
17025,025,17,2022,13077,-69,0,-69,172,189
17025,025,17,2023,12999,-58,0,-58,163,184
17027,027,17,2020,36901,2,0,2,96,98
17027,027,17,2021,36882,-53,15,-38,394,400
17027,027,17,2022,36937,23,28,51,396,371
17027,027,17,2023,36785,-201,38,-163,375,368
17029,029,17,2020,46760,-74,0,-74,117,152
17029,029,17,2021,46802,152,18,170,463,617
17029,029,17,2022,46346,-349,46,-303,453,606
17029,029,17,2023,46060,-225,52,-173,449,566
17031,031,17,2020,5263608,-11204,251,-10953,14083,15675
17031,031,17,2021,5180919,-93591,6598,-86993,54927,48145
17031,031,17,2022,5111566,-94927,18250,-76677,53649,47752
17031,031,17,2023,5087072,-58105,23790,-34315,53124,43149
17033,033,17,2020,18651,-25,0,-25,42,42
17033,033,17,2021,18684,98,0,98,182,254
17033,033,17,2022,18495,-90,1,-89,163,259
17033,033,17,2023,18300,-94,1,-93,147,250
17035,035,17,2020,10433,-13,0,-13,22,29
17035,035,17,2021,10352,-75,1,-74,128,136
17035,035,17,2022,10308,3,0,3,107,148
17035,035,17,2023,10261,-14,2,-12,100,134
17037,037,17,2020,100269,-226,3,-223,309,232
17037,037,17,2021,100482,-92,117,25,1025,891
17037,037,17,2022,100223,-694,276,-418,1044,883
17037,037,17,2023,100288,-513,350,-163,1040,818
17039,039,17,2020,15461,-41,0,-41,45,60
17039,039,17,2021,15403,3,1,4,162,230
17039,039,17,2022,15365,19,2,21,164,215
17039,039,17,2023,15365,36,4,40,165,201
17041,041,17,2020,19764,6,0,6,62,46
17041,041,17,2021,19694,-75,4,-71,246,257
17041,041,17,2022,19667,-31,10,-21,251,250
17041,041,17,2023,19629,-57,16,-41,243,239
17043,043,17,2020,931317,-1890,93,-1797,2385,2098
17043,043,17,2021,926848,-8086,1254,-6832,9484,7272
17043,043,17,2022,921664,-11346,3576,-7770,9719,7356
17043,043,17,2023,921213,-8099,4517,-3582,9715,6667
17045,045,17,2020,16786,-49,0,-49,39,55
17045,045,17,2021,16576,-109,-1,-110,180,284
17045,045,17,2022,16385,-48,2,-46,140,279
17045,045,17,2023,16334,96,2,98,112,259
17047,047,17,2020,6208,-15,0,-15,7,28
17047,047,17,2021,6084,-91,1,-90,56,88
17047,047,17,2022,6058,18,2,20,44,88
17047,047,17,2023,5968,-32,3,-29,28,88
17049,049,17,2020,34703,-29,0,-29,120,69
17049,049,17,2021,34508,-175,7,-168,425,467
17049,049,17,2022,34300,-211,25,-186,409,425
17049,049,17,2023,34331,10,37,47,374,391
17051,051,17,2020,21490,-14,0,-14,55,55
17051,051,17,2021,21438,-21,3,-18,225,271
17051,051,17,2022,21270,-108,0,-108,202,258
17051,051,17,2023,21164,-44,1,-43,188,252
17053,053,17,2020,13513,7,0,7,34,55
17053,053,17,2021,13479,48,9,57,144,243
17053,053,17,2022,13256,-176,30,-146,143,224
17053,053,17,2023,13250,25,33,58,144,210
17055,055,17,2020,37697,-79,0,-79,100,125
17055,055,17,2021,37459,25,2,27,375,666
17055,055,17,2022,37215,-9,3,-6,411,627
17055,055,17,2023,37138,109,4,113,399,587
17057,057,17,2020,33487,-76,0,-76,87,126
17057,057,17,2021,33275,29,1,30,285,551
17057,057,17,2022,32935,-57,0,-57,266,533
17057,057,17,2023,32541,-156,0,-156,263,503
17059,059,17,2020,4935,3,0,3,9,21
17059,059,17,2021,4895,1,0,1,39,82
17059,059,17,2022,4823,-13,1,-12,34,92
17059,059,17,2023,4670,-86,1,-85,24,91
17061,061,17,2020,11936,-37,0,-37,24,37
17061,061,17,2021,11847,-5,0,-5,109,197
17061,061,17,2022,11640,-111,0,-111,96,188
17061,061,17,2023,11543,-2,0,-2,91,185
17063,063,17,2020,52516,-27,0,-27,124,127
17063,063,17,2021,52959,409,18,427,552,560
17063,063,17,2022,53149,154,25,179,580,536
17063,063,17,2023,53578,328,33,361,580,508
17065,065,17,2020,7999,-2,0,-2,31,27
17065,065,17,2021,7913,-36,0,-36,78,129
17065,065,17,2022,7981,104,0,104,77,110
17065,065,17,2023,7911,-39,0,-39,73,105
17067,067,17,2020,17543,-50,0,-50,44,60
17067,067,17,2021,17376,-82,0,-82,178,268
17067,067,17,2022,17254,-59,5,-54,173,238
17067,067,17,2023,17186,-22,5,-17,178,228
17069,069,17,2020,3642,-1,0,-1,10,15
17069,069,17,2021,3635,51,-1,50,25,82
17069,069,17,2022,3572,-5,-1,-6,29,84
17069,069,17,2023,3569,56,-1,55,27,83
17071,071,17,2020,6335,-30,0,-30,9,26
17071,071,17,2021,6306,22,0,22,52,105
17071,071,17,2022,6168,-98,1,-97,57,101
17071,071,17,2023,6088,-40,1,-39,55,95
17073,073,17,2020,49167,-83,0,-83,129,161
17073,073,17,2021,48911,-87,0,-87,469,659
17073,073,17,2022,48596,-199,-1,-200,500,603
17073,073,17,2023,48448,-82,-2,-84,505,569
17075,075,17,2020,26984,-69,0,-69,75,99
17075,075,17,2021,26775,-47,0,-47,247,424
17075,075,17,2022,26493,-113,2,-111,273,439
17075,075,17,2023,26136,-209,2,-207,273,424
17077,077,17,2020,52891,-76,1,-75,146,145
17077,077,17,2021,52604,-325,76,-249,571,625
17077,077,17,2022,52477,-251,195,-56,544,605
17077,077,17,2023,52141,-549,237,-312,542,569
17079,079,17,2020,9241,-36,0,-36,22,29
17079,079,17,2021,9193,-42,2,-40,104,116
17079,079,17,2022,9172,16,4,20,92,128
17079,079,17,2023,9144,2,8,10,83,121
17081,081,17,2020,36995,-80,0,-80,88,124
17081,081,17,2021,36889,4,4,8,427,559
17081,081,17,2022,36419,-348,7,-341,415,542
17081,081,17,2023,36320,-5,9,4,402,504
17083,083,17,2020,21494,-8,0,-8,49,69
17083,083,17,2021,21349,-21,2,-19,188,327
17083,083,17,2022,21191,-7,11,4,165,316
17083,083,17,2023,21091,28,14,42,151,292
17085,085,17,2020,22057,39,0,39,44,69
17085,085,17,2021,21972,28,1,29,158,276
17085,085,17,2022,21845,1,4,5,162,281
17085,085,17,2023,21756,45,5,50,143,280
17087,087,17,2020,13318,11,0,11,32,32
17087,087,17,2021,13472,223,0,223,106,166
17087,087,17,2022,13391,-25,6,-19,114,173
17087,087,17,2023,13326,-5,6,1,101,168
17089,089,17,2020,516181,-744,5,-739,1460,1112
17089,089,17,2021,516292,-1935,190,-1745,5605,4023
17089,089,17,2022,514139,-4123,416,-3707,5581,4043
17089,089,17,2023,514982,-1805,731,-1074,5581,3707
17091,091,17,2020,107264,-190,0,-190,280,338
17091,091,17,2021,106605,-507,42,-465,1102,1339
17091,091,17,2022,105998,-493,105,-388,1145,1339
17091,091,17,2023,105940,-101,147,46,1136,1243
17093,093,17,2020,132355,234,1,235,379,174
17093,093,17,2021,135015,1894,61,1955,1477,784
17093,093,17,2022,137494,1557,172,1729,1572,787
17093,093,17,2023,139976,1440,235,1675,1566,751
17095,095,17,2020,49790,-126,0,-126,125,160
17095,095,17,2021,49310,-230,46,-184,502,819
17095,095,17,2022,48620,-554,136,-418,470,747
17095,095,17,2023,48411,-120,169,49,459,717
17097,097,17,2020,713281,-1156,99,-1057,1692,1657
17097,097,17,2021,712570,-2825,537,-2288,6635,5310
17097,097,17,2022,709899,-6054,2070,-3984,6644,5445
17097,097,17,2023,708760,-5388,2626,-2762,6534,4977
17099,099,17,2020,109410,-157,0,-157,248,337
17099,099,17,2021,109160,44,26,70,1111,1514
17099,099,17,2022,108181,-710,59,-651,1123,1449
17099,099,17,2023,108309,261,81,342,1119,1328
17101,101,17,2020,15268,-25,0,-25,32,33
17101,101,17,2021,15228,21,2,23,147,215
17101,101,17,2022,14891,-249,3,-246,101,199
17101,101,17,2023,14813,24,3,27,90,194
17103,103,17,2020,34062,-64,0,-64,78,101
17103,103,17,2021,34195,248,3,251,329,455
17103,103,17,2022,33938,-183,18,-165,340,425
17103,103,17,2023,33654,-243,23,-220,343,405
17105,105,17,2020,35792,-33,0,-33,98,103
17105,105,17,2021,35769,28,11,39,421,506
17105,105,17,2022,35517,-147,17,-130,384,497
17105,105,17,2023,35320,-124,23,-101,383,480
17107,107,17,2020,27912,-49,0,-49,52,85
17107,107,17,2021,27979,230,4,234,237,407
17107,107,17,2022,27666,-229,10,-219,255,355
17107,107,17,2023,27590,0,12,12,254,342
17109,109,17,2020,27100,-95,0,-95,67,95
17109,109,17,2021,26880,-154,12,-142,258,343
17109,109,17,2022,26914,106,35,141,244,331
17109,109,17,2023,26839,-29,42,13,233,319
17111,111,17,2020,309882,-398,1,-397,771,708
17111,111,17,2021,311543,1008,46,1054,2932,2543
17111,111,17,2022,311558,-381,60,-321,3080,2654
17111,111,17,2023,312800,499,114,613,3060,2421
17113,113,17,2020,170949,-155,12,-143,416,310
17113,113,17,2021,171109,-375,207,-168,1700,1496
17113,113,17,2022,170918,-863,481,-382,1691,1455
17113,113,17,2023,170441,-1426,605,-821,1692,1356
17115,115,17,2020,103752,-217,0,-217,305,315
17115,115,17,2021,102597,-971,52,-919,1220,1462
17115,115,17,2022,101333,-1118,141,-977,1158,1445
17115,115,17,2023,100591,-715,170,-545,1149,1346
17117,117,17,2020,44856,-76,0,-76,107,147
17117,117,17,2021,44492,-112,2,-110,408,684
17117,117,17,2022,44123,-91,20,-71,395,677
17117,117,17,2023,44018,138,23,161,369,635
17119,119,17,2020,265643,-159,1,-158,664,795
17119,119,17,2021,264867,-204,42,-162,2695,3498
17119,119,17,2022,263572,-328,95,-233,2495,3429
17119,119,17,2023,262752,-28,122,94,2189,3108
17121,121,17,2020,37652,-65,0,-65,111,130
17121,121,17,2021,37379,-121,2,-119,498,675
17121,121,17,2022,36905,-296,3,-293,437,607
17121,121,17,2023,36673,-99,5,-94,421,560
17123,123,17,2020,11717,-29,0,-29,29,33
17123,123,17,2021,11668,38,0,38,103,195
17123,123,17,2022,11671,67,3,70,125,186
17123,123,17,2023,11683,67,4,71,121,181
17125,125,17,2020,13058,-35,0,-35,42,39
17125,125,17,2021,12830,-89,1,-88,100,243
17125,125,17,2022,12699,1,3,4,89,219
17125,125,17,2023,12523,-55,4,-51,87,211
17127,127,17,2020,14133,-20,0,-20,32,49
17127,127,17,2021,13946,-83,0,-83,124,233
17127,127,17,2022,13827,31,-6,25,109,244
17127,127,17,2023,13661,-2,-6,-8,81,238
17129,129,17,2020,12270,-16,0,-16,28,35
17129,129,17,2021,12167,-77,2,-75,121,152
17129,129,17,2022,12072,-43,2,-41,112,160
17129,129,17,2023,11954,-78,2,-76,109,153
17131,131,17,2020,15632,-48,0,-48,27,40
17131,131,17,2021,15580,26,0,26,145,234
17131,131,17,2022,15533,42,0,42,137,217
17131,131,17,2023,15487,25,1,26,137,207
17133,133,17,2020,34953,0,0,0,85,89
17133,133,17,2021,35004,94,3,97,296,367
17133,133,17,2022,35001,146,0,146,245,370
17133,133,17,2023,34957,172,0,172,134,347
17135,135,17,2020,28202,-52,0,-52,60,88
17135,135,17,2021,28082,91,1,92,255,477
17135,135,17,2022,27901,21,4,25,240,430
17135,135,17,2023,27663,-86,4,-82,235,392
17137,137,17,2020,32845,-53,0,-53,78,103
17137,137,17,2021,32646,-87,4,-83,326,463
17137,137,17,2022,32298,-223,4,-219,328,455
17137,137,17,2023,32140,-44,7,-37,327,448
17139,139,17,2020,14481,-26,0,-26,29,49
17139,139,17,2021,14561,69,1,70,211,207
17139,139,17,2022,14375,-147,5,-142,166,213
17139,139,17,2023,14342,3,6,9,162,204
17141,141,17,2020,51692,-75,0,-75,117,129
17141,141,17,2021,51464,-148,15,-133,513,633
17141,141,17,2022,51345,-30,8,-22,525,598
17141,141,17,2023,51265,-52,17,-35,519,562
17143,143,17,2020,181319,-526,1,-525,543,514
17143,143,17,2021,179638,-1918,202,-1716,2192,2160
17143,143,17,2022,178000,-2082,499,-1583,2081,2144
17143,143,17,2023,177513,-1121,608,-513,2008,1989
17145,145,17,2020,20886,-43,0,-43,47,56
17145,145,17,2021,21014,216,4,220,196,288
17145,145,17,2022,20512,-397,3,-394,180,304
17145,145,17,2023,20503,87,5,92,177,277
17147,147,17,2020,16681,-3,0,-3,41,36
17147,147,17,2021,16757,123,0,123,157,210
17147,147,17,2022,16675,-29,1,-28,155,205
17147,147,17,2023,16714,72,1,73,155,187
17149,149,17,2020,14640,-72,0,-72,42,56
17149,149,17,2021,14621,45,4,49,179,254
17149,149,17,2022,14499,-48,8,-40,166,242
17149,149,17,2023,14342,-93,9,-84,158,233
17151,151,17,2020,3754,-6,0,-6,6,11
17151,151,17,2021,3758,37,-1,36,29,62
17151,151,17,2022,3746,34,-1,33,26,69
17151,151,17,2023,3707,6,-1,5,26,70
17153,153,17,2020,5160,-17,0,-17,14,25
17153,153,17,2021,5075,-62,0,-62,68,90
17153,153,17,2022,4950,-56,-1,-57,43,108
17153,153,17,2023,4911,32,-1,31,37,107
17155,155,17,2020,5630,1,0,1,7,14
17155,155,17,2021,5588,-32,0,-32,48,58
17155,155,17,2022,5553,-14,0,-14,43,62
17155,155,17,2023,5561,28,0,28,42,62
17157,157,17,2020,30090,-54,1,-53,87,109
17157,157,17,2021,30204,236,21,257,299,449
17157,157,17,2022,30026,-74,41,-33,286,420
17157,157,17,2023,29815,-113,49,-64,251,400
17159,159,17,2020,15790,7,0,7,32,64
17159,159,17,2021,15767,34,1,35,179,247
17159,159,17,2022,15555,-109,6,-103,157,263
17159,159,17,2023,15488,32,8,40,141,249
17161,161,17,2020,144360,-256,1,-255,386,438
17161,161,17,2021,142923,-1187,136,-1051,1533,1943
17161,161,17,2022,141559,-1511,352,-1159,1585,1797
17161,161,17,2023,141236,-717,436,-281,1622,1663
17163,163,17,2020,256844,-419,-4,-423,708,872
17163,163,17,2021,254958,-1722,57,-1665,2809,3102
17163,163,17,2022,252265,-2276,144,-2132,2487,3033
17163,163,17,2023,251018,-877,223,-654,2168,2775
17165,165,17,2020,23690,-61,0,-61,58,75
17165,165,17,2021,23316,-187,0,-187,249,440
17165,165,17,2022,23052,-95,1,-94,245,406
17165,165,17,2023,22873,-32,4,-28,230,380
17167,167,17,2020,196144,-198,1,-197,531,550
17167,167,17,2021,195371,-870,106,-764,2080,2181
17167,167,17,2022,194151,-1148,255,-893,1911,2209
17167,167,17,2023,193491,-764,319,-445,1850,2074
17169,169,17,2020,6868,-20,0,-20,16,26
17169,169,17,2021,6831,-7,3,-4,64,97
17169,169,17,2022,6753,-43,9,-34,65,107
17169,169,17,2023,6733,4,11,15,66,100
17171,171,17,2020,4941,-1,0,-1,10,14
17171,171,17,2021,4849,-65,0,-65,39,66
17171,171,17,2022,4771,-40,0,-40,34,70
17171,171,17,2023,4710,-27,0,-27,34,68
17173,173,17,2020,20919,-60,0,-60,50,57
17173,173,17,2021,20862,7,3,10,200,278
17173,173,17,2022,20710,-13,5,-8,189,322
17173,173,17,2023,20568,-34,5,-29,180,294
17175,175,17,2020,5382,-7,0,-7,12,18
17175,175,17,2021,5284,-72,1,-71,60,86
17175,175,17,2022,5313,72,2,74,46,90
17175,175,17,2023,5218,-56,4,-52,44,86
17177,177,17,2020,44503,-93,0,-93,106,137
17177,177,17,2021,44062,-225,4,-221,452,685
17177,177,17,2022,43556,-244,25,-219,382,663
17177,177,17,2023,43105,-175,33,-142,314,623
17179,179,17,2020,131086,-184,0,-184,294,372
17179,179,17,2021,130412,-221,26,-195,1225,1776
17179,179,17,2022,129610,-301,29,-272,1262,1727
17179,179,17,2023,129541,294,36,330,1201,1597
17181,181,17,2020,17184,-29,0,-29,44,70
17181,181,17,2021,16921,-142,2,-140,154,279
17181,181,17,2022,16772,-51,19,-32,148,259
17181,181,17,2023,16667,-9,21,12,136,253
17183,183,17,2020,74009,-165,0,-165,214,237
17183,183,17,2021,73164,-548,13,-535,844,1174
17183,183,17,2022,72103,-719,12,-707,853,1201
17183,183,17,2023,71652,-203,16,-187,849,1115
17185,185,17,2020,11318,-37,0,-37,21,24
17185,185,17,2021,11208,-55,3,-52,113,173
17185,185,17,2022,11040,-81,7,-74,71,165
17185,185,17,2023,10942,15,10,25,39,161
17187,187,17,2020,16821,-32,0,-32,80,60
17187,187,17,2021,16585,-201,9,-192,189,232
17187,187,17,2022,16360,-230,21,-209,198,219
17187,187,17,2023,16185,-187,25,-162,196,210
17189,189,17,2020,13723,-34,0,-34,39,39
17189,189,17,2021,13640,-40,1,-39,129,180
17189,189,17,2022,13623,50,0,50,119,175
17189,189,17,2023,13536,-29,1,-28,111,170
17191,191,17,2020,16126,-34,0,-34,31,45
17191,191,17,2021,15956,-105,10,-95,182,261
17191,191,17,2022,15843,-52,47,-5,158,256
17191,191,17,2023,15761,-23,57,34,137,252
17193,193,17,2020,13808,-29,0,-29,23,57
17193,193,17,2021,13758,95,3,98,125,276
17193,193,17,2022,13595,-18,6,-12,112,257
17193,193,17,2023,13401,-43,6,-37,86,243
17195,195,17,2020,55565,-104,0,-104,161,183
17195,195,17,2021,55302,-42,18,-24,585,854
17195,195,17,2022,54555,-532,32,-500,533,783
17195,195,17,2023,54498,112,43,155,537,743
17197,197,17,2020,696826,-645,4,-641,1700,1600
17197,197,17,2021,699176,276,371,647,6861,5617
17197,197,17,2022,698046,-3283,922,-2361,6960,5692
17197,197,17,2023,700728,-374,1289,915,6953,5180
17199,199,17,2020,67114,-19,0,-19,158,194
17199,199,17,2021,66883,-43,26,-17,660,917
17199,199,17,2022,66544,-101,52,-49,638,901
17199,199,17,2023,66706,322,61,383,633,854
17201,201,17,2020,284916,-383,3,-380,826,891
17201,201,17,2021,283333,-1616,230,-1386,3231,3528
17201,201,17,2022,281542,-1894,479,-1415,3234,3571
17201,201,17,2023,280922,-1144,608,-536,3193,3290
17203,203,17,2020,38413,-45,0,-45,94,100
17203,203,17,2021,38220,-130,5,-125,379,463
17203,203,17,2022,38177,-15,24,9,402,439
17203,203,17,2023,38285,104,27,131,397,420
18001,001,18,2020,35849,-45,0,-45,168,87
18001,001,18,2021,35991,-153,3,-150,665,386
18001,001,18,2022,36151,-110,0,-110,670,391
18001,001,18,2023,36288,-124,-1,-125,629,369
18003,003,18,2020,386103,256,8,264,1273,952
18003,003,18,2021,389163,1341,339,1680,5170,4039
18003,003,18,2022,391644,478,881,1359,5316,3990
18003,003,18,2023,394545,103,1020,1123,5282,3520
18005,005,18,2020,82218,-58,19,-39,256,228
18005,005,18,2021,82729,43,248,291,1042,874
18005,005,18,2022,83394,1,560,561,1042,908
18005,005,18,2023,84003,-281,673,392,1031,820
18007,007,18,2020,8715,-9,0,-9,28,23
18007,007,18,2021,8686,-7,0,-7,91,117
18007,007,18,2022,8672,-3,10,7,92,108
18007,007,18,2023,8729,68,9,77,90,108
18009,009,18,2020,12105,9,0,9,33,47
18009,009,18,2021,12041,22,3,25,97,192
18009,009,18,2022,11919,-46,6,-40,127,207
18009,009,18,2023,11893,43,5,48,130,202
18011,011,18,2020,71137,323,0,323,191,184
18011,011,18,2021,73080,1764,45,1809,776,597
18011,011,18,2022,74309,951,73,1024,878,654
18011,011,18,2023,76120,1456,91,1547,879,609
18013,013,18,2020,15485,36,0,36,26,47
18013,013,18,2021,15592,193,0,193,118,205
18013,013,18,2022,15587,95,3,98,106,209
18013,013,18,2023,15653,168,5,173,94,199
18015,015,18,2020,20339,9,1,10,58,41
18015,015,18,2021,20525,131,8,139,230,190
18015,015,18,2022,20514,18,9,27,212,242
18015,015,18,2023,20525,40,12,52,193,233
18017,017,18,2020,37786,-56,2,-54,95,114
18017,017,18,2021,37558,-209,43,-166,454,523
18017,017,18,2022,37537,-101,115,14,483,507
18017,017,18,2023,37666,-6,128,122,474,464
18019,019,18,2020,121360,273,0,273,342,356
18019,019,18,2021,122895,1569,43,1612,1395,1470
18019,019,18,2022,124222,1330,119,1449,1396,1563
18019,019,18,2023,125467,1230,112,1342,1309,1413
18021,021,18,2020,26427,-13,0,-13,65,89
18021,021,18,2021,26394,9,2,11,302,364
18021,021,18,2022,26410,86,3,89,298,357
18021,021,18,2023,26460,88,4,92,302,343
18023,023,18,2020,33178,-33,0,-33,126,105
18023,023,18,2021,32983,-146,14,-132,372,449
18023,023,18,2022,32769,-164,17,-147,392,442
18023,023,18,2023,32730,-33,14,-19,395,416
18025,025,18,2020,10524,15,0,15,19,37
18025,025,18,2021,10491,13,0,13,97,148
18025,025,18,2022,10517,94,-1,93,101,169
18025,025,18,2023,10438,-13,-1,-14,97,161
18027,027,18,2020,33357,-37,0,-37,100,92
18027,027,18,2021,33396,-150,39,-111,538,402
18027,027,18,2022,33496,-182,102,-80,535,353
18027,027,18,2023,33656,-151,112,-39,532,338
18029,029,18,2020,50750,59,0,59,135,134
18029,029,18,2021,50875,177,3,180,492,581
18029,029,18,2022,50900,225,8,233,449,632
18029,029,18,2023,51215,498,12,510,380,571
18031,031,18,2020,26474,23,1,24,76,109
18031,031,18,2021,26353,-109,12,-97,308,344
18031,031,18,2022,26454,126,14,140,309,336
18031,031,18,2023,26399,-45,17,-28,309,334
18033,033,18,2020,43292,7,0,7,128,112
18033,033,18,2021,43395,40,4,44,550,525
18033,033,18,2022,43813,356,9,365,557,494
18033,033,18,2023,44198,305,11,316,544,474
18035,035,18,2020,111762,-55,4,-51,272,404
18035,035,18,2021,112057,656,46,702,1059,1527
18035,035,18,2022,112163,504,98,602,1126,1582
18035,035,18,2023,112321,339,121,460,1124,1425
18037,037,18,2020,43642,-25,1,-24,130,100
18037,037,18,2021,43565,-73,23,-50,479,525
18037,037,18,2022,43492,-62,43,-19,500,539
18037,037,18,2023,43546,2,51,53,498,497
18039,039,18,2020,206991,-326,8,-318,707,461
18039,039,18,2021,207054,-926,160,-766,2858,2127
18039,039,18,2022,206873,-1329,419,-910,2915,2138
18039,039,18,2023,206409,-1925,475,-1450,2878,1901
18041,041,18,2020,23359,-20,0,-20,68,87
18041,041,18,2021,23381,161,4,165,233,385
18041,041,18,2022,23389,138,10,148,266,397
18041,041,18,2023,23362,82,12,94,241,362
18043,043,18,2020,80519,67,1,68,181,236
18043,043,18,2021,80595,140,47,187,813,983
18043,043,18,2022,80621,187,94,281,773,974
18043,043,18,2023,80809,277,86,363,703,879
18045,045,18,2020,16492,24,0,24,38,50
18045,045,18,2021,16480,55,2,57,188,266
18045,045,18,2022,16620,181,7,188,219,264
18045,045,18,2023,16731,136,7,143,224,254
18047,047,18,2020,22788,-6,0,-6,54,56
18047,047,18,2021,22889,95,6,101,255,269
18047,047,18,2022,23083,212,15,227,235,265
18047,047,18,2023,23096,55,19,74,198,256
18049,049,18,2020,20469,-6,0,-6,52,57
18049,049,18,2021,20412,-29,8,-21,221,271
18049,049,18,2022,20368,18,10,28,237,300
18049,049,18,2023,20358,25,14,39,234,283
18051,051,18,2020,33049,23,0,23,97,89
18051,051,18,2021,32965,-57,24,-33,377,447
18051,051,18,2022,33002,67,18,85,373,408
18051,051,18,2023,32904,-106,19,-87,373,385
18053,053,18,2020,66507,-107,0,-107,189,256
18053,053,18,2021,66188,1,14,15,711,1095
18053,053,18,2022,65993,137,95,232,756,1147
18053,053,18,2023,66200,386,114,500,745,1038
18055,055,18,2020,30793,41,1,42,75,127
18055,055,18,2021,30862,148,13,161,325,433
18055,055,18,2022,31071,302,33,335,335,458
18055,055,18,2023,31196,180,33,213,343,431
18057,057,18,2020,348996,1185,33,1218,912,631
18057,057,18,2021,357620,6677,580,7257,3745,2278
18057,057,18,2022,365463,4873,1332,6205,4059,2359
18057,057,18,2023,371645,2719,1568,4287,4009,2099
18059,059,18,2020,80180,361,1,362,181,195
18059,059,18,2021,81891,1737,16,1753,809,818
18059,059,18,2022,83117,1219,63,1282,882,934
18059,059,18,2023,86166,2977,62,3039,872,851
18061,061,18,2020,39676,26,0,26,92,111
18061,061,18,2021,39805,219,4,223,396,510
18061,061,18,2022,39790,137,17,154,409,551
18061,061,18,2023,40006,313,20,333,382,497
18063,063,18,2020,175596,800,7,807,436,418
18063,063,18,2021,179800,3788,100,3888,1848,1465
18063,063,18,2022,183119,2641,352,2993,1890,1490
18063,063,18,2023,186387,2382,419,2801,1841,1337
18065,065,18,2020,48903,26,0,26,126,176
18065,065,18,2021,49024,353,1,354,454,706
18065,065,18,2022,48815,144,0,144,425,748
18065,065,18,2023,48929,374,1,375,420,679
18067,067,18,2020,83589,12,3,15,225,342
18067,067,18,2021,83650,342,27,369,911,1268
18067,067,18,2022,83546,269,52,321,980,1360
18067,067,18,2023,83831,501,58,559,947,1217
18069,069,18,2020,36646,-34,1,-33,102,99
18069,069,18,2021,36788,222,21,243,404,524
18069,069,18,2022,36800,112,36,148,409,528
18069,069,18,2023,36781,25,37,62,412,492
18071,071,18,2020,46479,-28,1,-27,165,103
18071,071,18,2021,46224,-336,77,-259,590,595
18071,071,18,2022,46230,-268,260,-8,601,582
18071,071,18,2023,46460,-135,295,160,598,529
18073,073,18,2020,32908,-13,0,-13,86,98
18073,073,18,2021,33165,279,1,280,360,393
18073,073,18,2022,33345,241,4,245,382,433
18073,073,18,2023,33535,215,4,219,384,412
18075,075,18,2020,20474,-13,0,-13,70,58
18075,075,18,2021,20282,-205,2,-203,294,284
18075,075,18,2022,20118,-158,7,-151,290,301
18075,075,18,2023,20032,-80,9,-71,279,295
18077,077,18,2020,33100,-37,1,-36,79,89
18077,077,18,2021,33117,87,17,104,350,460
18077,077,18,2022,32936,-106,25,-81,349,440
18077,077,18,2023,33056,157,33,190,347,417
18079,079,18,2020,27580,-28,0,-28,85,94
18079,079,18,2021,27513,-81,1,-80,336,342
18079,079,18,2022,27484,44,2,46,299,355
18079,079,18,2023,27622,189,1,190,291,344
18081,081,18,2020,162237,465,3,468,444,457
18081,081,18,2021,164394,1966,73,2039,1825,1726
18081,081,18,2022,165686,1102,174,1276,1889,1775
18081,081,18,2023,167819,1606,206,1812,1886,1560
18083,083,18,2020,36256,-17,0,-17,93,116
18083,083,18,2021,35976,-164,16,-148,416,567
18083,083,18,2022,35876,-43,72,29,403,510
18083,083,18,2023,36070,171,84,255,411,471
18085,085,18,2020,80141,-161,2,-159,240,173
18085,085,18,2021,80237,-20,89,69,889,916
18085,085,18,2022,80564,252,127,379,925,935
18085,085,18,2023,80364,-390,133,-257,903,850
18087,087,18,2020,40542,-32,0,-32,191,79
18087,087,18,2021,40527,-377,7,-370,688,338
18087,087,18,2022,40854,-64,19,-45,704,315
18087,087,18,2023,40907,-337,23,-314,668,305
18089,089,18,2020,498957,229,14,243,1380,1553
18089,089,18,2021,499257,486,224,710,5314,6107
18089,089,18,2022,499657,637,666,1303,5570,6169
18089,089,18,2023,500598,-19,708,689,5653,5407
18091,091,18,2020,112270,-84,0,-84,288,361
18091,091,18,2021,112513,483,8,491,1117,1420
18091,091,18,2022,111822,-468,27,-441,1183,1391
18091,091,18,2023,111706,-61,35,-26,1180,1274
18093,093,18,2020,45016,49,0,49,103,159
18093,093,18,2021,45066,241,8,249,450,670
18093,093,18,2022,45231,404,19,423,500,747
18093,093,18,2023,45084,13,14,27,502,674
18095,095,18,2020,130167,106,1,107,354,452
18095,095,18,2021,130841,1145,33,1178,1386,1920
18095,095,18,2022,131383,1111,37,1148,1410,1991
18095,095,18,2023,132504,1437,37,1474,1402,1757
18097,097,18,2020,976659,-1360,156,-1204,3341,2972
18097,097,18,2021,971543,-10420,1835,-8585,13172,9833
18097,097,18,2022,969223,-10582,5209,-5373,13753,10461
18097,097,18,2023,968460,-11403,6055,-5348,13736,9122
18099,099,18,2020,46071,-23,0,-23,123,120
18099,099,18,2021,46160,127,2,129,528,595
18099,099,18,2022,46378,206,25,231,562,557
18099,099,18,2023,46352,-108,34,-74,567,519
18101,101,18,2020,9809,-19,0,-19,34,19
18101,101,18,2021,9804,4,0,4,105,121
18101,101,18,2022,9827,23,0,23,133,129
18101,101,18,2023,9897,56,-1,55,144,127
18103,103,18,2020,35906,-28,0,-28,72,106
18103,103,18,2021,35999,203,7,210,349,481
18103,103,18,2022,35546,-282,6,-276,351,531
18103,103,18,2023,35402,3,9,12,340,496
18105,105,18,2020,139585,-154,18,-136,285,301
18105,105,18,2021,140176,193,350,543,1095,1166
18105,105,18,2022,139621,-1237,759,-478,1129,1189
18105,105,18,2023,139342,-1273,913,-360,1146,1082
18107,107,18,2020,37935,16,0,16,99,120
18107,107,18,2021,38057,191,5,196,394,486
18107,107,18,2022,38319,305,24,329,444,496
18107,107,18,2023,38573,249,20,269,445,461
18109,109,18,2020,71836,69,1,70,181,213
18109,109,18,2021,72275,538,18,556,695,846
18109,109,18,2022,72260,158,16,174,779,919
18109,109,18,2023,73227,977,21,998,797,824
18111,111,18,2020,13799,-18,0,-18,35,56
18111,111,18,2021,13820,53,11,64,143,193
18111,111,18,2022,13839,70,25,95,153,227
18111,111,18,2023,13960,164,25,189,152,219
18113,113,18,2020,47460,-51,0,-51,182,141
18113,113,18,2021,47392,-205,25,-180,602,514
18113,113,18,2022,47234,-256,63,-193,603,559
18113,113,18,2023,47430,60,60,120,603,528
18115,115,18,2020,5928,3,0,3,4,15
18115,115,18,2021,5994,96,1,97,59,88
18115,115,18,2022,6097,142,2,144,47,89
18115,115,18,2023,6004,-54,2,-52,47,89
18117,117,18,2020,19850,-2,0,-2,58,79
18117,117,18,2021,19806,37,0,37,212,305
18117,117,18,2022,19601,-103,2,-101,222,320
18117,117,18,2023,19638,129,2,131,213,304
18119,119,18,2020,21318,1,0,1,47,61
18119,119,18,2021,21514,248,2,250,246,302
18119,119,18,2022,21487,173,3,176,114,312
18119,119,18,2023,21532,293,5,298,55,305
18121,121,18,2020,16150,-3,0,-3,38,35
18121,121,18,2021,16486,320,0,320,206,184
18121,121,18,2022,16367,-137,1,-136,217,199
18121,121,18,2023,16484,101,1,102,209,192
18123,123,18,2020,19155,-7,0,-7,43,56
18123,123,18,2021,19334,242,4,246,179,240
18123,123,18,2022,19207,-72,22,-50,178,251
18123,123,18,2023,19209,53,25,78,164,239
18125,125,18,2020,12249,1,0,1,31,39
18125,125,18,2021,12170,-29,0,-29,126,184
18125,125,18,2022,12143,44,-3,41,132,193
18125,125,18,2023,12106,22,-3,19,130,185
18127,127,18,2020,173318,126,0,126,397,477
18127,127,18,2021,174551,1376,52,1428,1580,1843
18127,127,18,2022,174848,511,172,683,1675,1943
18127,127,18,2023,175335,347,182,529,1693,1729
18129,129,18,2020,25185,-22,0,-22,49,61
18129,129,18,2021,25165,-1,2,1,241,272
18129,129,18,2022,25098,-6,1,-5,214,261
18129,129,18,2023,25040,-21,2,-19,205,245
18131,131,18,2020,12515,7,0,7,26,35
18131,131,18,2021,12360,-89,7,-82,128,203
18131,131,18,2022,12449,173,14,187,120,215
18131,131,18,2023,12385,5,14,19,123,207
18133,133,18,2020,36689,-25,0,-25,80,110
18133,133,18,2021,37043,394,26,420,349,421
18133,133,18,2022,37294,327,40,367,347,450
18133,133,18,2023,37567,291,46,337,350,414
18135,135,18,2020,24415,-72,0,-72,67,84
18135,135,18,2021,24409,92,13,105,279,403
18135,135,18,2022,24350,69,24,93,286,425
18135,135,18,2023,24216,-40,21,-19,286,401
18137,137,18,2020,28980,-15,0,-15,93,87
18137,137,18,2021,29015,73,4,77,342,402
18137,137,18,2022,29030,121,8,129,336,431
18137,137,18,2023,29227,262,9,271,334,404
18139,139,18,2020,16763,13,0,13,47,50
18139,139,18,2021,16679,-42,2,-40,175,230
18139,139,18,2022,16672,16,10,26,200,225
18139,139,18,2023,16847,186,11,197,200,220
18141,141,18,2020,272682,-324,7,-317,784,750
18141,141,18,2021,272286,-700,255,-445,3183,3315
18141,141,18,2022,272282,-625,663,38,3260,3190
18141,141,18,2023,272848,-671,763,92,3286,2826
18143,143,18,2020,24377,0,0,0,75,92
18143,143,18,2021,24422,142,1,143,291,399
18143,143,18,2022,24500,241,7,248,280,445
18143,143,18,2023,24657,298,4,302,279,425
18145,145,18,2020,45060,17,0,17,126,145
18145,145,18,2021,45101,70,22,92,458,542
18145,145,18,2022,45189,101,82,183,484,549
18145,145,18,2023,45231,-14,86,72,479,510
18147,147,18,2020,19833,9,0,9,58,50
18147,147,18,2021,19841,35,7,42,218,265
18147,147,18,2022,19849,99,9,108,195,288
18147,147,18,2023,19910,137,9,146,187,270
18149,149,18,2020,23396,23,0,23,58,74
18149,149,18,2021,23373,90,6,96,247,380
18149,149,18,2022,23203,-24,15,-9,236,384
18149,149,18,2023,23206,115,15,130,236,363
18151,151,18,2020,34441,12,0,12,80,99
18151,151,18,2021,34702,265,10,275,345,367
18151,151,18,2022,34772,115,18,133,357,403
18151,151,18,2023,34917,145,20,165,356,375
18153,153,18,2020,20812,0,0,0,45,51
18153,153,18,2021,20777,18,0,18,219,286
18153,153,18,2022,20671,-34,8,-26,210,281
18153,153,18,2023,20757,140,7,147,212,270
18155,155,18,2020,9748,-19,0,-19,27,21
18155,155,18,2021,9869,90,1,91,134,107
18155,155,18,2022,10009,132,0,132,121,116
18155,155,18,2023,10019,17,0,17,111,118
18157,157,18,2020,186387,-139,39,-100,497,319
18157,157,18,2021,187423,-286,650,364,2014,1495
18157,157,18,2022,188237,-1271,1606,335,2029,1530
18157,157,18,2023,188792,-2049,1925,-124,2028,1367
18159,159,18,2020,15392,30,0,30,49,47
18159,159,18,2021,15394,47,8,55,163,223
18159,159,18,2022,15325,17,5,22,152,235
18159,159,18,2023,15256,0,6,6,148,223
18161,161,18,2020,7082,-3,0,-3,20,22
18161,161,18,2021,7018,-35,2,-33,77,109
18161,161,18,2022,6967,-33,0,-33,72,91
18161,161,18,2023,6973,33,1,34,62,90
18163,163,18,2020,180336,212,7,219,521,569
18163,163,18,2021,180165,-26,114,88,2038,2421
18163,163,18,2022,179563,-447,166,-281,2169,2389
18163,163,18,2023,179810,-3,196,193,2159,2108
18165,165,18,2020,15409,-28,0,-28,48,55
18165,165,18,2021,15435,77,3,80,166,229
18165,165,18,2022,15433,68,6,74,167,238
18165,165,18,2023,15417,35,4,39,171,227
18167,167,18,2020,106130,-68,1,-67,307,297
18167,167,18,2021,106116,99,53,152,1151,1405
18167,167,18,2022,106082,107,139,246,1148,1363
18167,167,18,2023,106153,-34,161,127,1167,1226
18169,169,18,2020,30934,-25,0,-25,75,99
18169,169,18,2021,30893,183,4,187,294,535
18169,169,18,2022,30842,184,9,193,315,543
18169,169,18,2023,30670,8,11,19,313,504
18171,171,18,2020,8423,-10,0,-10,27,28
18171,171,18,2021,8449,77,1,78,63,117
18171,171,18,2022,8488,49,3,52,89,99
18171,171,18,2023,8518,35,4,39,87,95
18173,173,18,2020,63996,127,0,127,158,193
18173,173,18,2021,64657,738,22,760,640,754
18173,173,18,2022,65231,667,69,736,591,733
18173,173,18,2023,65867,659,73,732,584,673
18175,175,18,2020,28238,50,0,50,82,66
18175,175,18,2021,28138,-69,5,-64,325,374
18175,175,18,2022,28171,122,13,135,320,405
18175,175,18,2023,28205,100,12,112,303,381
18177,177,18,2020,66507,-10,0,-10,206,247
18177,177,18,2021,66435,193,47,240,745,1100
18177,177,18,2022,66216,15,72,87,771,1040
18177,177,18,2023,66127,23,83,106,748,943
18179,179,18,2020,28155,-10,0,-10,68,76
18179,179,18,2021,28154,29,8,37,335,389
18179,179,18,2022,28298,181,23,204,317,368
18179,179,18,2023,28555,266,24,290,314,347
18181,181,18,2020,24673,-7,0,-7,67,87
18181,181,18,2021,24643,23,17,40,250,333
18181,181,18,2022,24660,-49,72,23,329,328
18181,181,18,2023,24917,60,85,145,423,311
18183,183,18,2020,34329,141,0,141,92,81
18183,183,18,2021,34470,130,5,135,353,370
18183,183,18,2022,34577,145,6,151,370,391
18183,183,18,2023,34742,146,6,152,377,363
19001,001,19,2020,7493,-10,0,-10,23,17
19001,001,19,2021,7524,71,4,75,84,127
19001,001,19,2022,7457,-18,6,-12,84,134
19001,001,19,2023,7389,-37,4,-33,85,120
19003,003,19,2020,3709,-2,0,-2,13,9
19003,003,19,2021,3638,-61,0,-61,43,52
19003,003,19,2022,3601,-18,1,-17,41,61
19003,003,19,2023,3544,-40,1,-39,39,56
19005,005,19,2020,14071,-9,0,-9,63,50
19005,005,19,2021,13968,-100,11,-89,189,207
19005,005,19,2022,14018,-31,59,28,189,162
19005,005,19,2023,14074,-27,61,34,177,155
19007,007,19,2020,12287,-15,0,-15,23,37
19007,007,19,2021,12269,61,3,64,130,215
19007,007,19,2022,12141,-52,4,-48,125,199
19007,007,19,2023,12119,41,3,44,126,190
19009,009,19,2020,5683,2,0,2,18,13
19009,009,19,2021,5645,-7,1,-6,53,89
19009,009,19,2022,5575,-52,5,-47,62,85
19009,009,19,2023,5534,-25,7,-18,61,83
19011,011,19,2020,25549,-33,0,-33,50,54
19011,011,19,2021,25738,200,5,205,269,293
19011,011,19,2022,25742,-3,11,8,262,251
19011,011,19,2023,25796,26,13,39,263,247
19013,013,19,2020,131044,-199,7,-192,436,365
19013,013,19,2021,130576,-837,208,-629,1602,1489
19013,013,19,2022,130052,-1111,519,-592,1611,1513
19013,013,19,2023,130471,-226,370,144,1629,1352
19015,015,19,2020,26698,-1,0,-1,59,77
19015,015,19,2021,26761,137,2,139,263,347
19015,015,19,2022,26579,-94,0,-94,279,358
19015,015,19,2023,26590,83,-1,82,281,350
19017,017,19,2020,25011,20,0,20,63,69
19017,017,19,2021,25118,132,21,153,237,295
19017,017,19,2022,25254,131,40,171,247,265
19017,017,19,2023,25307,37,24,61,250,256
19019,019,19,2020,20605,17,0,17,67,46
19019,019,19,2021,20703,32,14,46,274,236
19019,019,19,2022,20689,-59,33,-26,250,233
19019,019,19,2023,20691,-59,29,-30,254,223
19021,021,19,2020,20806,-26,6,-20,58,54
19021,021,19,2021,20790,-200,60,-140,310,188
19021,021,19,2022,20644,-415,149,-266,298,188
19021,021,19,2023,20567,-323,122,-201,304,181
19023,023,19,2020,14333,-7,0,-7,40,37
19023,023,19,2021,14348,75,5,80,130,202
19023,023,19,2022,14246,-58,16,-42,150,208
19023,023,19,2023,14172,-42,9,-33,152,192
19025,025,19,2020,9900,-26,0,-26,22,27
19025,025,19,2021,9895,54,0,54,76,136
19025,025,19,2022,9725,-118,2,-116,91,146
19025,025,19,2023,9763,86,2,88,94,141
19027,027,19,2020,20726,-41,0,-41,69,59
19027,027,19,2021,20740,51,11,62,226,286
19027,027,19,2022,20541,-165,18,-147,250,296
19027,027,19,2023,20522,-9,26,17,250,286
19029,029,19,2020,13123,8,0,8,27,49
19029,029,19,2021,13089,46,1,47,127,215
19029,029,19,2022,13137,134,1,135,130,212
19029,029,19,2023,13130,66,0,66,129,200
19031,031,19,2020,18495,-6,0,-6,45,47
19031,031,19,2021,18436,-23,4,-19,168,213
19031,031,19,2022,18353,-18,20,2,160,236
19031,031,19,2023,18302,5,10,15,160,227
19033,033,19,2020,43022,-71,0,-71,111,146
19033,033,19,2021,42761,-112,14,-98,420,609
19033,033,19,2022,42426,-227,52,-175,446,594
19033,033,19,2023,42406,47,30,77,449,546
19035,035,19,2020,11656,3,0,3,31,36
19035,035,19,2021,11535,-75,0,-75,131,179
19035,035,19,2022,11490,20,-1,19,124,180
19035,035,19,2023,11605,167,-1,166,125,174
19037,037,19,2020,11988,-29,0,-29,41,34
19037,037,19,2021,11883,-68,-1,-69,125,163
19037,037,19,2022,11728,-158,26,-132,134,158
19037,037,19,2023,11658,-92,36,-56,132,147
19039,039,19,2020,9737,-18,1,-17,26,27
19039,039,19,2021,9756,27,23,50,120,157
19039,039,19,2022,9643,-100,6,-94,126,145
19039,039,19,2023,9588,-41,12,-29,127,154
19041,041,19,2020,16336,-27,0,-27,43,60
19041,041,19,2021,16454,132,4,136,171,195
19041,041,19,2022,16507,90,3,93,171,202
19041,041,19,2023,16511,27,2,29,165,190
19043,043,19,2020,17033,-33,0,-33,63,44
19043,043,19,2021,17053,64,4,68,195,250
19043,043,19,2022,17057,28,21,49,200,234
19043,043,19,2023,16969,-49,15,-34,168,222
19045,045,19,2020,46427,-39,0,-39,136,135
19045,045,19,2021,46483,139,10,149,495,620
19045,045,19,2022,46255,-103,14,-89,545,664
19045,045,19,2023,46158,-32,5,-27,549,618
19047,047,19,2020,16484,-53,2,-51,62,43
19047,047,19,2021,16232,-295,26,-269,215,190
19047,047,19,2022,16129,-232,63,-169,236,172
19047,047,19,2023,16013,-223,40,-183,228,161
19049,049,19,2020,100536,721,2,723,304,172
19049,049,19,2021,104174,2857,133,2990,1343,605
19049,049,19,2022,108146,2774,335,3109,1398,623
19049,049,19,2023,111092,1908,218,2126,1413,599
19051,051,19,2020,9111,-5,0,-5,30,22
19051,051,19,2021,9150,-31,3,-28,161,100
19051,051,19,2022,9147,-94,25,-69,152,88
19051,051,19,2023,9169,-76,32,-44,154,88
19053,053,19,2020,7606,-21,0,-21,11,22
19053,053,19,2021,7668,65,6,71,85,95
19053,053,19,2022,7695,36,18,54,85,107
19053,053,19,2023,7665,-26,9,-17,86,98
19055,055,19,2020,17458,-24,0,-24,42,42
19055,055,19,2021,17553,79,2,81,201,198
19055,055,19,2022,17607,54,4,58,201,196
19055,055,19,2023,17600,-24,3,-21,201,186
19057,057,19,2020,38823,-74,1,-73,109,124
19057,057,19,2021,38506,-249,39,-210,404,524
19057,057,19,2022,38242,-185,72,-113,410,549
19057,057,19,2023,38253,64,41,105,415,509
19059,059,19,2020,17767,80,1,81,39,52
19059,059,19,2021,17868,153,13,166,172,240
19059,059,19,2022,18048,227,18,245,157,221
19059,059,19,2023,18056,56,7,63,154,208
19061,061,19,2020,99308,-38,1,-37,279,231
19061,061,19,2021,98854,-584,51,-533,1074,1034
19061,061,19,2022,98715,-274,183,-91,1109,1113
19061,061,19,2023,98887,-31,105,74,1115,1018
19063,063,19,2020,9347,-28,0,-28,21,36
19063,063,19,2021,9334,32,3,35,91,144
19063,063,19,2022,9214,-88,-4,-92,107,135
19063,063,19,2023,9229,49,-4,45,95,124
19065,065,19,2020,19445,-63,0,-63,68,63
19065,065,19,2021,19295,-62,13,-49,182,290
19065,065,19,2022,19266,41,18,59,198,273
19065,065,19,2023,19210,-11,13,2,205,262
19067,067,19,2020,15604,-36,0,-36,51,45
19067,067,19,2021,15465,-84,-1,-85,165,222
19067,067,19,2022,15348,-64,2,-62,163,217
19067,067,19,2023,15326,15,4,19,164,204
19069,069,19,2020,10002,-24,0,-24,36,29
19069,069,19,2021,9952,-29,-1,-30,146,170
19069,069,19,2022,9946,-17,21,4,128,137
19069,069,19,2023,9875,-92,13,-79,130,122
19071,071,19,2020,6566,-31,0,-31,17,16
19071,071,19,2021,6583,43,0,43,58,85
19071,071,19,2022,6475,-80,2,-78,66,100
19071,071,19,2023,6458,9,1,10,67,95
19073,073,19,2020,8752,-14,0,-14,23,21
19073,073,19,2021,8724,2,1,3,83,120
19073,073,19,2022,8710,36,2,38,87,135
19073,073,19,2023,8584,-86,1,-85,89,129
19075,075,19,2020,12333,3,0,3,34,32
19075,075,19,2021,12358,53,6,59,123,165
19075,075,19,2022,12355,8,10,18,140,159
19075,075,19,2023,12384,32,6,38,141,149
19077,077,19,2020,10612,8,0,8,22,39
19077,077,19,2021,10588,20,3,23,84,137
19077,077,19,2022,10681,119,22,141,96,136
19077,077,19,2023,10722,70,11,81,95,133
19079,079,19,2020,15008,-17,0,-17,39,50
19079,079,19,2021,14863,-96,2,-94,153,207
19079,079,19,2022,14803,-36,9,-27,175,204
19079,079,19,2023,14729,-77,15,-62,181,194
19081,081,19,2020,10754,-35,0,-35,31,29
19081,081,19,2021,10680,-57,4,-53,121,145
19081,081,19,2022,10651,1,12,13,119,157
19081,081,19,2023,10615,-22,15,-7,120,149
19083,083,19,2020,16828,-38,0,-38,42,52
19083,083,19,2021,16702,-3,17,14,133,279
19083,083,19,2022,16614,-13,56,43,151,274
19083,083,19,2023,16463,-130,76,-54,154,252
19085,085,19,2020,14569,-15,0,-15,44,43
19085,085,19,2021,14690,202,0,202,152,235
19085,085,19,2022,14680,28,1,29,166,200
19085,085,19,2023,14670,17,1,18,157,185
19087,087,19,2020,20447,-30,0,-30,51,56
19087,087,19,2021,20382,26,2,28,177,281
19087,087,19,2022,20253,-58,5,-53,190,259
19087,087,19,2023,19547,-667,4,-663,194,243
19089,089,19,2020,9489,10,0,10,29,17
19089,089,19,2021,9496,4,2,6,129,131
19089,089,19,2022,9509,31,4,35,122,139
19089,089,19,2023,9376,-133,6,-127,127,131
19091,091,19,2020,9599,-3,0,-3,22,22
19091,091,19,2021,9630,57,3,60,109,140
19091,091,19,2022,9521,-115,15,-100,121,128
19091,091,19,2023,9500,-47,22,-25,124,120
19093,093,19,2020,7022,15,0,15,21,18
19093,093,19,2021,6969,1,0,1,76,130
19093,093,19,2022,6905,-44,5,-39,76,100
19093,093,19,2023,6833,-56,3,-53,79,97
19095,095,19,2020,16658,13,0,13,36,61
19095,095,19,2021,16586,-29,0,-29,164,217
19095,095,19,2022,16497,-44,-1,-45,181,220
19095,095,19,2023,16381,-90,-2,-92,185,210
19097,097,19,2020,19455,-31,0,-31,49,49
19097,097,19,2021,19399,1,6,7,205,278
19097,097,19,2022,19346,-13,22,9,208,258
19097,097,19,2023,19342,13,13,26,208,237
19099,099,19,2020,37810,-5,0,-5,114,115
19099,099,19,2021,37874,73,30,103,390,452
19099,099,19,2022,37949,106,71,177,383,459
19099,099,19,2023,37919,-36,47,11,383,424
19101,101,19,2020,15694,23,5,28,45,46
19101,101,19,2021,15781,16,112,128,152,202
19101,101,19,2022,15668,-281,213,-68,142,195
19101,101,19,2023,15440,-311,128,-183,144,189
19103,103,19,2020,153056,-107,42,-65,402,190
19103,103,19,2021,155035,586,551,1137,1638,889
19103,103,19,2022,156915,72,1170,1242,1678,953
19103,103,19,2023,157528,-934,729,-205,1690,877
19105,105,19,2020,20653,4,0,4,49,47
19105,105,19,2021,20826,230,0,230,197,256
19105,105,19,2022,20949,181,0,181,187,246
19105,105,19,2023,20900,-14,0,-14,192,227
19107,107,19,2020,10004,-21,0,-21,29,28
19107,107,19,2021,9902,-37,2,-35,89,159
19107,107,19,2022,9883,29,5,34,105,152
19107,107,19,2023,9914,53,7,60,109,138
19109,109,19,2020,14799,-20,0,-20,31,39
19109,109,19,2021,14515,-216,4,-212,165,232
19109,109,19,2022,14465,-8,10,2,163,210
19109,109,19,2023,14396,-48,8,-40,164,194
19111,111,19,2020,33533,-1,0,-1,75,106
19111,111,19,2021,33257,-152,0,-152,346,484
19111,111,19,2022,32829,-223,-5,-228,336,529
19111,111,19,2023,32565,-114,-5,-119,338,485
19113,113,19,2020,230419,-112,17,-95,666,513
19113,113,19,2021,229445,-1723,355,-1368,2542,2208
19113,113,19,2022,228940,-1529,769,-760,2590,2295
19113,113,19,2023,228972,-1020,484,-536,2621,2063
19115,115,19,2020,10814,-18,0,-18,27,23
19115,115,19,2021,10724,-87,26,-61,96,129
19115,115,19,2022,10617,-132,41,-91,109,128
19115,115,19,2023,10513,-149,52,-97,113,120
19117,117,19,2020,8618,-11,0,-11,25,31
19117,117,19,2021,8706,103,2,105,107,125
19117,117,19,2022,8702,13,5,18,113,131
19117,117,19,2023,8747,50,4,54,115,124
19119,119,19,2020,11930,-27,0,-27,44,23
19119,119,19,2021,12040,67,3,70,160,125
19119,119,19,2022,12177,49,14,63,190,109
19119,119,19,2023,12324,63,23,86,158,96
19121,121,19,2020,16629,64,0,64,47,29
19121,121,19,2021,16793,145,0,145,176,166
19121,121,19,2022,17040,241,1,242,190,180
19121,121,19,2023,16971,-96,1,-95,194,169
19123,123,19,2020,22160,-23,0,-23,62,76
19123,123,19,2021,21974,-166,8,-158,239,271
19123,123,19,2022,21971,37,31,68,228,287
19123,123,19,2023,21874,-82,18,-64,232,266
19125,125,19,2020,33414,-21,0,-21,86,77
19125,125,19,2021,33441,37,6,43,363,390
19125,125,19,2022,33630,231,10,241,354,395
19125,125,19,2023,33770,157,3,160,357,374
19127,127,19,2020,40096,-24,14,-10,122,127
19127,127,19,2021,39913,-247,121,-126,483,552
19127,127,19,2022,39821,-281,264,-17,481,556
19127,127,19,2023,40014,-33,283,250,479,537
19129,129,19,2020,14398,-71,0,-71,35,42
19129,129,19,2021,14467,71,4,75,136,149
19129,129,19,2022,14535,102,11,113,133,171
19129,129,19,2023,14633,124,13,137,123,160
19131,131,19,2020,10597,24,0,24,32,28
19131,131,19,2021,10563,-9,7,-2,127,166
19131,131,19,2022,10544,-16,35,19,125,159
19131,131,19,2023,10518,-36,29,-7,127,146
19133,133,19,2020,8742,8,0,8,17,38
19133,133,19,2021,8598,-62,2,-60,102,190
19133,133,19,2022,8506,-28,3,-25,93,159
19133,133,19,2023,8493,40,6,46,92,150
19135,135,19,2020,7593,23,0,23,28,28
19135,135,19,2021,7581,28,0,28,74,118
19135,135,19,2022,7530,-16,0,-16,82,115
19135,135,19,2023,7504,2,0,2,83,111
19137,137,19,2020,10333,15,0,15,23,36
19137,137,19,2021,10316,67,0,67,104,192
19137,137,19,2022,10210,-46,3,-43,105,165
19137,137,19,2023,10139,-13,2,-11,98,157
19139,139,19,2020,43143,-76,2,-74,104,126
19139,139,19,2021,42674,-433,25,-408,448,511
19139,139,19,2022,42395,-341,83,-258,464,491
19139,139,19,2023,42218,-281,106,-175,467,468
19141,141,19,2020,14150,-20,0,-20,42,53
19141,141,19,2021,14044,-59,9,-50,177,238
19141,141,19,2022,14085,-3,55,52,192,197
19141,141,19,2023,14012,-116,42,-74,185,183
19143,143,19,2020,6198,8,0,8,13,15
19143,143,19,2021,6170,-8,4,-4,66,93
19143,143,19,2022,6072,-96,14,-82,72,89
19143,143,19,2023,5978,-80,12,-68,60,84
19145,145,19,2020,15190,2,0,2,28,49
19145,145,19,2021,15220,92,3,95,139,208
19145,145,19,2022,15176,42,11,53,137,228
19145,145,19,2023,15014,-88,5,-83,136,215
19147,147,19,2020,8986,-5,0,-5,20,25
19147,147,19,2021,8923,-49,0,-49,120,136
19147,147,19,2022,8790,-104,0,-104,113,143
19147,147,19,2023,8810,41,0,41,113,134
19149,149,19,2020,25692,-6,1,-5,59,66
19149,149,19,2021,25731,-8,33,25,293,290
19149,149,19,2022,25722,-115,74,-41,309,274
19149,149,19,2023,25722,-89,47,-42,306,264
19151,151,19,2020,7065,0,0,0,17,26
19151,151,19,2021,7039,11,4,15,72,117
19151,151,19,2022,7073,31,38,69,77,108
19151,151,19,2023,6976,-98,27,-71,77,103
19153,153,19,2020,493022,-80,66,-14,1532,1116
19153,153,19,2021,497842,1784,814,2598,6303,4286
19153,153,19,2022,501184,-476,2237,1761,6488,4594
19153,153,19,2023,505255,63,1579,1642,6560,4143
19155,155,19,2020,93669,-34,2,-32,273,258
19155,155,19,2021,93410,-169,77,-92,961,1190
19155,155,19,2022,93065,-270,157,-113,1001,1199
19155,155,19,2023,93179,42,203,245,946,1079
19157,157,19,2020,18631,-8,1,-7,35,60
19157,157,19,2021,18624,19,10,29,184,233
19157,157,19,2022,18518,-69,36,-33,187,252
19157,157,19,2023,18453,-38,18,-20,190,234
19159,159,19,2020,4639,-9,0,-9,14,24
19159,159,19,2021,4632,39,0,39,49,96
19159,159,19,2022,4688,97,5,102,42,87
19159,159,19,2023,4642,-9,1,-8,43,81
19161,161,19,2020,9799,-14,0,-14,21,31
19161,161,19,2021,9768,2,0,2,107,144
19161,161,19,2022,9689,-30,4,-26,113,162
19161,161,19,2023,9686,32,2,34,112,149
19163,163,19,2020,174609,-186,4,-182,510,417
19163,163,19,2021,174225,-492,83,-409,1866,1947
19163,163,19,2022,173751,-714,296,-418,1890,1888
19163,163,19,2023,174270,35,302,337,1904,1722
19165,165,19,2020,11735,-6,0,-6,28,47
19165,165,19,2021,11780,104,2,106,94,160
19165,165,19,2022,11711,-64,40,-24,117,160
19165,165,19,2023,11806,77,59,136,113,152
19167,167,19,2020,35885,-38,0,-38,110,55
19167,167,19,2021,35959,-139,32,-107,484,309
19167,167,19,2022,36127,-166,86,-80,540,278
19167,167,19,2023,36246,-245,119,-126,508,267
19169,169,19,2020,98649,-15,16,1,200,120
19169,169,19,2021,99679,501,278,779,791,608
19169,169,19,2022,98257,-2444,691,-1753,835,663
19169,169,19,2023,98566,-380,468,88,840,625
19171,171,19,2020,17081,-30,2,-28,47,70
19171,171,19,2021,16898,-172,15,-157,197,226
19171,171,19,2022,16943,45,34,79,198,222
19171,171,19,2023,16833,-133,31,-102,203,213
19173,173,19,2020,5862,-22,0,-22,16,23
19173,173,19,2021,5866,24,7,31,63,92
19173,173,19,2022,5875,2,25,27,75,93
19173,173,19,2023,5924,42,19,61,75,86
19175,175,19,2020,12132,-11,0,-11,33,32
19175,175,19,2021,12049,-44,13,-31,121,178
19175,175,19,2022,11903,-126,47,-79,109,179
19175,175,19,2023,11906,13,59,72,104,170
19177,177,19,2020,7222,7,0,7,22,16
19177,177,19,2021,7258,37,0,37,96,100
19177,177,19,2022,7252,-11,1,-10,99,93
19177,177,19,2023,7266,7,1,8,100,93
19179,179,19,2020,35326,-71,0,-71,114,152
19179,179,19,2021,35295,-78,55,-23,445,467
19179,179,19,2022,35081,-363,200,-163,444,494
19179,179,19,2023,35166,-35,140,105,453,471
19181,181,19,2020,52591,167,0,167,129,106
19181,181,19,2021,53485,859,6,865,574,543
19181,181,19,2022,54303,745,23,768,611,557
19181,181,19,2023,55205,780,22,802,617,514
19183,183,19,2020,22542,-26,1,-25,66,67
19183,183,19,2021,22522,-82,22,-60,314,283
19183,183,19,2022,22542,16,17,33,274,276
19183,183,19,2023,22560,-27,30,3,278,263
19185,185,19,2020,6512,5,0,5,31,25
19185,185,19,2021,6531,16,0,16,88,90
19185,185,19,2022,6490,-38,0,-38,87,88
19185,185,19,2023,6557,63,0,63,88,84
19187,187,19,2020,36996,-19,1,-18,123,118
19187,187,19,2021,37170,278,21,299,413,540
19187,187,19,2022,36652,-523,92,-431,415,518
19187,187,19,2023,36485,-210,107,-103,409,476
19189,189,19,2020,10662,-11,0,-11,26,36
19189,189,19,2021,10661,41,3,44,100,151
19189,189,19,2022,10639,11,6,17,98,133
19189,189,19,2023,10571,-42,5,-37,96,125
19191,191,19,2020,20045,-25,0,-25,46,40
19191,191,19,2021,19935,-110,16,-94,189,210
19191,191,19,2022,19902,-15,17,2,190,218
19191,191,19,2023,19815,-66,7,-59,179,210
19193,193,19,2020,105912,-132,4,-128,383,291
19193,193,19,2021,105749,-571,179,-392,1378,1189
19193,193,19,2022,105558,-905,424,-481,1424,1115
19193,193,19,2023,105951,-375,352,-23,1426,1017
19195,195,19,2020,7436,-11,0,-11,15,11
19195,195,19,2021,7377,-41,1,-40,75,95
19195,195,19,2022,7311,-50,3,-47,78,97
19195,195,19,2023,7297,-4,3,-1,79,93
19197,197,19,2020,12916,-32,0,-32,49,41
19197,197,19,2021,12813,-85,19,-66,150,189
19197,197,19,2022,12695,-158,64,-94,165,194
19197,197,19,2023,12656,-110,82,-28,169,181
20001,001,20,2020,12533,2,0,2,37,31
20001,001,20,2021,12498,-2,4,2,126,171
20001,001,20,2022,12489,77,4,81,124,204
20001,001,20,2023,12412,-6,2,-4,124,196
20003,003,20,2020,7839,17,0,17,16,28
20003,003,20,2021,7807,-25,0,-25,102,112
20003,003,20,2022,7798,1,0,1,100,109
20003,003,20,2023,7838,43,0,43,102,104
20005,005,20,2020,16328,-25,0,-25,38,34
20005,005,20,2021,16236,-64,-1,-65,158,193
20005,005,20,2022,16053,-135,3,-132,175,227
20005,005,20,2023,16016,7,1,8,172,218
20007,007,20,2020,4198,-20,0,-20,10,17
20007,007,20,2021,4099,-61,1,-60,41,76
20007,007,20,2022,4124,53,0,53,41,68
20007,007,20,2023,4071,-26,0,-26,40,67
20009,009,20,2020,25427,-61,1,-60,71,80
20009,009,20,2021,25263,-141,19,-122,314,365
20009,009,20,2022,25058,-142,16,-126,314,385
20009,009,20,2023,24899,-135,12,-123,314,351
20011,011,20,2020,14335,-21,0,-21,50,55
20011,011,20,2021,14326,-11,0,-11,221,225
20011,011,20,2022,14443,148,-1,147,194,223
20011,011,20,2023,14408,-17,-1,-18,193,210
20013,013,20,2020,9472,-16,0,-16,20,34
20013,013,20,2021,9446,28,0,28,121,181
20013,013,20,2022,9373,-31,1,-30,117,159
20013,013,20,2023,9250,-80,0,-80,113,156
20015,015,20,2020,67391,25,0,25,148,173
20015,015,20,2021,67976,622,35,657,687,783
20015,015,20,2022,68289,353,95,448,739,830
20015,015,20,2023,68632,249,85,334,747,734
20017,017,20,2020,2571,0,0,0,7,8
20017,017,20,2021,2604,34,1,35,19,21
20017,017,20,2022,2568,-40,1,-39,36,32
20017,017,20,2023,2579,6,0,6,36,32
20019,019,20,2020,3386,15,0,15,8,20
20019,019,20,2021,3389,25,0,25,27,48
20019,019,20,2022,3387,42,0,42,25,66
20019,019,20,2023,3347,1,0,1,23,65
20021,021,20,2020,19309,-45,0,-45,48,58
20021,021,20,2021,19186,6,1,7,201,341
20021,021,20,2022,19025,-17,-2,-19,187,323
20021,021,20,2023,19054,169,-2,167,166,301
20023,023,20,2020,2614,1,0,1,11,14
20023,023,20,2021,2637,29,1,30,41,49
20023,023,20,2022,2618,-13,0,-13,39,42
20023,023,20,2023,2636,19,-1,18,40,39
20025,025,20,2020,1979,-9,0,-9,4,6
20025,025,20,2021,1958,1,0,1,18,41
20025,025,20,2022,1939,-9,0,-9,21,34
20025,025,20,2023,1847,-79,0,-79,21,32
20027,027,20,2020,8121,11,0,11,22,23
20027,027,20,2021,8090,0,0,0,83,118
20027,027,20,2022,8041,-8,0,-8,80,117
20027,027,20,2023,8007,-3,0,-3,81,112
20029,029,20,2020,9009,-26,0,-26,32,30
20029,029,20,2021,8954,-23,2,-21,115,154
20029,029,20,2022,8934,35,8,43,106,163
20029,029,20,2023,8854,-42,8,-34,110,156
20031,031,20,2020,8357,11,0,11,16,29
20031,031,20,2021,8337,4,6,10,73,107
20031,031,20,2022,8252,-49,8,-41,71,115
20031,031,20,2023,8251,28,8,36,71,108
20033,033,20,2020,1678,-2,0,-2,3,7
20033,033,20,2021,1663,4,0,4,16,34
20033,033,20,2022,1690,39,0,39,18,33
20033,033,20,2023,1655,-20,0,-20,17,31
20035,035,20,2020,34534,-17,0,-17,93,102
20035,035,20,2021,34624,204,1,205,411,543
20035,035,20,2022,34423,-110,30,-80,414,528
20035,035,20,2023,34157,-201,11,-190,414,493
20037,037,20,2020,38948,-19,1,-18,114,126
20037,037,20,2021,39028,212,12,224,414,580
20037,037,20,2022,39145,193,30,223,458,539
20037,037,20,2023,38764,-358,20,-338,449,495
20039,039,20,2020,2759,-7,0,-7,7,4
20039,039,20,2021,2766,26,1,27,28,48
20039,039,20,2022,2689,-47,1,-46,30,59
20039,039,20,2023,2712,55,1,56,27,58
20041,041,20,2020,18373,-18,0,-18,38,50
20041,041,20,2021,18465,166,1,167,193,274
20041,041,20,2022,18355,5,1,6,185,294
20041,041,20,2023,18445,180,0,180,190,278
20043,043,20,2020,7474,-20,0,-20,10,22
20043,043,20,2021,7456,22,0,22,74,118
20043,043,20,2022,7475,51,7,58,78,115
20043,043,20,2023,7493,46,6,52,74,109
20045,045,20,2020,118784,-71,11,-60,241,210
20045,045,20,2021,119493,320,159,479,1010,876
20045,045,20,2022,120007,17,400,417,1052,879
20045,045,20,2023,120553,-55,322,267,1069,796
20047,047,20,2020,2884,-9,0,-9,6,15
20047,047,20,2021,2802,-44,5,-39,31,77
20047,047,20,2022,2760,-30,20,-10,29,59
20047,047,20,2023,2733,-5,6,1,29,59
20049,049,20,2020,2482,4,0,4,2,10
20049,049,20,2021,2439,-16,0,-16,22,49
20049,049,20,2022,2448,41,0,41,19,52
20049,049,20,2023,2467,50,0,50,19,50
20051,051,20,2020,28948,-14,2,-12,79,61
20051,051,20,2021,28850,-113,26,-87,266,296
20051,051,20,2022,28840,-41,20,-21,267,244
20051,051,20,2023,28810,-84,11,-73,269,228
20053,053,20,2020,6369,-9,0,-9,16,21
20053,053,20,2021,6324,2,1,3,59,111
20053,053,20,2022,6383,93,0,93,55,88
20053,053,20,2023,6357,2,0,2,56,84
20055,055,20,2020,38304,-201,2,-199,128,76
20055,055,20,2021,38079,-511,78,-433,553,334
20055,055,20,2022,37639,-867,193,-674,548,343
20055,055,20,2023,37466,-528,113,-415,560,320
20057,057,20,2020,34215,-149,3,-146,147,65
20057,057,20,2021,34186,-400,75,-325,594,298
20057,057,20,2022,33924,-742,161,-581,591,286
20057,057,20,2023,33980,-346,70,-276,602,276
20059,059,20,2020,26000,11,0,11,62,65
20059,059,20,2021,26002,43,4,47,276,341
20059,059,20,2022,25959,24,9,33,286,349
20059,059,20,2023,26125,209,4,213,283,330
20061,061,20,2020,36760,-134,3,-131,204,57
20061,061,20,2021,36116,-1385,20,-1365,1039,264
20061,061,20,2022,35529,-1369,97,-1272,937,282
20061,061,20,2023,35047,-1252,104,-1148,946,271
20063,063,20,2020,2714,-10,0,-10,9,8
20063,063,20,2021,2747,58,0,58,36,58
20063,063,20,2022,2742,6,1,7,33,45
20063,063,20,2023,2735,0,1,1,34,42
20065,065,20,2020,2403,-8,0,-8,5,6
20065,065,20,2021,2400,11,0,11,26,40
20065,065,20,2022,2397,17,0,17,26,43
20065,065,20,2023,2376,-8,0,-8,28,41
20067,067,20,2020,7326,-31,1,-30,17,11
20067,067,20,2021,7333,-44,15,-29,110,74
20067,067,20,2022,7250,-191,49,-142,115,62
20067,067,20,2023,7147,-174,15,-159,116,61
20069,069,20,2020,5647,-16,0,-16,22,12
20069,069,20,2021,5664,1,4,5,83,71
20069,069,20,2022,5711,18,17,35,82,67
20069,069,20,2023,5743,7,6,13,84,64
20071,071,20,2020,1274,-4,0,-4,3,7
20071,071,20,2021,1282,24,0,24,16,30
20071,071,20,2022,1232,-43,0,-43,17,27
20071,071,20,2023,1181,-41,0,-41,17,26
20073,073,20,2020,5977,-25,0,-25,11,24
20073,073,20,2021,5921,2,0,2,42,102
20073,073,20,2022,5908,64,3,67,50,129
20073,073,20,2023,5870,30,3,33,52,122
20075,075,20,2020,2487,-25,0,-25,7,9
20075,075,20,2021,2478,-38,11,-27,38,21
20075,075,20,2022,2452,-72,24,-48,44,27
20075,075,20,2023,2437,-48,16,-32,45,26
20077,077,20,2020,5472,-17,0,-17,20,20
20077,077,20,2021,5355,-83,1,-82,68,101
20077,077,20,2022,5400,50,-1,49,79,81
20077,077,20,2023,5435,35,-1,34,80,79
20079,079,20,2020,33986,-41,2,-39,90,84
20079,079,20,2021,33788,-75,4,-71,361,503
20079,079,20,2022,33671,88,4,92,342,530
20079,079,20,2023,33504,-17,2,-15,348,500
20081,081,20,2020,3760,-21,0,-21,7,5
20081,081,20,2021,3652,-123,3,-120,51,33
20081,081,20,2022,3595,-90,9,-81,58,35
20081,081,20,2023,3630,11,2,13,59,35
20083,083,20,2020,1737,9,0,9,8,0
20083,083,20,2021,1724,10,2,12,13,38
20083,083,20,2022,1697,3,3,6,11,42
20083,083,20,2023,1655,-12,1,-11,11,42
20085,085,20,2020,13239,-2,0,-2,36,29
20085,085,20,2021,13263,11,9,20,160,165
20085,085,20,2022,13292,-8,24,16,179,159
20085,085,20,2023,13368,31,17,48,184,156
20087,087,20,2020,18323,-34,0,-34,41,44
20087,087,20,2021,18429,139,3,142,170,211
20087,087,20,2022,18354,-28,9,-19,163,209
20087,087,20,2023,18327,7,1,8,167,203
20089,089,20,2020,2927,-2,0,-2,10,10
20089,089,20,2021,2942,29,0,29,25,38
20089,089,20,2022,2885,-30,1,-29,32,61
20089,089,20,2023,2847,-9,1,-8,29,59
20091,091,20,2020,611149,306,36,342,1740,1043
20091,091,20,2021,614889,797,496,1293,6874,4911
20091,091,20,2022,619091,1305,1335,2640,6959,5032
20091,091,20,2023,622237,-450,1030,580,6982,4443
20093,093,20,2020,3962,-21,0,-21,11,8
20093,093,20,2021,3897,-88,4,-84,57,35
20093,093,20,2022,3865,-58,3,-55,72,49
20093,093,20,2023,3823,-68,-1,-69,74,48
20095,095,20,2020,7425,-13,0,-13,17,53
20095,095,20,2021,7291,36,0,36,75,249
20095,095,20,2022,7174,86,0,86,78,277
20095,095,20,2023,7066,75,0,75,77,260
20097,097,20,2020,2455,-6,0,-6,7,7
20097,097,20,2021,2409,-36,0,-36,28,36
20097,097,20,2022,2405,-2,9,7,29,38
20097,097,20,2023,2374,-30,7,-23,29,38
20099,099,20,2020,20170,-24,0,-24,65,59
20099,099,20,2021,19914,-177,2,-175,220,303
20099,099,20,2022,19702,-110,7,-103,215,317
20099,099,20,2023,19728,106,4,110,207,290
20101,101,20,2020,1568,-1,0,-1,2,5
20101,101,20,2021,1561,18,0,18,15,40
20101,101,20,2022,1544,-1,0,-1,18,33
20101,101,20,2023,1529,-1,0,-1,18,32
20103,103,20,2020,81966,12,-6,6,213,184
20103,103,20,2021,82398,223,3,226,912,769
20103,103,20,2022,82922,428,58,486,900,818
20103,103,20,2023,83518,411,41,452,896,747
20105,105,20,2020,2949,10,0,10,10,11
20105,105,20,2021,2910,-21,0,-21,22,40
20105,105,20,2022,2911,14,0,14,29,42
20105,105,20,2023,2920,24,0,24,29,42
20107,107,20,2020,9587,-5,0,-5,27,28
20107,107,20,2021,9740,202,0,202,102,145
20107,107,20,2022,9777,118,1,119,89,170
20107,107,20,2023,9860,159,1,160,89,165
20109,109,20,2020,2739,-16,0,-16,9,10
20109,109,20,2021,2710,-26,1,-25,36,42
20109,109,20,2022,2703,5,4,9,37,50
20109,109,20,2023,2665,-26,1,-25,35,49
20111,111,20,2020,32113,-65,4,-61,84,89
20111,111,20,2021,32028,-160,70,-90,346,355
20111,111,20,2022,32031,-204,175,-29,365,330
20111,111,20,2023,32172,-20,105,85,370,314
20113,113,20,2020,30184,-14,0,-14,72,98
20113,113,20,2021,30164,87,6,93,297,433
20113,113,20,2022,30063,13,12,25,324,440
20113,113,20,2023,30091,91,5,96,329,395
20115,115,20,2020,11793,-31,0,-31,30,38
20115,115,20,2021,11750,6,1,7,108,167
20115,115,20,2022,11783,149,2,151,113,228
20115,115,20,2023,11690,4,2,6,115,213
20117,117,20,2020,10023,-10,0,-10,28,31
20117,117,20,2021,10021,12,0,12,115,134
20117,117,20,2022,9992,9,0,9,102,136
20117,117,20,2023,9933,-23,0,-23,97,133
20119,119,20,2020,4061,-1,0,-1,13,13
20119,119,20,2021,3997,-55,2,-53,56,67
20119,119,20,2022,3913,-84,8,-76,49,60
20119,119,20,2023,3911,3,5,8,49,59
20121,121,20,2020,34224,15,0,15,83,73
20121,121,20,2021,34641,457,6,463,347,395
20121,121,20,2022,34791,211,21,232,364,436
20121,121,20,2023,35320,559,11,570,365,405
20123,123,20,2020,5773,-11,0,-11,13,20
20123,123,20,2021,5744,10,0,10,65,107
20123,123,20,2022,5730,21,0,21,69,102
20123,123,20,2023,5719,17,0,17,69,96
20125,125,20,2020,31404,-67,0,-67,85,105
20125,125,20,2021,31181,-78,7,-71,348,518
20125,125,20,2022,30853,-77,9,-68,318,566
20125,125,20,2023,30568,-81,9,-72,304,518
20127,127,20,2020,5369,-12,0,-12,12,20
20127,127,20,2021,5386,47,2,49,54,87
20127,127,20,2022,5400,36,4,40,53,77
20127,127,20,2023,5334,-52,4,-48,53,71
20129,129,20,2020,2700,3,0,3,8,10
20129,129,20,2021,2671,-17,3,-14,28,43
20129,129,20,2022,2601,-72,12,-60,30,43
20129,129,20,2023,2580,-12,5,-7,31,44
20131,131,20,2020,10262,-23,0,-23,40,28
20131,131,20,2021,10226,-12,0,-12,141,173
20131,131,20,2022,10164,-61,1,-60,129,129
20131,131,20,2023,10114,-63,1,-62,130,120
20133,133,20,2020,15905,6,0,6,43,49
20133,133,20,2021,15787,-81,13,-68,184,238
20133,133,20,2022,15583,-146,11,-135,184,252
20133,133,20,2023,15420,-122,10,-112,188,239
20135,135,20,2020,2673,-5,0,-5,6,9
20135,135,20,2021,2651,11,3,14,32,70
20135,135,20,2022,2657,19,7,26,33,53
20135,135,20,2023,2618,-25,5,-20,33,53
20137,137,20,2020,5453,-8,0,-8,16,13
20137,137,20,2021,5369,-58,1,-57,53,80
20137,137,20,2022,5325,-45,5,-40,52,57
20137,137,20,2023,5330,5,4,9,48,53
20139,139,20,2020,15741,-15,0,-15,47,58
20139,139,20,2021,15752,111,0,111,164,271
20139,139,20,2022,15705,35,0,35,163,240
20139,139,20,2023,15824,192,0,192,163,232
20141,141,20,2020,3490,1,0,1,12,17
20141,141,20,2021,3485,9,0,9,40,53
20141,141,20,2022,3481,25,0,25,36,62
20141,141,20,2023,3427,-34,0,-34,36,57
20143,143,20,2020,5729,4,0,4,11,15
20143,143,20,2021,5830,136,0,136,51,82
20143,143,20,2022,5806,-9,0,-9,63,77
20143,143,20,2023,5818,21,0,21,66,74
20145,145,20,2020,6256,3,0,3,13,16
20145,145,20,2021,6247,17,0,17,70,98
20145,145,20,2022,6188,-34,0,-34,63,87
20145,145,20,2023,6126,-39,0,-39,63,86
20147,147,20,2020,4961,-12,0,-12,18,17
20147,147,20,2021,4819,-99,0,-99,46,86
20147,147,20,2022,4783,-7,1,-6,55,81
20147,147,20,2023,4761,-1,1,0,54,76
20149,149,20,2020,25411,25,0,25,85,50
20149,149,20,2021,25873,296,2,298,371,216
20149,149,20,2022,26292,271,15,286,376,229
20149,149,20,2023,26382,-82,13,-69,375,217
20151,151,20,2020,9143,-1,0,-1,26,36
20151,151,20,2021,9168,71,2,73,93,144
20151,151,20,2022,9073,-79,2,-77,112,132
20151,151,20,2023,9082,22,1,23,115,128
20153,153,20,2020,2572,1,0,1,8,3
20153,153,20,2021,2558,2,0,2,24,41
20153,153,20,2022,2523,-22,1,-21,24,39
20153,153,20,2023,2463,-40,0,-40,20,39
20155,155,20,2020,61878,-6,0,-6,170,182
20155,155,20,2021,61499,-164,7,-157,623,883
20155,155,20,2022,61552,263,30,293,656,855
20155,155,20,2023,61497,41,19,60,662,777
20157,157,20,2020,4664,-1,0,-1,12,16
20157,157,20,2021,4688,43,0,43,64,84
20157,157,20,2022,4653,0,1,1,58,90
20157,157,20,2023,4627,5,1,6,56,88
20159,159,20,2020,9389,-36,0,-36,26,25
20159,159,20,2021,9389,39,4,43,100,146
20159,159,20,2022,9370,23,10,33,104,151
20159,159,20,2023,9260,-80,7,-73,105,142
20161,161,20,2020,72016,-68,13,-55,174,103
20161,161,20,2021,71871,-550,83,-467,699,409
20161,161,20,2022,71563,-896,312,-584,730,444
20161,161,20,2023,71402,-800,308,-492,744,421
20163,163,20,2020,4893,-19,0,-19,14,18
20163,163,20,2021,4865,-7,0,-7,47,71
20163,163,20,2022,4810,-35,1,-34,53,75
20163,163,20,2023,4778,-16,1,-15,56,73
20165,165,20,2020,2938,-8,0,-8,8,12
20165,165,20,2021,2928,29,0,29,27,68
20165,165,20,2022,2941,47,1,48,28,63
20165,165,20,2023,2830,-84,1,-83,28,56
20167,167,20,2020,6678,-9,0,-9,18,23
20167,167,20,2021,6697,94,1,95,59,133
20167,167,20,2022,6733,51,4,55,66,87
20167,167,20,2023,6723,3,4,7,67,83
20169,169,20,2020,54254,-69,0,-69,151,133
20169,169,20,2021,53827,-345,28,-317,576,703
20169,169,20,2022,53389,-329,77,-252,594,766
20169,169,20,2023,53098,-272,63,-209,606,689
20171,171,20,2020,5139,-15,0,-15,9,7
20171,171,20,2021,5121,-18,-1,-19,80,81
20171,171,20,2022,5007,-104,-4,-108,70,76
20171,171,20,2023,4922,-82,-4,-86,72,72
20173,173,20,2020,524821,298,39,337,1713,1244
20173,173,20,2021,524423,-1642,395,-1247,6333,5781
20173,173,20,2022,525368,-455,1028,573,6536,5867
20173,173,20,2023,528469,889,682,1571,6615,5110
20175,175,20,2020,21857,-152,1,-151,90,30
20175,175,20,2021,21763,-310,24,-286,370,171
20175,175,20,2022,21345,-680,19,-661,385,169
20175,175,20,2023,21067,-504,-3,-507,393,164
20177,177,20,2020,178709,-198,1,-197,473,493
20177,177,20,2021,178403,-146,45,-101,1913,2252
20177,177,20,2022,177537,-609,88,-521,1967,2258
20177,177,20,2023,177746,156,54,210,1990,1994
20179,179,20,2020,2445,0,0,0,9,7
20179,179,20,2021,2451,28,0,28,30,53
20179,179,20,2022,2439,3,0,3,28,42
20179,179,20,2023,2423,-2,0,-2,28,41
20181,181,20,2020,5897,-29,0,-29,11,8
20181,181,20,2021,5932,20,0,20,84,71
20181,181,20,2022,5876,-67,-4,-71,75,63
20181,181,20,2023,5844,-49,-4,-53,81,62
20183,183,20,2020,3567,-1,0,-1,3,9
20183,183,20,2021,3573,37,1,38,23,55
20183,183,20,2022,3572,20,1,21,39,58
20183,183,20,2023,3590,27,0,27,42,52
20185,185,20,2020,4049,-3,0,-3,8,21
20185,185,20,2021,4008,-28,-1,-29,56,69
20185,185,20,2022,3971,5,-1,4,44,83
20185,185,20,2023,3909,-22,-2,-24,44,81
20187,187,20,2020,2084,-3,0,-3,7,4
20187,187,20,2021,2045,-36,0,-36,18,20
20187,187,20,2022,1967,-74,-3,-77,15,19
20187,187,20,2023,1901,-58,-3,-61,15,19
20189,189,20,2020,5243,-12,0,-12,20,13
20189,189,20,2021,5302,39,1,40,69,52
20189,189,20,2022,5166,-146,-4,-150,62,54
20189,189,20,2023,5077,-96,-4,-100,65,55
20191,191,20,2020,22328,-41,0,-41,60,65
20191,191,20,2021,22327,103,-1,102,226,343
20191,191,20,2022,22359,157,-3,154,218,334
20191,191,20,2023,22334,69,-3,66,220,309
20193,193,20,2020,7932,-9,0,-9,27,17
20193,193,20,2021,7948,-36,10,-26,113,73
20193,193,20,2022,7908,-110,24,-86,118,74
20193,193,20,2023,7865,-98,7,-91,120,72
20195,195,20,2020,2803,-1,0,-1,8,9
20195,195,20,2021,2788,2,1,3,34,52
20195,195,20,2022,2746,-25,2,-23,28,46
20195,195,20,2023,2731,-1,2,1,28,43
20197,197,20,2020,6891,2,0,2,22,11
20197,197,20,2021,6970,81,2,83,81,85
20197,197,20,2022,7009,47,3,50,86,94
20197,197,20,2023,7057,47,3,50,88,89
20199,199,20,2020,1512,-1,0,-1,5,4
20199,199,20,2021,1513,-5,0,-5,24,18
20199,199,20,2022,1493,-25,0,-25,25,19
20199,199,20,2023,1509,7,0,7,28,19
20201,201,20,2020,5530,0,0,0,16,15
20201,201,20,2021,5525,-4,6,2,76,86
20201,201,20,2022,5493,-25,9,-16,73,87
20201,201,20,2023,5504,21,2,23,67,79
20203,203,20,2020,2149,-8,0,-8,10,3
20203,203,20,2021,2080,-67,3,-64,40,43
20203,203,20,2022,2078,-24,10,-14,40,30
20203,203,20,2023,2082,-11,4,-7,40,30
20205,205,20,2020,8582,-38,0,-38,24,29
20205,205,20,2021,8520,-11,0,-11,91,143
20205,205,20,2022,8554,117,0,117,76,160
20205,205,20,2023,8382,-96,0,-96,76,152
20207,207,20,2020,3099,-12,0,-12,7,18
20207,207,20,2021,3084,19,0,19,26,60
20207,207,20,2022,3117,65,0,65,25,58
20207,207,20,2023,3115,27,0,27,25,54
20209,209,20,2020,168914,-483,21,-462,587,449
20209,209,20,2021,167262,-2654,333,-2321,2380,1678
20209,209,20,2022,165626,-3238,969,-2269,2278,1706
20209,209,20,2023,165281,-1754,689,-1065,2287,1552
21001,001,21,2020,18883,15,0,15,50,92
21001,001,21,2021,18966,157,4,161,189,271
21001,001,21,2022,19097,201,13,214,198,278
21001,001,21,2023,19264,217,18,235,197,265
21003,003,21,2020,20574,1,0,1,57,70
21003,003,21,2021,20839,280,-1,279,257,268
21003,003,21,2022,21283,464,-5,459,266,299
21003,003,21,2023,21788,519,-5,514,268,277
21005,005,21,2020,23883,29,0,29,57,71
21005,005,21,2021,24084,210,1,211,264,283
21005,005,21,2022,24273,229,4,233,251,295
21005,005,21,2023,24613,353,7,360,249,270
21007,007,21,2020,7713,-3,0,-3,8,24
21007,007,21,2021,7687,15,0,15,74,120
21007,007,21,2022,7642,33,-1,32,59,135
21007,007,21,2023,7582,11,-1,10,59,128
21009,009,21,2020,44505,33,0,33,108,128
21009,009,21,2021,44598,213,8,221,467,623
21009,009,21,2022,44872,413,7,420,527,668
21009,009,21,2023,45008,159,23,182,548,594
21011,011,21,2020,12716,-17,0,-17,39,56
21011,011,21,2021,12795,92,0,92,173,188
21011,011,21,2022,12828,92,-1,91,175,227
21011,011,21,2023,12975,185,0,185,175,213
21013,013,21,2020,23984,-87,0,-87,62,86
21013,013,21,2021,23834,-4,0,-4,313,470
21013,013,21,2022,23611,40,-2,38,289,541
21013,013,21,2023,23317,-123,-2,-125,289,459
21015,015,21,2020,136468,291,6,297,414,264
21015,015,21,2021,137747,551,88,639,1646,1098
21015,015,21,2022,139045,631,229,860,1746,1225
21015,015,21,2023,140496,428,375,803,1723,1075
21017,017,21,2020,20286,50,0,50,43,57
21017,017,21,2021,20224,19,4,23,186,285
21017,017,21,2022,20109,-13,6,-7,213,314
21017,017,21,2023,20134,83,20,103,208,286
21019,019,21,2020,48206,9,0,9,108,178
21019,019,21,2021,47757,-197,-1,-198,522,794
21019,019,21,2022,48059,597,-1,596,525,834
21019,019,21,2023,47826,24,4,28,477,739
21021,021,21,2020,30753,145,0,145,72,76
21021,021,21,2021,30604,-11,9,-2,285,446
21021,021,21,2022,30851,361,11,372,309,437
21021,021,21,2023,30988,188,20,208,311,385
21023,023,21,2020,8400,-9,0,-9,25,18
21023,023,21,2021,8440,63,0,63,95,122
21023,023,21,2022,8435,36,2,38,91,129
21023,023,21,2023,8426,8,5,13,94,115
21025,025,21,2020,13693,-3,0,-3,31,52
21025,025,21,2021,13546,-76,0,-76,163,240
21025,025,21,2022,13358,-57,1,-56,140,269
21025,025,21,2023,12953,-311,1,-310,143,235
21027,027,21,2020,20447,14,0,14,58,65
21027,027,21,2021,20687,273,1,274,274,306
21027,027,21,2022,20961,372,2,374,246,352
21027,027,21,2023,21124,224,2,226,254,318
21029,029,21,2020,82366,90,0,90,211,192
21029,029,21,2021,83073,722,13,735,791,847
21029,029,21,2022,83774,801,58,859,769,908
21029,029,21,2023,84863,1029,103,1132,771,810
21031,031,21,2020,12316,-33,0,-33,29,49
21031,031,21,2021,12302,23,5,28,152,201
21031,031,21,2022,12365,84,18,102,149,184
21031,031,21,2023,12375,1,24,25,151,166
21033,033,21,2020,12635,0,0,0,27,43
21033,033,21,2021,12678,55,0,55,165,184
21033,033,21,2022,12608,-16,-7,-23,160,201
21033,033,21,2023,12551,-36,-7,-43,167,182
21035,035,21,2020,37596,75,0,75,78,107
21035,035,21,2021,37896,457,11,468,336,513
21035,035,21,2022,38093,351,20,371,360,522
21035,035,21,2023,38280,261,47,308,356,477
21037,037,21,2020,93127,7,0,7,247,227
21037,037,21,2021,92828,-379,19,-360,1003,998
21037,037,21,2022,93272,416,23,439,995,976
21037,037,21,2023,93702,271,43,314,967,857
21039,039,21,2020,4807,-4,0,-4,14,25
21039,039,21,2021,4761,-10,0,-10,57,96
21039,039,21,2022,4719,7,0,7,58,105
21039,039,21,2023,4704,21,1,22,59,96
21041,041,21,2020,10825,19,0,19,42,35
21041,041,21,2021,10896,32,0,32,169,136
21041,041,21,2022,10939,52,0,52,155,161
21041,041,21,2023,10987,37,0,37,162,150
21043,043,21,2020,26609,-24,0,-24,72,68
21043,043,21,2021,26430,-66,0,-66,264,390
21043,043,21,2022,26343,106,0,106,284,468
21043,043,21,2023,26366,194,0,194,272,441
21045,045,21,2020,15918,-22,0,-22,52,51
21045,045,21,2021,15940,98,0,98,166,248
21045,045,21,2022,15911,54,-1,53,181,255
21045,045,21,2023,15918,62,0,62,180,236
21047,047,21,2020,72762,-237,3,-234,355,180
21047,047,21,2021,73180,-198,0,-198,1431,833
21047,047,21,2022,72286,-1659,13,-1646,1535,844
21047,047,21,2023,72032,-863,83,-780,1295,771
21049,049,21,2020,37035,50,1,51,99,113
21049,049,21,2021,36895,-84,7,-77,411,501
21049,049,21,2022,36992,226,4,230,408,540
21049,049,21,2023,37304,389,6,395,410,492
21051,051,21,2020,20312,-22,0,-22,58,66
21051,051,21,2021,20161,-27,0,-27,208,347
21051,051,21,2022,19874,-132,-2,-134,233,382
21051,051,21,2023,19648,-121,5,-116,232,344
21053,053,21,2020,9232,-14,0,-14,30,38
21053,053,21,2021,9282,112,3,115,111,176
21053,053,21,2022,9139,-117,7,-110,122,157
21053,053,21,2023,9148,46,10,56,107,155
21055,055,21,2020,9003,17,0,17,28,32
21055,055,21,2021,8944,-17,1,-16,90,138
21055,055,21,2022,8991,99,3,102,100,155
21055,055,21,2023,8974,23,4,27,102,146
21057,057,21,2020,5856,-13,0,-13,15,30
21057,057,21,2021,5900,76,1,77,77,112
21057,057,21,2022,5969,103,1,104,76,115
21057,057,21,2023,6000,69,1,70,74,110
21059,059,21,2020,103405,47,0,47,274,276
21059,059,21,2021,103089,-287,28,-259,1196,1317
21059,059,21,2022,103189,148,81,229,1282,1348
21059,059,21,2023,103458,-26,143,117,1308,1161
21061,061,21,2020,12152,39,0,39,26,45
21061,061,21,2021,12237,147,1,148,111,175
21061,061,21,2022,12302,141,0,141,110,190
21061,061,21,2023,12448,218,0,218,108,180
21063,063,21,2020,7334,-10,0,-10,12,20
21063,063,21,2021,7361,83,0,83,45,102
21063,063,21,2022,7292,-17,0,-17,52,97
21063,063,21,2023,7245,-4,0,-4,52,97
21065,065,21,2020,14161,6,0,6,38,50
21065,065,21,2021,14086,23,3,26,122,234
21065,065,21,2022,14024,76,6,82,125,267
21065,065,21,2023,13936,15,8,23,126,237
21067,067,21,2020,322627,-234,24,-210,883,714
21067,067,21,2021,320519,-3226,339,-2887,3643,2896
21067,067,21,2022,320281,-1621,860,-761,3674,3013
21067,067,21,2023,320154,-2644,1414,-1230,3696,2594
21069,069,21,2020,15101,5,0,5,49,44
21069,069,21,2021,15265,183,-1,182,200,217
21069,069,21,2022,15278,34,-2,32,204,220
21069,069,21,2023,15442,168,-2,166,205,208
21071,071,21,2020,35798,-77,0,-77,99,158
21071,071,21,2021,35304,-212,-2,-214,373,668
21071,071,21,2022,34918,10,-1,9,358,732
21071,071,21,2023,34423,-213,5,-208,367,655
21073,073,21,2020,51594,61,0,61,143,161
21073,073,21,2021,51714,214,25,239,507,658
21073,073,21,2022,51548,76,64,140,513,785
21073,073,21,2023,51644,191,91,282,512,697
21075,075,21,2020,6511,2,0,2,15,21
21075,075,21,2021,6487,52,0,52,67,143
21075,075,21,2022,6371,-66,-1,-67,74,123
21075,075,21,2023,6338,16,-1,15,73,121
21077,077,21,2020,8673,-17,0,-17,29,32
21077,077,21,2021,8763,113,0,113,99,120
21077,077,21,2022,8773,18,3,21,111,121
21077,077,21,2023,8792,16,4,20,112,113
21079,079,21,2020,16963,13,0,13,44,45
21079,079,21,2021,17366,505,11,516,152,248
21079,079,21,2022,17566,258,16,274,173,245
21079,079,21,2023,17829,300,24,324,175,234
21081,081,21,2020,25015,47,0,47,98,81
21081,081,21,2021,25292,229,0,229,331,288
21081,081,21,2022,25474,150,1,151,365,328
21081,081,21,2023,25619,87,1,88,361,305
21083,083,21,2020,36528,-80,1,-79,93,139
21083,083,21,2021,36673,227,1,228,451,551
21083,083,21,2022,36493,-61,7,-54,467,572
21083,083,21,2023,36461,-28,37,9,465,507
21085,085,21,2020,26460,14,0,14,87,71
21085,085,21,2021,26583,198,1,199,337,417
21085,085,21,2022,26643,148,0,148,373,451
21085,085,21,2023,26825,213,0,213,376,409
21087,087,21,2020,11132,25,0,25,26,31
21087,087,21,2021,11325,247,0,247,119,166
21087,087,21,2022,11392,119,0,119,115,171
21087,087,21,2023,11468,122,0,122,117,164
21089,089,21,2020,35877,-27,0,-27,80,138
21089,089,21,2021,35643,25,0,25,298,580
21089,089,21,2022,35375,27,-4,23,325,594
21089,089,21,2023,35221,77,-2,75,301,529
21091,091,21,2020,9101,7,0,7,19,20
21091,091,21,2021,9073,6,0,6,86,127
21091,091,21,2022,9027,-18,0,-18,93,118
21091,091,21,2023,8920,-90,0,-90,95,111
21093,093,21,2020,110829,-5,2,-3,353,261
21093,093,21,2021,111878,794,25,819,1455,1284
21093,093,21,2022,111743,-72,73,1,1340,1427
21093,093,21,2023,112273,229,143,372,1369,1208
21095,095,21,2020,26754,-56,0,-56,85,108
21095,095,21,2021,26150,-288,1,-287,286,602
21095,095,21,2022,25652,-214,-1,-215,284,570
21095,095,21,2023,25324,-100,0,-100,282,510
21097,097,21,2020,18719,26,0,26,48,51
21097,097,21,2021,18957,306,0,306,220,284
21097,097,21,2022,19105,198,0,198,253,303
21097,097,21,2023,19415,342,0,342,255,286
21099,099,21,2020,19290,-10,0,-10,62,49
21099,099,21,2021,19477,219,1,220,249,284
21099,099,21,2022,19594,151,0,151,249,274
21099,099,21,2023,19724,130,0,130,257,257
21101,101,21,2020,44678,-98,0,-98,119,139
21101,101,21,2021,44418,-137,4,-133,488,636
21101,101,21,2022,44032,-202,6,-196,476,652
21101,101,21,2023,44119,142,16,158,514,584
21103,103,21,2020,15698,9,0,9,50,47
21103,103,21,2021,15708,11,1,12,192,202
21103,103,21,2022,15760,95,2,97,196,233
21103,103,21,2023,15973,231,4,235,198,219
21105,105,21,2020,4529,10,0,10,7,10
21105,105,21,2021,4426,-46,0,-46,33,89
21105,105,21,2022,4434,40,1,41,45,78
21105,105,21,2023,4447,51,1,52,41,78
21107,107,21,2020,45369,19,0,19,103,187
21107,107,21,2021,45189,-54,7,-47,526,686
21107,107,21,2022,44926,-9,10,1,511,751
21107,107,21,2023,44929,75,55,130,524,651
21109,109,21,2020,12963,11,0,11,40,48
21109,109,21,2021,12980,87,0,87,138,213
21109,109,21,2022,12989,72,-1,71,156,212
21109,109,21,2023,13104,148,-1,147,161,193
21111,111,21,2020,782845,-523,72,-451,2340,2263
21111,111,21,2021,777251,-5977,796,-5181,9214,9834
21111,111,21,2022,773095,-5357,2087,-3270,9390,10041
21111,111,21,2023,772144,-5371,3247,-2124,9534,8371
21113,113,21,2020,53024,-4,0,-4,153,125
21113,113,21,2021,53603,536,14,550,594,581
21113,113,21,2022,54236,592,45,637,615,615
21113,113,21,2023,55017,608,95,703,618,542
21115,115,21,2020,22648,-15,0,-15,58,75
21115,115,21,2021,22548,52,1,53,229,397
21115,115,21,2022,22235,-111,4,-107,235,436
21115,115,21,2023,22116,22,5,27,231,378
21117,117,21,2020,169271,24,4,28,561,403
21117,117,21,2021,169698,-206,61,-145,2121,1673
21117,117,21,2022,170280,53,146,199,2198,1733
21117,117,21,2023,171321,129,234,363,2158,1486
21119,119,21,2020,14158,-45,0,-45,25,63
21119,119,21,2021,14032,-18,1,-17,124,240
21119,119,21,2022,13847,-12,4,-8,107,277
21119,119,21,2023,13659,-45,5,-40,108,254
21121,121,21,2020,30185,-6,0,-6,103,117
21121,121,21,2021,30025,-76,2,-74,359,465
21121,121,21,2022,29773,-84,5,-79,385,549
21121,121,21,2023,29794,129,11,140,377,497
21123,123,21,2020,14873,15,0,15,40,47
21123,123,21,2021,15027,190,1,191,161,199
21123,123,21,2022,15150,187,-1,186,157,225
21123,123,21,2023,15303,200,-1,199,158,203
21125,125,21,2020,62727,124,0,124,181,193
21125,125,21,2021,62580,37,4,41,676,913
21125,125,21,2022,62879,518,12,530,698,919
21125,125,21,2023,63296,499,16,515,705,803
21127,127,21,2020,16303,14,0,14,40,46
21127,127,21,2021,16284,41,0,41,171,240
21127,127,21,2022,16097,-62,-1,-63,162,283
21127,127,21,2023,16000,23,6,29,142,266
21129,129,21,2020,7368,-14,0,-14,18,29
21129,129,21,2021,7462,170,2,172,71,145
21129,129,21,2022,7273,-111,0,-111,65,142
21129,129,21,2023,7293,88,0,88,65,133
21131,131,21,2020,10468,-37,0,-37,27,32
21131,131,21,2021,10280,-106,0,-106,103,187
21131,131,21,2022,10049,-122,0,-122,96,208
21131,131,21,2023,9864,-80,0,-80,95,199
21133,133,21,2020,21465,-51,0,-51,48,81
21133,133,21,2021,21224,-37,0,-37,198,416
21133,133,21,2022,20827,-130,0,-130,180,444
21133,133,21,2023,20423,-174,0,-174,179,409
21135,135,21,2020,13087,-8,0,-8,41,30
21135,135,21,2021,12991,-32,1,-31,169,238
21135,135,21,2022,12937,11,0,11,168,228
21135,135,21,2023,12973,88,0,88,161,211
21137,137,21,2020,24255,-12,0,-12,68,89
21137,137,21,2021,24295,80,0,80,327,383
21137,137,21,2022,24419,252,-1,251,312,436
21137,137,21,2023,24776,428,-1,427,312,382
21139,139,21,2020,8871,-12,0,-12,23,29
21139,139,21,2021,8980,211,0,211,93,187
21139,139,21,2022,8968,69,0,69,95,179
21139,139,21,2023,8892,-7,0,-7,94,163
21141,141,21,2020,27513,71,0,71,109,98
21141,141,21,2021,27804,293,7,300,361,377
21141,141,21,2022,27856,79,5,84,380,399
21141,141,21,2023,28283,421,8,429,368,370
21143,143,21,2020,8679,7,0,7,14,28
21143,143,21,2021,8435,-142,-1,-143,51,142
21143,143,21,2022,9099,689,-2,687,53,143
21143,143,21,2023,9187,159,14,173,53,137
21145,145,21,2020,67917,42,0,42,167,183
21145,145,21,2021,67546,-81,2,-79,670,1004
21145,145,21,2022,67366,208,4,212,696,1056
21145,145,21,2023,67428,283,15,298,696,933
21147,147,21,2020,16840,-34,0,-34,39,49
21147,147,21,2021,16804,8,1,9,208,264
21147,147,21,2022,16783,90,4,94,181,294
21147,147,21,2023,17050,359,5,364,180,279
21149,149,21,2020,9136,-13,0,-13,21,25
21149,149,21,2021,9122,40,0,40,103,162
21149,149,21,2022,9107,42,-1,41,92,143
21149,149,21,2023,9054,-10,-1,-11,94,137
21151,151,21,2020,92993,277,0,277,248,239
21151,151,21,2021,93474,432,13,445,1025,1040
21151,151,21,2022,95151,1624,25,1649,1057,1089
21151,151,21,2023,96735,1407,63,1470,1058,942
21153,153,21,2020,11603,-25,0,-25,34,43
21153,153,21,2021,11489,-65,2,-63,132,188
21153,153,21,2022,11348,-48,-2,-50,131,220
21153,153,21,2023,11228,-39,-1,-40,130,211
21155,155,21,2020,19592,17,0,17,51,59
21155,155,21,2021,19739,202,2,204,198,260
21155,155,21,2022,19748,67,3,70,212,262
21155,155,21,2023,19834,111,7,118,212,244
21157,157,21,2020,31691,70,0,70,64,106
21157,157,21,2021,31829,325,0,325,308,499
21157,157,21,2022,31790,175,-2,173,304,506
21157,157,21,2023,31744,102,-2,100,304,450
21159,159,21,2020,11253,-29,0,-29,27,36
21159,159,21,2021,11165,-40,0,-40,129,179
21159,159,21,2022,11096,13,-1,12,104,181
21159,159,21,2023,10928,-100,-1,-101,100,167
21161,161,21,2020,17133,2,0,2,48,43
21161,161,21,2021,16960,-126,5,-121,200,255
21161,161,21,2022,16903,27,8,35,187,272
21161,161,21,2023,16841,-6,9,3,186,251
21163,163,21,2020,30026,8,0,8,73,68
21163,163,21,2021,30119,164,2,166,255,346
21163,163,21,2022,30010,-35,10,-25,260,327
21163,163,21,2023,30131,141,19,160,267,307
21165,165,21,2020,6146,27,0,27,26,19
21165,165,21,2021,6185,96,0,96,66,121
21165,165,21,2022,6236,85,-1,84,72,108
21165,165,21,2023,6286,87,-1,86,72,107
21167,167,21,2020,22655,9,0,9,53,57
21167,167,21,2021,22860,327,-2,325,231,352
21167,167,21,2022,22900,147,-3,144,251,356
21167,167,21,2023,23097,277,-1,276,254,333
21169,169,21,2020,10288,7,0,7,26,38
21169,169,21,2021,10391,144,0,144,106,148
21169,169,21,2022,10408,71,-3,68,116,164
21169,169,21,2023,10482,99,13,112,119,156
21171,171,21,2020,11319,-14,0,-14,27,28
21171,171,21,2021,11260,-14,0,-14,137,190
21171,171,21,2022,11353,135,-1,134,150,189
21171,171,21,2023,11306,-12,-1,-13,147,182
21173,173,21,2020,28112,-5,0,-5,78,78
21173,173,21,2021,28230,174,-1,173,329,398
21173,173,21,2022,28357,227,-5,222,328,419
21173,173,21,2023,28527,212,6,218,326,373
21175,175,21,2020,13735,10,0,10,31,37
21175,175,21,2021,13689,-11,2,-9,138,182
21175,175,21,2022,14146,461,20,481,131,188
21175,175,21,2023,14283,160,26,186,130,176
21177,177,21,2020,30894,-27,0,-27,71,88
21177,177,21,2021,30323,-424,1,-423,336,468
21177,177,21,2022,30696,501,2,503,327,490
21177,177,21,2023,30568,-22,3,-19,339,448
21179,179,21,2020,46779,38,0,38,110,109
21179,179,21,2021,47127,382,7,389,546,603
21179,179,21,2022,47359,275,18,293,550,605
21179,179,21,2023,47730,318,40,358,553,542
21181,181,21,2020,7541,5,0,5,23,20
21181,181,21,2021,7733,224,0,224,77,103
21181,181,21,2022,7786,74,0,74,98,119
21181,181,21,2023,7686,-82,0,-82,99,117
21183,183,21,2020,23747,-27,0,-27,66,66
21183,183,21,2021,23744,41,2,43,270,334
21183,183,21,2022,23496,-118,12,-106,251,384
21183,183,21,2023,23626,151,70,221,256,346
21185,185,21,2020,67693,60,0,60,125,112
21185,185,21,2021,68238,481,9,490,522,483
21185,185,21,2022,69444,1137,32,1169,537,511
21185,185,21,2023,70183,600,79,679,546,473
21187,187,21,2020,11301,45,0,45,20,30
21187,187,21,2021,11298,68,1,69,97,171
21187,187,21,2022,11294,54,1,55,108,163
21187,187,21,2023,11313,59,2,61,109,151
21189,189,21,2020,4032,-11,0,-11,12,21
21189,189,21,2021,3974,-12,0,-12,50,97
21189,189,21,2022,3958,18,0,18,54,85
21189,189,21,2023,4001,73,0,73,55,85
21191,191,21,2020,14648,6,0,6,35,44
21191,191,21,2021,14635,-8,1,-7,170,185
21191,191,21,2022,14703,101,2,103,163,199
21191,191,21,2023,14810,122,2,124,166,183
21193,193,21,2020,28367,-47,0,-47,70,127
21193,193,21,2021,27927,-223,5,-218,330,558
21193,193,21,2022,27367,-282,3,-279,307,588
21193,193,21,2023,27133,-40,6,-34,312,511
21195,195,21,2020,58441,-123,0,-123,124,221
21195,195,21,2021,57416,-547,-1,-548,549,1031
21195,195,21,2022,56317,-537,4,-533,534,1109
21195,195,21,2023,55973,43,13,56,536,937
21197,197,21,2020,13093,-19,0,-19,36,53
21197,197,21,2021,13086,50,1,51,145,210
21197,197,21,2022,13041,30,-1,29,159,225
21197,197,21,2023,12972,-19,-1,-20,166,214
21199,199,21,2020,65116,107,0,107,171,210
21199,199,21,2021,65571,757,6,763,687,1001
21199,199,21,2022,65767,566,13,579,694,1070
21199,199,21,2023,66191,629,23,652,691,917
21201,201,21,2020,2184,-1,0,-1,3,12
21201,201,21,2021,2257,100,0,100,18,41
21201,201,21,2022,2247,9,0,9,20,39
21201,201,21,2023,2313,83,2,85,20,38
21203,203,21,2020,16059,31,0,31,34,44
21203,203,21,2021,16134,191,0,191,160,277
21203,203,21,2022,16225,235,0,235,162,306
21203,203,21,2023,16190,85,0,85,162,282
21205,205,21,2020,24722,68,0,68,56,61
21205,205,21,2021,24569,-117,0,-117,260,305
21205,205,21,2022,24372,-143,-4,-147,265,317
21205,205,21,2023,24409,25,31,56,272,291
21207,207,21,2020,18002,27,0,27,49,73
21207,207,21,2021,18172,305,7,312,167,304
21207,207,21,2022,18185,103,9,112,211,307
21207,207,21,2023,18279,143,15,158,211,274
21209,209,21,2020,57531,323,0,323,171,104
21209,209,21,2021,58316,610,6,616,681,525
21209,209,21,2022,59077,627,5,632,699,560
21209,209,21,2023,60168,848,36,884,699,491
21211,211,21,2020,48244,116,1,117,133,112
21211,211,21,2021,48588,224,31,255,530,469
21211,211,21,2022,48842,181,57,238,562,530
21211,211,21,2023,49515,509,87,596,568,492
21213,213,21,2020,19633,24,0,24,62,59
21213,213,21,2021,19734,125,1,126,228,261
21213,213,21,2022,19948,270,-8,262,215,271
21213,213,21,2023,20195,303,-8,295,211,256
21215,215,21,2020,19511,77,0,77,38,37
21215,215,21,2021,19887,399,2,401,185,205
21215,215,21,2022,20212,320,10,330,201,202
21215,215,21,2023,20531,295,11,306,201,186
21217,217,21,2020,26000,0,0,0,74,100
21217,217,21,2021,26187,234,9,243,322,385
21217,217,21,2022,26396,323,9,332,323,451
21217,217,21,2023,26443,110,15,125,324,402
21219,219,21,2020,12288,25,0,25,41,30
21219,219,21,2021,12301,12,-2,10,171,175
21219,219,21,2022,12394,87,6,93,186,183
21219,219,21,2023,12494,72,19,91,175,167
21221,221,21,2020,14078,36,0,36,35,47
21221,221,21,2021,14220,207,1,208,158,218
21221,221,21,2022,14348,218,0,218,158,248
21221,221,21,2023,14369,85,0,85,158,221
21223,223,21,2020,8460,-5,0,-5,23,27
21223,223,21,2021,8549,124,-1,123,87,119
21223,223,21,2022,8527,41,-1,40,81,139
21223,223,21,2023,8607,121,4,125,87,132
21225,225,21,2020,13652,-20,0,-20,36,35
21225,225,21,2021,13254,-325,-1,-326,152,205
21225,225,21,2022,13104,-68,0,-68,148,224
21225,225,21,2023,13106,39,1,40,164,203
21227,227,21,2020,135028,338,8,346,406,308
21227,227,21,2021,137225,1562,128,1690,1778,1292
21227,227,21,2022,140046,1933,379,2312,1854,1371
21227,227,21,2023,142229,909,572,1481,1898,1207
21229,229,21,2020,12043,9,0,9,31,29
21229,229,21,2021,12080,94,-1,93,123,185
21229,229,21,2022,12060,21,1,22,133,170
21229,229,21,2023,12267,226,11,237,133,162
21231,231,21,2020,19539,-6,0,-6,50,64
21231,231,21,2021,19535,109,1,110,221,343
21231,231,21,2022,19634,216,0,216,210,325
21231,231,21,2023,19580,17,7,24,209,287
21233,233,21,2020,13018,-11,0,-11,40,28
21233,233,21,2021,12852,-106,2,-104,155,218
21233,233,21,2022,12739,-78,13,-65,163,209
21233,233,21,2023,12726,-14,20,6,172,190
21235,235,21,2020,36698,-17,0,-17,123,131
21235,235,21,2021,36761,68,7,75,545,570
21235,235,21,2022,36908,254,3,257,543,653
21235,235,21,2023,36825,-55,9,-46,544,583
21237,237,21,2020,6559,2,0,2,19,26
21237,237,21,2021,6507,-5,0,-5,83,133
21237,237,21,2022,6416,-16,1,-15,86,160
21237,237,21,2023,6282,-74,1,-73,88,148
21239,239,21,2020,26904,26,0,26,59,62
21239,239,21,2021,27082,227,2,229,241,301
21239,239,21,2022,27053,43,-10,33,270,315
21239,239,21,2023,27268,204,36,240,273,297
22001,001,22,2020,57478,-72,0,-72,176,204
22001,001,22,2021,57217,-159,-2,-161,804,940
22001,001,22,2022,56725,-427,-7,-434,834,887
22001,001,22,2023,56489,-262,-7,-269,834,806
22003,003,22,2020,22687,-41,0,-41,52,81
22003,003,22,2021,22588,-34,15,-19,269,364
22003,003,22,2022,22287,-251,52,-199,236,341
22003,003,22,2023,22112,-120,38,-82,237,330
22005,005,22,2020,126978,309,5,314,404,266
22005,005,22,2021,128571,803,28,831,1678,983
22005,005,22,2022,130485,1250,61,1311,1658,1028
22005,005,22,2023,131632,346,75,421,1631,906
22007,007,22,2020,20963,-62,0,-62,68,85
22007,007,22,2021,20696,-211,3,-208,208,269
22007,007,22,2022,20463,-109,1,-108,210,326
22007,007,22,2023,20160,-205,1,-204,210,310
22009,009,22,2020,39646,-39,0,-39,129,141
22009,009,22,2021,39261,-255,2,-253,474,621
22009,009,22,2022,38715,-400,24,-376,464,631
22009,009,22,2023,38408,-205,29,-176,442,578
22011,011,22,2020,36605,38,0,38,108,106
22011,011,22,2021,36668,-11,7,-4,528,483
22011,011,22,2022,36624,-68,4,-64,505,469
22011,011,22,2023,36827,120,8,128,508,433
22013,013,22,2020,12913,-42,0,-42,44,68
22013,013,22,2021,12779,-27,6,-21,151,269
22013,013,22,2022,12612,-75,14,-61,165,270
22013,013,22,2023,12366,-162,4,-158,165,253
22015,015,22,2020,128721,-135,6,-129,386,292
22015,015,22,2021,129323,226,83,309,1581,1386
22015,015,22,2022,129153,-662,306,-356,1572,1369
22015,015,22,2023,129795,-14,300,286,1573,1223
22017,017,22,2020,236945,-662,0,-662,696,933
22017,017,22,2021,232658,-3525,38,-3487,2824,3558
22017,017,22,2022,228934,-3278,123,-3155,2744,3343
22017,017,22,2023,226386,-2616,141,-2475,2748,2818
22019,019,22,2020,216481,-388,6,-382,659,603
22019,019,22,2021,204914,-10937,139,-10798,2485,2655
22019,019,22,2022,202288,-3130,341,-2789,2523,2399
22019,019,22,2023,203761,650,393,1043,2499,2060
22021,021,22,2020,9615,-19,0,-19,26,37
22021,021,22,2021,9576,7,1,8,107,160
22021,021,22,2022,9493,-11,1,-10,87,158
22021,021,22,2023,9389,-44,2,-42,85,148
22023,023,22,2020,5623,7,0,7,14,18
22023,023,22,2021,5094,-505,0,-505,73,65
22023,023,22,2022,4896,-213,-2,-215,63,52
22023,023,22,2023,4768,-137,-2,-139,60,52
22025,025,22,2020,8844,-42,0,-42,17,30
22025,025,22,2021,8721,-58,1,-57,109,179
22025,025,22,2022,8604,-64,1,-63,96,149
22025,025,22,2023,8414,-126,1,-125,77,142
22027,027,22,2020,14103,-23,0,-23,23,64
22027,027,22,2021,14043,2,2,4,145,217
22027,027,22,2022,13849,-131,0,-131,140,205
22027,027,22,2023,13670,-123,0,-123,142,196
22029,029,22,2020,18569,-84,0,-84,50,70
22029,029,22,2021,18348,-150,33,-117,221,330
22029,029,22,2022,18026,-273,81,-192,161,296
22029,029,22,2023,17688,-223,65,-158,105,287
22031,031,22,2020,26845,57,0,57,68,97
22031,031,22,2021,26949,128,0,128,325,360
22031,031,22,2022,26856,-30,0,-30,330,380
22031,031,22,2023,27114,281,0,281,335,356
22033,033,22,2020,455899,-920,49,-871,1300,1361
22033,033,22,2021,453596,-3721,620,-3101,5551,4872
22033,033,22,2022,450091,-5635,1481,-4154,5573,4983
22033,033,22,2023,448467,-4674,1739,-2935,5455,4160
22035,035,22,2020,7397,-51,0,-51,18,25
22035,035,22,2021,7229,-131,0,-131,78,113
22035,035,22,2022,6939,-241,-1,-242,62,117
22035,035,22,2023,6829,-61,-1,-62,63,112
22037,037,22,2020,19456,-32,0,-32,45,100
22037,037,22,2021,19373,-5,0,-5,183,275
22037,037,22,2022,19208,-33,0,-33,179,297
22037,037,22,2023,19229,132,0,132,175,283
22039,039,22,2020,32297,-51,0,-51,108,107
22039,039,22,2021,32213,-96,43,-53,459,507
22039,039,22,2022,32033,-232,98,-134,449,490
22039,039,22,2023,31754,-400,113,-287,453,445
22041,041,22,2020,19713,-49,0,-49,56,66
22041,041,22,2021,19609,-21,0,-21,233,330
22041,041,22,2022,19358,-187,1,-186,247,315
22041,041,22,2023,19285,-15,1,-14,235,294
22043,043,22,2020,22149,-30,0,-30,61,59
22043,043,22,2021,22256,87,7,94,291,289
22043,043,22,2022,22040,-215,17,-198,264,285
22043,043,22,2023,21911,-138,13,-125,261,262
22045,045,22,2020,70055,-162,1,-161,181,254
22045,045,22,2021,69325,-770,26,-744,924,913
22045,045,22,2022,68320,-1033,62,-971,873,926
22045,045,22,2023,67659,-762,72,-690,873,845
22047,047,22,2020,30064,-111,0,-111,62,125
22047,047,22,2021,29747,-218,13,-205,322,447
22047,047,22,2022,29613,-76,54,-22,342,440
22047,047,22,2023,29617,10,66,76,345,418
22049,049,22,2020,14998,-16,0,-16,43,66
22049,049,22,2021,14900,1,1,2,127,237
22049,049,22,2022,14816,4,23,27,121,223
22049,049,22,2023,14746,2,29,31,120,219
22051,051,22,2020,439725,-894,78,-816,1284,1555
22051,051,22,2021,434134,-6740,893,-5847,5264,4890
22051,051,22,2022,426030,-10958,2322,-8636,5218,4984
22051,051,22,2023,421777,-7945,2753,-5192,5202,4223
22053,053,22,2020,32210,-50,0,-50,96,90
22053,053,22,2021,32373,220,-1,219,427,497
22053,053,22,2022,31929,-355,-3,-358,429,517
22053,053,22,2023,31553,-327,-3,-330,435,480
22055,055,22,2020,242145,130,11,141,707,530
22055,055,22,2021,244880,1377,270,1647,3387,2428
22055,055,22,2022,247714,1371,592,1963,3362,2391
22055,055,22,2023,249750,12,688,700,3388,2063
22057,057,22,2020,97454,-53,0,-53,253,338
22057,057,22,2021,97599,-23,25,2,1141,1075
22057,057,22,2022,95751,-1822,28,-1794,1120,1216
22057,057,22,2023,95056,-772,22,-750,1115,1063
22059,059,22,2020,14823,32,0,32,31,39
22059,059,22,2021,14842,39,3,42,166,201
22059,059,22,2022,14821,12,9,21,168,201
22059,059,22,2023,14800,-8,8,0,169,191
22061,061,22,2020,48309,-109,2,-107,136,124
22061,061,22,2021,48110,-221,24,-197,491,515
22061,061,22,2022,47980,-107,19,-88,464,491
22061,061,22,2023,47962,-43,21,-22,465,462
22063,063,22,2020,142834,460,2,462,419,341
22063,063,22,2021,146121,2867,69,2936,1842,1448
22063,063,22,2022,148056,1506,158,1664,1864,1581
22063,063,22,2023,150145,1422,171,1593,1842,1345
22065,065,22,2020,9927,-72,0,-72,27,37
22065,065,22,2021,9801,-105,1,-104,127,151
22065,065,22,2022,9480,-318,3,-315,132,152
22065,065,22,2023,9246,-226,4,-222,131,141
22067,067,22,2020,25465,-120,0,-120,75,117
22067,067,22,2021,25021,-256,3,-253,301,495
22067,067,22,2022,24414,-375,3,-372,271,506
22067,067,22,2023,23955,-255,7,-248,269,480
22069,069,22,2020,37387,-123,0,-123,106,107
22069,069,22,2021,36973,-294,-4,-298,427,549
22069,069,22,2022,36648,-218,3,-215,437,537
22069,069,22,2023,36291,-276,5,-271,425,509
22071,071,22,2020,383241,-615,11,-604,1056,1311
22071,071,22,2021,377346,-6479,318,-6161,4265,3864
22071,071,22,2022,369917,-8582,846,-7736,4112,4003
22071,071,22,2023,364136,-7468,964,-6504,4111,3387
22073,073,22,2020,160111,-281,0,-281,493,482
22073,073,22,2021,158866,-1197,48,-1149,2003,2137
22073,073,22,2022,157704,-1293,134,-1159,2023,2020
22073,073,22,2023,157568,-583,168,-415,2016,1748
22075,075,22,2020,23460,-46,0,-46,54,63
22075,075,22,2021,23310,-180,6,-174,249,229
22075,075,22,2022,22618,-826,32,-794,293,225
22075,075,22,2023,22386,-338,27,-311,291,212
22077,077,22,2020,20673,-40,1,-39,56,99
22077,077,22,2021,20346,-244,2,-242,234,318
22077,077,22,2022,20212,-63,17,-46,255,333
22077,077,22,2023,20000,-165,21,-144,249,315
22079,079,22,2020,129651,-302,1,-301,406,460
22079,079,22,2021,128626,-738,43,-695,1632,2008
22079,079,22,2022,127028,-1428,99,-1329,1670,1953
22079,079,22,2023,126260,-817,78,-739,1631,1671
22081,081,22,2020,7582,-11,0,-11,19,45
22081,081,22,2021,7505,-36,0,-36,98,144
22081,081,22,2022,7465,4,0,4,97,136
22081,081,22,2023,7356,-73,0,-73,95,130
22083,083,22,2020,20026,-29,0,-29,68,56
22083,083,22,2021,19856,-125,4,-121,269,326
22083,083,22,2022,19784,-41,26,-15,256,306
22083,083,22,2023,19712,-76,24,-52,260,281
22085,085,22,2020,22099,-21,0,-21,57,90
22085,085,22,2021,22096,117,1,118,263,394
22085,085,22,2022,21974,0,-2,-2,266,377
22085,085,22,2023,21906,29,0,29,264,361
22087,087,22,2020,43856,73,0,73,133,124
22087,087,22,2021,44324,313,15,328,575,456
22087,087,22,2022,44419,-9,46,37,576,494
22087,087,22,2023,44463,-137,64,-73,575,460
22089,089,22,2020,52513,-36,0,-36,145,151
22089,089,22,2021,52470,-177,0,-177,602,479
22089,089,22,2022,51058,-1546,6,-1540,575,506
22089,089,22,2023,50620,-553,5,-548,576,468
22091,091,22,2020,10898,-15,0,-15,30,38
22091,091,22,2021,10903,69,12,81,92,171
22091,091,22,2022,10789,-64,32,-32,96,174
22091,091,22,2023,10774,21,37,58,96,168
22093,093,22,2020,20120,-63,0,-63,60,70
22093,093,22,2021,19794,-312,3,-309,225,237
22093,093,22,2022,19388,-376,7,-369,213,259
22093,093,22,2023,19191,-170,8,-162,213,249
22095,095,22,2020,42366,-77,0,-77,115,153
22095,095,22,2021,42109,-325,11,-314,514,470
22095,095,22,2022,39955,-2268,24,-2244,478,483
22095,095,22,2023,39592,-413,30,-383,471,456
22097,097,22,2020,82314,-178,0,-178,264,334
22097,097,22,2021,82191,-20,21,1,1151,1321
22097,097,22,2022,81679,-509,71,-438,1186,1241
22097,097,22,2023,81464,-366,70,-296,1188,1111
22099,099,22,2020,51634,-136,0,-136,179,175
22099,099,22,2021,51562,-74,13,-61,626,667
22099,099,22,2022,51249,-351,45,-306,631,632
22099,099,22,2023,51057,-275,32,-243,630,576
22101,101,22,2020,49142,-213,2,-211,152,177
22101,101,22,2021,48219,-890,46,-844,641,697
22101,101,22,2022,47819,-450,138,-312,623,719
22101,101,22,2023,47055,-821,105,-716,616,661
22103,103,22,2020,265000,461,12,473,650,757
22103,103,22,2021,270147,4839,192,5031,3000,2825
22103,103,22,2022,273237,2616,415,3031,3062,2911
22103,103,22,2023,275583,1264,493,1757,3081,2490
22105,105,22,2020,133654,414,1,415,455,376
22105,105,22,2021,135488,1414,23,1437,1995,1616
22105,105,22,2022,136799,1040,66,1106,1958,1760
22105,105,22,2023,138064,735,68,803,1970,1520
22107,107,22,2020,4107,-23,0,-23,9,23
22107,107,22,2021,4024,-38,0,-38,40,87
22107,107,22,2022,3814,-155,0,-155,25,86
22107,107,22,2023,3764,18,0,18,18,86
22109,109,22,2020,109405,-223,2,-221,376,333
22109,109,22,2021,108955,-620,32,-588,1386,1286
22109,109,22,2022,104632,-4632,154,-4478,1372,1389
22109,109,22,2023,103616,-1272,130,-1142,1367,1242
22111,111,22,2020,21092,32,0,32,61,110
22111,111,22,2021,21001,45,10,55,220,378
22111,111,22,2022,20729,-139,29,-110,198,351
22111,111,22,2023,20650,53,12,65,195,338
22113,113,22,2020,56956,-58,0,-58,164,166
22113,113,22,2021,56874,-68,1,-67,746,789
22113,113,22,2022,56953,150,1,151,735,771
22113,113,22,2023,56992,-11,1,-10,749,702
22115,115,22,2020,48622,-223,3,-220,216,108
22115,115,22,2021,48022,-896,3,-893,841,533
22115,115,22,2022,46870,-1593,54,-1539,813,494
22115,115,22,2023,46250,-1065,80,-985,814,443
22117,117,22,2020,45357,-46,0,-46,140,206
22117,117,22,2021,45198,-34,1,-33,575,733
22117,117,22,2022,44991,29,-2,27,560,765
22117,117,22,2023,44865,-5,-1,-6,566,687
22119,119,22,2020,36883,-45,0,-45,95,135
22119,119,22,2021,35938,-566,12,-554,356,736
22119,119,22,2022,35527,-111,25,-86,395,700
22119,119,22,2023,35238,-69,25,-44,393,640
22121,121,22,2020,27262,38,0,38,100,84
22121,121,22,2021,27798,466,3,469,366,294
22121,121,22,2022,28034,156,41,197,343,291
22121,121,22,2023,28266,156,14,170,337,278
22123,123,22,2020,9696,-44,0,-44,22,34
22123,123,22,2021,9583,-33,1,-32,103,191
22123,123,22,2022,9481,-51,1,-50,110,159
22123,123,22,2023,9323,-120,1,-119,110,150
22125,125,22,2020,15259,-22,0,-22,24,53
22125,125,22,2021,15495,302,7,309,104,169
22125,125,22,2022,15396,-48,1,-47,121,172
22125,125,22,2023,15371,19,1,20,120,165
22127,127,22,2020,13720,-6,0,-6,28,58
22127,127,22,2021,13493,-121,6,-115,134,246
22127,127,22,2022,13251,-215,50,-165,136,211
22127,127,22,2023,13216,-26,61,35,135,206
23001,001,23,2020,111175,6,1,7,296,293
23001,001,23,2021,112732,1765,110,1875,1036,1297
23001,001,23,2022,113225,538,368,906,1131,1523
23001,001,23,2023,113765,478,346,824,1136,1429
23003,003,23,2020,67063,1,0,1,153,204
23003,003,23,2021,67075,352,28,380,639,1037
23003,003,23,2022,67322,701,42,743,645,1146
23003,003,23,2023,67351,435,40,475,640,1084
23005,005,23,2020,303585,453,45,498,733,759
23005,005,23,2021,306107,2134,521,2655,2745,2976
23005,005,23,2022,308837,1882,1241,3123,2892,3253
23005,005,23,2023,310230,401,1133,1534,2922,3059
23007,007,23,2020,29468,19,0,19,55,63
23007,007,23,2021,30258,984,7,991,225,380
23007,007,23,2022,30595,496,19,515,226,426
23007,007,23,2023,30828,403,16,419,226,411
23009,009,23,2020,55511,66,0,66,117,158
23009,009,23,2021,56355,1197,31,1228,386,729
23009,009,23,2022,56549,557,42,599,371,780
23009,009,23,2023,56526,315,40,355,372,752
23011,011,23,2020,124712,297,2,299,279,372
23011,011,23,2021,125752,1379,49,1428,1090,1484
23011,011,23,2022,126535,1226,132,1358,1109,1700
23011,011,23,2023,127259,1092,127,1219,1110,1605
23013,013,23,2020,40654,92,0,92,67,109
23013,013,23,2021,41069,654,10,664,269,504
23013,013,23,2022,41179,379,21,400,279,562
23013,013,23,2023,40977,42,20,62,280,542
23015,015,23,2020,35263,68,0,68,61,113
23015,015,23,2021,36024,986,2,988,236,424
23015,015,23,2022,36285,449,2,451,261,466
23015,015,23,2023,36507,412,2,414,258,450
23017,017,23,2020,57898,151,0,151,132,151
23017,017,23,2021,58692,1135,7,1142,469,786
23017,017,23,2022,59458,1153,9,1162,450,886
23017,017,23,2023,59905,829,9,838,441,831
23019,019,23,2020,152169,23,5,28,307,404
23019,019,23,2021,153359,1714,88,1802,1253,1883
23019,019,23,2022,154728,1890,231,2121,1298,2088
23019,019,23,2023,155312,1032,205,1237,1298,1950
23021,021,23,2020,16808,35,0,35,30,57
23021,021,23,2021,17217,525,23,548,130,246
23021,021,23,2022,17403,325,31,356,132,312
23021,021,23,2023,17486,251,8,259,130,306
23023,023,23,2020,36732,37,0,37,72,84
23023,023,23,2021,37170,575,8,583,281,414
23023,023,23,2022,37372,319,38,357,306,455
23023,023,23,2023,37513,255,14,269,315,441
23025,025,23,2020,50473,6,0,6,125,153
23025,025,23,2021,50782,483,8,491,463,654
23025,025,23,2022,51118,644,17,661,467,797
23025,025,23,2023,51302,458,10,468,472,759
23027,027,23,2020,39658,79,1,80,90,110
23027,027,23,2021,39978,460,2,462,340,481
23027,027,23,2022,40255,448,7,455,359,547
23027,027,23,2023,40620,526,7,533,359,531
23029,029,23,2020,31088,73,0,73,54,128
23029,029,23,2021,31192,333,11,344,272,513
23029,029,23,2022,31527,566,19,585,279,551
23029,029,23,2023,31555,252,17,269,287,529
23031,031,23,2020,212260,397,4,401,426,546
23031,031,23,2021,215025,3262,107,3369,1756,2308
23031,031,23,2022,216950,2288,285,2573,1804,2485
23031,031,23,2023,218586,2035,215,2250,1699,2319
24001,001,24,2020,67960,-48,0,-48,148,260
24001,001,24,2021,67687,217,0,217,625,1158
24001,001,24,2022,67266,91,19,110,579,1062
24001,001,24,2023,67273,427,33,460,553,1001
24003,003,24,2020,589106,251,-17,234,1727,1327
24003,003,24,2021,592085,456,399,855,6737,5026
24003,003,24,2022,593347,-1583,1005,-578,7027,4925
24003,003,24,2023,594582,-2732,1525,-1207,6971,4570
24005,005,24,2020,853387,-959,64,-895,2364,2751
24005,005,24,2021,850691,-3694,1109,-2585,9290,9831
24005,005,24,2022,845986,-7354,2649,-4705,9412,9316
24005,005,24,2023,844703,-5765,3663,-2102,9375,8577
24009,009,24,2020,92915,100,0,100,232,232
24009,009,24,2021,94233,1188,12,1200,949,853
24009,009,24,2022,94559,218,57,275,979,866
24009,009,24,2023,94728,-28,78,50,957,834
24011,011,24,2020,33270,-22,0,-22,89,97
24011,011,24,2021,33429,110,30,140,424,424
24011,011,24,2022,33427,-48,76,28,430,441
24011,011,24,2023,33593,68,103,171,423,430
24013,013,24,2020,172941,104,0,104,450,541
24013,013,24,2021,174313,1314,63,1377,1719,1814
24013,013,24,2022,175472,1206,140,1346,1810,1877
24013,013,24,2023,176639,944,215,1159,1795,1758
24015,015,24,2020,103800,79,1,80,277,309
24015,015,24,2021,104056,311,37,348,1097,1258
24015,015,24,2022,104870,854,99,953,1157,1262
24015,015,24,2023,105672,733,142,875,1124,1194
24017,017,24,2020,166741,48,0,48,433,406
24017,017,24,2021,168927,1633,99,1732,1819,1433
24017,017,24,2022,170111,676,280,956,1831,1479
24017,017,24,2023,171973,1174,395,1569,1724,1421
24019,019,24,2020,32530,12,0,12,95,110
24019,019,24,2021,32594,141,13,154,345,451
24019,019,24,2022,32583,134,21,155,337,495
24019,019,24,2023,32879,413,32,445,336,489
24021,021,24,2020,272786,920,5,925,771,646
24021,021,24,2021,280647,6769,315,7084,3075,2126
24021,021,24,2022,287540,4997,840,5837,3225,2212
24021,021,24,2023,293391,3551,1215,4766,3172,2066
24023,023,24,2020,28798,-18,0,-18,95,92
24023,023,24,2021,28758,127,3,130,236,420
24023,023,24,2022,28588,1,3,4,239,396
24023,023,24,2023,28423,4,6,10,215,389
24025,025,24,2020,261230,222,0,222,627,631
24025,025,24,2021,263302,1951,48,1999,2595,2632
24025,025,24,2022,263815,542,84,626,2643,2593
24025,025,24,2023,264644,481,148,629,2624,2413
24027,027,24,2020,332814,135,13,148,827,560
24027,027,24,2021,335328,630,410,1040,3275,2026
24027,027,24,2022,335366,-2331,1075,-1256,3256,1999
24027,027,24,2023,336001,-2222,1500,-722,3236,1901
24029,029,24,2020,19120,-16,0,-16,39,104
24029,029,24,2021,19244,304,8,312,133,313
24029,029,24,2022,19295,194,25,219,147,320
24029,029,24,2023,19303,139,37,176,145,312
24031,031,24,2020,1060904,-1920,250,-1670,2874,2421
24031,031,24,2021,1056193,-11875,2914,-8961,11291,7080
24031,031,24,2022,1053067,-16517,8043,-8474,11797,6898
24031,031,24,2023,1058474,-11153,11191,38,11709,6412
24033,033,24,2020,965365,-2251,174,-2077,2796,2701
24033,033,24,2021,956451,-14455,2563,-11892,10943,7823
24033,033,24,2022,946980,-20019,6723,-13296,10929,7493
24033,033,24,2023,947430,-12516,9345,-3171,10619,6954
24035,035,24,2020,50033,133,0,133,143,125
24035,035,24,2021,50922,856,28,884,499,480
24035,035,24,2022,51720,698,79,777,540,529
24035,035,24,2023,52508,675,107,782,533,522
24037,037,24,2020,113999,133,0,133,327,270
24037,037,24,2021,114650,159,67,226,1374,1042
24037,037,24,2022,114783,-338,139,-199,1425,1063
24037,037,24,2023,115281,-96,210,114,1405,1025
24039,039,24,2020,24561,-28,0,-28,47,79
24039,039,24,2021,24546,77,9,86,222,342
24039,039,24,2022,24608,125,42,167,219,317
24039,039,24,2023,24910,340,59,399,218,315
24041,041,24,2020,37488,0,0,0,95,134
24041,041,24,2021,37756,476,23,499,326,551
24041,041,24,2022,37814,254,63,317,306,561
24041,041,24,2023,37823,163,88,251,304,543
24043,043,24,2020,154697,-3,0,-3,416,464
24043,043,24,2021,155143,642,72,714,1630,1992
24043,043,24,2022,155257,519,150,669,1585,2047
24043,043,24,2023,155813,693,212,905,1554,1900
24045,045,24,2020,103565,-79,1,-78,336,310
24045,045,24,2021,104114,364,154,518,1200,1234
24045,045,24,2022,104486,64,339,403,1289,1266
24045,045,24,2023,104800,-234,467,233,1276,1201
24047,047,24,2020,52522,132,1,133,96,167
24047,047,24,2021,53398,1231,23,1254,429,764
24047,047,24,2022,53934,757,49,806,467,749
24047,047,24,2023,54171,425,70,495,459,716
24510,510,24,2020,583157,-2182,16,-2166,1852,2192
24510,510,24,2021,576578,-6615,642,-5973,7198,7922
24510,510,24,2022,569107,-8874,1536,-7338,7275,7393
24510,510,24,2023,565239,-6389,2136,-4253,7242,6827
25001,001,25,2020,228012,-352,4,-348,354,895
25001,001,25,2021,232315,6095,276,6371,1412,3192
25001,001,25,2022,232078,950,704,1654,1519,3319
25001,001,25,2023,231735,539,836,1375,1504,3208
25003,003,25,2020,128619,-234,0,-234,248,414
25003,003,25,2021,128376,405,79,484,970,1760
25003,003,25,2022,127547,-185,225,40,921,1729
25003,003,25,2023,126818,-195,263,68,888,1685
25005,005,25,2020,576772,-1708,20,-1688,1456,1932
25005,005,25,2021,579756,2781,723,3504,5456,6178
25005,005,25,2022,579744,-997,1793,796,5716,6247
25005,005,25,2023,581841,531,2092,2623,5475,6004
25007,007,25,2020,20593,-12,0,-12,45,47
25007,007,25,2021,21127,514,28,542,172,161
25007,007,25,2022,20962,-334,154,-180,183,172
25007,007,25,2023,20819,-324,176,-148,177,173
25009,009,25,2020,807791,-1436,94,-1342,2026,2710
25009,009,25,2021,807360,-3690,2016,-1674,8225,7431
25009,009,25,2022,806499,-6920,5096,-1824,8551,7526
25009,009,25,2023,810089,-3691,5988,2297,8482,7227
25011,011,25,2020,70923,25,0,25,117,267
25011,011,25,2021,70991,238,30,268,498,724
25011,011,25,2022,70995,157,132,289,513,752
25011,011,25,2023,70836,-51,152,101,495,754
25013,013,25,2020,464311,-955,64,-891,1189,1789
25013,013,25,2021,462862,-1825,578,-1247,4720,5188
25013,013,25,2022,460758,-3056,1381,-1675,4798,5133
25013,013,25,2023,460291,-1931,1581,-350,4808,4951
25015,015,25,2020,146616,-12307,6,-12301,262,459
25015,015,25,2021,163128,17970,278,18248,900,1371
25015,015,25,2022,162518,-716,626,-90,939,1432
25015,015,25,2023,162502,-292,755,463,937,1419
25017,017,25,2020,1628235,-3565,301,-3264,4137,4635
25017,017,25,2021,1617262,-19699,5207,-14492,15571,11953
25017,017,25,2022,1616794,-18198,13795,-4403,16191,12347
25017,017,25,2023,1623952,-13402,16339,2937,16102,11957
25019,019,25,2020,14237,-25,0,-25,30,22
25019,019,25,2021,14506,184,15,199,146,75
25019,019,25,2022,14443,-182,46,-136,166,90
25019,019,25,2023,14444,-122,51,-71,159,88
25021,021,25,2020,724554,-907,115,-792,1720,2329
25021,021,25,2021,724471,-2976,1633,-1343,6879,5991
25021,021,25,2022,725469,-4269,4380,111,7249,6261
25021,021,25,2023,727473,-4372,5181,809,7196,6056
25023,023,25,2020,530200,-77,16,-61,1216,1866
25023,023,25,2021,533059,2033,564,2597,5160,5181
25023,023,25,2022,533248,-1017,1476,459,5415,5499
25023,023,25,2023,535308,228,1722,1950,5395,5289
25025,025,25,2020,797181,-3813,190,-3623,2197,2103
25025,025,25,2021,774514,-27830,3508,-24322,8070,4993
25025,025,25,2022,768812,-18094,8914,-9180,8267,5071
25025,025,25,2023,768425,-14207,10606,-3601,8210,4932
25027,027,25,2020,859669,-1869,98,-1771,2116,2665
25027,027,25,2021,862224,-469,1542,1073,8262,7454
25027,027,25,2022,862873,-3952,4210,258,8641,7988
25027,027,25,2023,866866,-1860,4905,3045,8559,7661
26001,001,26,2020,10192,49,0,49,24,41
26001,001,26,2021,10295,259,1,260,67,208
26001,001,26,2022,10397,236,9,245,70,229
26001,001,26,2023,10489,235,9,244,63,216
26003,003,26,2020,8842,6,0,6,21,23
26003,003,26,2021,8774,-27,2,-25,64,112
26003,003,26,2022,8773,38,0,38,74,116
26003,003,26,2023,8757,30,0,30,67,114
26005,005,26,2020,120669,122,2,124,288,288
26005,005,26,2021,121068,321,51,372,1218,1268
26005,005,26,2022,121290,224,134,358,1242,1303
26005,005,26,2023,121939,486,97,583,1227,1163
26007,007,26,2020,28886,-3,0,-3,61,89
26007,007,26,2021,28939,201,0,201,277,435
26007,007,26,2022,28833,113,2,115,277,484
26007,007,26,2023,28904,246,4,250,269,447
26009,009,26,2020,23458,63,0,63,37,61
26009,009,26,2021,23879,593,0,593,186,333
26009,009,26,2022,24265,480,19,499,195,336
26009,009,26,2023,24409,262,17,279,187,319
26011,011,26,2020,15001,26,0,26,28,56
26011,011,26,2021,15016,115,0,115,138,241
26011,011,26,2022,15123,215,0,215,146,254
26011,011,26,2023,15145,137,0,137,132,247
26013,013,26,2020,8142,-5,0,-5,18,24
26013,013,26,2021,8286,195,0,195,86,130
26013,013,26,2022,8283,31,0,31,83,115
26013,013,26,2023,8310,73,0,73,69,116
26015,015,26,2020,62598,160,0,160,168,152
26015,015,26,2021,63141,593,5,598,622,691
26015,015,26,2022,63402,427,7,434,622,783
26015,015,26,2023,63808,508,10,518,604,711
26017,017,26,2020,103742,-50,0,-50,251,333
26017,017,26,2021,103108,24,0,24,900,1635
26017,017,26,2022,102638,243,12,255,912,1576
26017,017,26,2023,102500,396,14,410,865,1409
26019,019,26,2020,17990,55,0,55,34,58
26019,019,26,2021,18237,373,1,374,137,252
26019,019,26,2022,18327,178,7,185,144,246
26019,019,26,2023,18441,196,13,209,138,231
26021,021,26,2020,154197,-63,0,-63,387,482
26021,021,26,2021,153352,-586,70,-516,1526,1929
26021,021,26,2022,152835,-208,184,-24,1609,2025
26021,021,26,2023,152261,-563,225,-338,1584,1824
26023,023,26,2020,44884,-12,0,-12,154,144
26023,023,26,2021,45215,256,35,291,587,566
26023,023,26,2022,44502,-862,114,-748,562,571
26023,023,26,2023,45215,575,135,710,530,533
26025,025,26,2020,134200,-60,0,-60,379,442
26025,025,26,2021,133878,-3,40,37,1490,1941
26025,025,26,2022,133424,-161,87,-74,1536,1846
26025,025,26,2023,133366,-1,94,93,1517,1670
26027,027,26,2020,51559,-13,0,-13,117,152
26027,027,26,2021,51527,147,1,148,451,659
26027,027,26,2022,51477,135,7,142,478,645
26027,027,26,2023,51642,308,13,321,446,601
26029,029,26,2020,26041,-4,0,-4,57,71
26029,029,26,2021,26199,243,7,250,220,315
26029,029,26,2022,26173,135,24,159,207,384
26029,029,26,2023,26159,125,20,145,201,357
26031,031,26,2020,25587,78,0,78,36,105
26031,031,26,2021,25754,393,1,394,189,403
26031,031,26,2022,25964,424,10,434,209,447
26031,031,26,2023,26048,292,15,307,192,417
26033,033,26,2020,36787,-5,0,-5,75,76
26033,033,26,2021,35849,-769,6,-763,297,428
26033,033,26,2022,36207,478,35,513,288,462
26033,033,26,2023,36264,167,43,210,291,445
26035,035,26,2020,30843,10,0,10,64,97
26035,035,26,2021,31131,528,2,530,311,540
26035,035,26,2022,31307,423,2,425,308,573
26035,035,26,2023,31316,216,4,220,305,518
26037,037,26,2020,79170,2,0,2,191,168
26037,037,26,2021,79464,313,26,339,708,804
26037,037,26,2022,79652,278,47,325,718,797
26037,037,26,2023,79720,46,59,105,675,712
26039,039,26,2020,12992,14,0,14,32,47
26039,039,26,2021,13277,388,1,389,112,199
26039,039,26,2022,13434,262,3,265,111,227
26039,039,26,2023,13538,213,3,216,107,220
26041,041,26,2020,36870,0,0,0,77,119
26041,041,26,2021,36825,217,0,217,346,618
26041,041,26,2022,36781,196,-5,191,336,561
26041,041,26,2023,36790,228,-4,224,314,528
26043,043,26,2020,25904,-32,0,-32,55,75
26043,043,26,2021,25819,49,2,51,240,395
26043,043,26,2022,25943,253,5,258,233,361
26043,043,26,2023,25982,164,7,171,212,341
26045,045,26,2020,109175,-24,0,-24,283,277
26045,045,26,2021,108908,-89,45,-44,1069,1363
26045,045,26,2022,108854,135,123,258,1105,1346
26045,045,26,2023,108820,-44,149,105,1075,1212
26047,047,26,2020,34113,17,0,17,71,95
26047,047,26,2021,34297,343,4,347,265,434
26047,047,26,2022,34215,74,4,78,254,394
26047,047,26,2023,34123,15,5,20,260,371
26049,049,26,2020,405777,-103,0,-103,1052,1498
26049,049,26,2021,404627,-364,83,-281,4325,5496
26049,049,26,2022,401923,-1604,251,-1353,4404,5610
26049,049,26,2023,401522,-110,331,221,4337,4972
26051,051,26,2020,25378,46,0,46,44,96
26051,051,26,2021,25475,355,0,355,240,488
26051,051,26,2022,25621,391,0,391,230,488
26051,051,26,2023,25853,456,0,456,226,450
26053,053,26,2020,14346,-8,0,-8,28,51
26053,053,26,2021,14367,174,0,174,90,240
26053,053,26,2022,14377,120,1,121,98,216
26053,053,26,2023,14224,-29,3,-26,77,202
26055,055,26,2020,95425,178,0,178,231,245
26055,055,26,2021,95969,676,23,699,898,1089
26055,055,26,2022,96298,544,48,592,897,1138
26055,055,26,2023,96421,192,54,246,893,1017
26057,057,26,2020,41683,-35,0,-35,87,136
26057,057,26,2021,41286,-230,3,-227,357,541
26057,057,26,2022,41104,24,9,33,352,541
26057,057,26,2023,41368,390,14,404,355,496
26059,059,26,2020,45731,5,0,5,131,170
26059,059,26,2021,45625,-18,7,-11,470,598
26059,059,26,2022,45735,296,11,307,489,664
26059,059,26,2023,45587,-3,13,10,446,604
26061,061,26,2020,37237,-110,1,-109,79,76
26061,061,26,2021,37507,221,35,256,379,383
26061,061,26,2022,37160,-462,110,-352,370,386
26061,061,26,2023,37599,295,146,441,347,353
26063,063,26,2020,31364,-3,0,-3,68,104
26063,063,26,2021,31307,172,6,178,293,541
26063,063,26,2022,31145,93,17,110,278,535
26063,063,26,2023,30927,-19,17,-2,277,492
26065,065,26,2020,284675,-385,17,-368,740,659
26065,065,26,2021,271224,-12918,415,-12503,2733,2733
26065,065,26,2022,283477,10260,906,11166,2848,2798
26065,065,26,2023,284637,-434,1240,806,2908,2556
26067,067,26,2020,66870,14,0,14,175,137
26067,067,26,2021,66823,-137,7,-130,628,591
26067,067,26,2022,66836,9,12,21,672,642
26067,067,26,2023,66262,-673,11,-662,670,591
26069,069,26,2020,25184,16,0,16,47,107
26069,069,26,2021,25350,464,6,470,199,486
26069,069,26,2022,25473,387,7,394,215,500
26069,069,26,2023,25373,158,11,169,200,468
26071,071,26,2020,11634,40,0,40,19,54
26071,071,26,2021,11610,130,0,130,68,221
26071,071,26,2022,11705,221,1,222,71,203
26071,071,26,2023,11740,161,2,163,64,192
26073,073,26,2020,64518,69,0,69,158,130
26073,073,26,2021,64248,-198,20,-178,580,695
26073,073,26,2022,64366,211,50,261,599,697
26073,073,26,2023,64118,-247,61,-186,593,657
26075,075,26,2020,160231,-110,0,-110,402,471
26075,075,26,2021,160162,192,28,220,1658,2069
26075,075,26,2022,159758,142,52,194,1660,2158
26075,075,26,2023,159424,-84,78,-6,1611,1942
26077,077,26,2020,261796,-78,5,-73,732,630
26077,077,26,2021,260523,-1625,275,-1350,2629,2634
26077,077,26,2022,260892,-288,733,445,2751,2681
26077,077,26,2023,262215,152,842,994,2732,2412
26079,079,26,2020,17931,3,0,3,41,58
26079,079,26,2021,17994,137,-1,136,164,237
26079,079,26,2022,18244,306,3,309,185,257
26079,079,26,2023,18490,294,4,298,184,239
26081,081,26,2020,658492,-467,23,-444,2104,1371
26081,081,26,2021,658852,-2850,566,-2284,8032,5770
26081,081,26,2022,658920,-3596,1532,-2064,8186,5815
26081,081,26,2023,661354,-2453,1838,-615,8192,5154
26083,083,26,2020,2060,13,0,13,6,5
26083,083,26,2021,2108,65,0,65,13,26
26083,083,26,2022,2155,67,0,67,10,35
26083,083,26,2023,2172,41,0,41,10,34
26085,085,26,2020,12094,26,0,26,17,44
26085,085,26,2021,12274,317,1,318,80,205
26085,085,26,2022,12651,447,2,449,91,197
26085,085,26,2023,12734,186,2,188,90,195
26087,087,26,2020,88583,19,0,19,196,273
26087,087,26,2021,88662,308,33,341,774,1089
26087,087,26,2022,88632,354,111,465,788,1216
26087,087,26,2023,88977,591,82,673,769,1095
26089,089,26,2020,22308,45,0,45,37,71
26089,089,26,2021,22627,480,3,483,155,302
26089,089,26,2022,22883,377,10,387,185,324
26089,089,26,2023,23019,232,10,242,187,291
26091,091,26,2020,99325,-84,2,-82,248,276
26091,091,26,2021,99100,79,36,115,894,1307
26091,091,26,2022,98280,-432,126,-306,827,1318
26091,091,26,2023,97520,-413,105,-308,739,1191
26093,093,26,2020,193968,97,0,97,439,477
26093,093,26,2021,195333,1303,18,1321,1750,1807
26093,093,26,2022,196134,1063,21,1084,1772,1936
26093,093,26,2023,196757,677,34,711,1629,1703
26095,095,26,2020,6412,3,0,3,12,19
26095,095,26,2021,5977,-373,0,-373,52,83
26095,095,26,2022,6274,303,-1,302,56,86
26095,095,26,2023,6435,186,-1,185,56,83
26097,097,26,2020,10816,22,0,22,15,51
26097,097,26,2021,10907,181,6,187,77,163
26097,097,26,2022,10962,123,47,170,83,198
26097,097,26,2023,10851,-53,48,-5,81,187
26099,099,26,2020,880238,-352,44,-308,2307,3196
26099,099,26,2021,877646,-2074,592,-1482,8606,10284
26099,099,26,2022,874235,-2630,1444,-1186,8739,10618
26099,099,26,2023,875101,-212,1820,1608,8630,9376
26101,101,26,2020,25066,82,0,82,41,82
26101,101,26,2021,25328,479,4,483,188,395
26101,101,26,2022,25365,216,13,229,195,379
26101,101,26,2023,25562,347,15,362,194,357
26103,103,26,2020,66012,-26,0,-26,148,143
26103,103,26,2021,65739,-98,7,-91,550,774
26103,103,26,2022,66548,969,34,1003,568,806
26103,103,26,2023,66999,582,37,619,561,737
26105,105,26,2020,29033,25,0,25,56,106
26105,105,26,2021,29339,500,4,504,229,416
26105,105,26,2022,29318,177,17,194,232,446
26105,105,26,2023,29159,7,14,21,232,410
26107,107,26,2020,39790,79,0,79,111,110
26107,107,26,2021,40048,380,5,385,366,494
26107,107,26,2022,40782,755,8,763,425,481
26107,107,26,2023,41099,335,10,345,414,444
26109,109,26,2020,23451,-18,0,-18,39,68
26109,109,26,2021,23317,-6,1,-5,184,329
26109,109,26,2022,23225,97,3,100,152,334
26109,109,26,2023,22945,-44,6,-38,73,313
26111,111,26,2020,83478,-3,0,-3,182,207
26111,111,26,2021,83479,-7,38,31,814,899
26111,111,26,2022,83762,357,59,416,863,944
26111,111,26,2023,84039,188,88,276,862,858
26113,113,26,2020,15065,19,0,19,35,46
26113,113,26,2021,15173,148,1,149,161,204
26113,113,26,2022,15232,98,8,106,165,207
26113,113,26,2023,15311,109,9,118,158,199
26115,115,26,2020,154896,97,0,97,403,453
26115,115,26,2021,155534,855,43,898,1525,1871
26115,115,26,2022,155235,196,125,321,1411,1934
26115,115,26,2023,155045,292,116,408,1144,1740
26117,117,26,2020,66635,-38,0,-38,194,143
26117,117,26,2021,67320,818,11,829,642,790
26117,117,26,2022,67209,-6,68,62,682,822
26117,117,26,2023,68154,922,87,1009,678,750
26119,119,26,2020,9170,41,0,41,16,40
26119,119,26,2021,9302,264,0,264,78,198
26119,119,26,2022,9557,353,1,354,75,201
26119,119,26,2023,9678,248,1,249,73,200
26121,121,26,2020,174784,36,1,37,495,543
26121,121,26,2021,175550,938,39,977,1841,2144
26121,121,26,2022,175539,245,95,340,1869,2149
26121,121,26,2023,176564,1007,91,1098,1875,1949
26123,123,26,2020,50111,113,0,113,135,123
26123,123,26,2021,50413,398,16,414,496,620
26123,123,26,2022,50728,441,43,484,496,655
26123,123,26,2023,51108,440,34,474,493,588
26125,125,26,2020,1272493,-1668,144,-1524,3195,3749
26125,125,26,2021,1272630,-2766,2000,-766,12312,12263
26125,125,26,2022,1271025,-7290,5515,-1775,12825,12388
26125,125,26,2023,1270426,-8944,6558,-2386,12666,10964
26127,127,26,2020,26712,66,1,67,68,76
26127,127,26,2021,26860,180,39,219,261,337
26127,127,26,2022,26920,70,75,145,265,338
26127,127,26,2023,26981,39,66,105,268,312
26129,129,26,2020,20780,38,0,38,42,66
26129,129,26,2021,20774,166,3,169,183,359
26129,129,26,2022,20919,331,13,344,181,391
26129,129,26,2023,20990,244,17,261,179,371
26131,131,26,2020,5804,15,0,15,9,29
26131,131,26,2021,5870,165,1,166,32,123
26131,131,26,2022,5921,116,1,117,33,103
26131,131,26,2023,5906,55,1,56,31,102
26133,133,26,2020,22909,17,0,17,65,69
26133,133,26,2021,23196,308,2,310,238,259
26133,133,26,2022,23279,118,11,129,249,290
26133,133,26,2023,23330,80,12,92,232,273
26135,135,26,2020,8235,22,0,22,26,32
26135,135,26,2021,8320,180,0,180,95,182
26135,135,26,2022,8391,156,1,157,80,177
26135,135,26,2023,8545,240,2,242,77,164
26137,137,26,2020,25133,53,0,53,63,75
26137,137,26,2021,25324,296,2,298,234,340
26137,137,26,2022,25561,360,9,369,235,370
26137,137,26,2023,25747,279,15,294,237,344
26139,139,26,2020,296907,446,4,450,750,580
26139,139,26,2021,298393,555,133,688,3115,2498
26139,139,26,2022,300918,1784,262,2046,3136,2554
26139,139,26,2023,303372,1382,234,1616,3121,2281
26141,141,26,2020,13005,51,0,51,20,48
26141,141,26,2021,13172,291,2,293,91,205
26141,141,26,2022,13343,287,7,294,88,216
26141,141,26,2023,13285,56,5,61,89,208
26143,143,26,2020,23472,76,0,76,40,87
26143,143,26,2021,23653,563,0,563,133,485
26143,143,26,2022,23682,323,1,324,153,474
26143,143,26,2023,23863,470,1,471,151,442
26145,145,26,2020,189882,-110,1,-109,515,692
26145,145,26,2021,189516,236,33,269,1953,2715
26145,145,26,2022,188373,-541,85,-456,2009,2601
26145,145,26,2023,187782,-332,89,-243,1998,2354
26147,147,26,2020,160380,74,0,74,378,500
26147,147,26,2021,160205,495,28,523,1483,2290
26147,147,26,2022,159668,405,60,465,1434,2339
26147,147,26,2023,159874,809,60,869,1423,2079
26149,149,26,2020,60941,-23,0,-23,174,164
26149,149,26,2021,60844,-82,20,-62,688,763
26149,149,26,2022,60778,41,65,106,661,803
26149,149,26,2023,60878,137,49,186,645,734
26151,151,26,2020,40499,-73,0,-73,86,124
26151,151,26,2021,40528,214,18,232,421,644
26151,151,26,2022,40482,178,40,218,397,643
26151,151,26,2023,40368,56,29,85,396,595
26153,153,26,2020,8057,23,0,23,19,32
26153,153,26,2021,8048,61,1,62,65,139
26153,153,26,2022,8174,186,8,194,61,132
26153,153,26,2023,8149,38,7,45,59,129
26155,155,26,2020,68010,-36,0,-36,162,219
26155,155,26,2021,67991,121,1,122,654,841
26155,155,26,2022,67967,223,10,233,679,900
26155,155,26,2023,68025,189,14,203,665,805
26157,157,26,2020,53312,27,0,27,133,185
26157,157,26,2021,53034,-48,3,-45,503,775
26157,157,26,2022,52908,166,22,188,505,795
26157,157,26,2023,52826,107,31,138,495,715
26159,159,26,2020,75574,-8,0,-8,179,201
26159,159,26,2021,75678,186,20,206,807,955
26159,159,26,2022,75669,103,100,203,816,986
26159,159,26,2023,75798,128,95,223,815,904
26161,161,26,2020,371834,-628,21,-607,890,729
26161,161,26,2021,365013,-7610,636,-6974,3173,2665
26161,161,26,2022,366504,-538,1592,1054,3302,2655
26161,161,26,2023,365536,-3642,2074,-1568,2936,2375
26163,163,26,2020,1789586,-2843,143,-2700,5508,7357
26163,163,26,2021,1774807,-16878,1468,-15410,21286,20839
26163,163,26,2022,1758942,-19709,4065,-15644,21253,21573
26163,163,26,2023,1751169,-14685,5231,-9454,20698,19095
26165,165,26,2020,33693,23,0,23,88,99
26165,165,26,2021,33898,273,3,276,348,426
26165,165,26,2022,34018,272,17,289,341,503
26165,165,26,2023,34122,219,22,241,340,476
27001,001,27,2020,15722,44,0,44,33,54
27001,001,27,2021,15957,412,1,413,105,261
27001,001,27,2022,16142,301,9,310,100,257
27001,001,27,2023,16102,94,9,103,101,243
27003,003,27,2020,364499,107,4,111,1033,671
27003,003,27,2021,367802,1378,361,1739,4077,2739
27003,003,27,2022,369108,-792,852,60,4234,2867
27003,003,27,2023,372441,835,900,1735,4246,2629
27005,005,27,2020,35193,-5,0,-5,106,90
27005,005,27,2021,35336,179,6,185,371,430
27005,005,27,2022,35363,108,13,121,355,430
27005,005,27,2023,35283,-23,11,-12,343,411
27007,007,27,2020,46255,-7,0,-7,134,127
27007,007,27,2021,46481,84,14,98,607,509
27007,007,27,2022,46511,-18,21,3,577,526
27007,007,27,2023,46718,127,19,146,574,514
27009,009,27,2020,41355,-44,2,-42,122,106
27009,009,27,2021,41533,44,46,90,487,428
27009,009,27,2022,41509,-179,108,-71,478,417
27009,009,27,2023,41600,-115,124,9,478,401
27011,011,27,2020,5158,-7,0,-7,14,15
27011,011,27,2021,5167,22,0,22,66,83
27011,011,27,2022,5149,2,0,2,59,78
27011,011,27,2023,5105,-23,2,-21,54,77
27013,013,27,2020,69204,13,3,16,195,145
27013,013,27,2021,69380,-115,86,-29,715,555
27013,013,27,2022,69603,-85,265,180,703,618
27013,013,27,2023,70006,42,243,285,700,584
27015,015,27,2020,25914,-11,0,-11,73,70
27015,015,27,2021,25899,28,6,34,260,325
27015,015,27,2022,25762,-62,12,-50,270,351
27015,015,27,2023,25628,-93,32,-61,268,340
27017,017,27,2020,36185,-23,0,-23,96,84
27017,017,27,2021,36440,334,7,341,355,452
27017,017,27,2022,36544,206,16,222,389,488
27017,017,27,2023,36825,336,15,351,390,462
27019,019,27,2020,107297,238,0,238,250,142
27019,019,27,2021,108859,967,57,1024,1140,640
27019,019,27,2022,110120,661,147,808,1220,702
27019,019,27,2023,111057,211,155,366,1217,646
27021,021,27,2020,30168,112,0,112,63,86
27021,021,27,2021,30682,663,0,663,283,408
27021,021,27,2022,31308,731,9,740,286,445
27021,021,27,2023,31446,276,9,285,285,432
27023,023,27,2020,12608,-2,0,-2,36,32
27023,023,27,2021,12372,-201,16,-185,142,188
27023,023,27,2022,12269,-125,37,-88,166,178
27023,023,27,2023,12172,-150,56,-94,164,168
27025,025,27,2020,56716,25,0,25,153,103
27025,025,27,2021,57549,757,14,771,575,518
27025,025,27,2022,57898,329,20,349,599,562
27025,025,27,2023,58535,592,19,611,565,535
27027,027,27,2020,65344,-49,1,-48,222,154
27027,027,27,2021,65651,-41,62,21,789,546
27027,027,27,2022,65860,-106,144,38,777,574
27027,027,27,2023,66258,264,137,401,539,543
27029,029,27,2020,8578,41,0,41,31,21
27029,029,27,2021,8582,20,0,20,95,116
27029,029,27,2022,8638,95,1,96,85,125
27029,029,27,2023,8644,45,1,46,83,122
27031,031,27,2020,5597,3,0,3,7,13
27031,031,27,2021,5629,54,2,56,38,57
27031,031,27,2022,5721,89,17,106,32,50
27031,031,27,2023,5639,-85,20,-65,31,47
27033,033,27,2020,11516,8,0,8,31,35
27033,033,27,2021,11594,110,1,111,141,179
27033,033,27,2022,11382,-196,5,-191,142,167
27033,033,27,2023,11319,-39,11,-28,130,165
27035,035,27,2020,66277,156,0,156,165,160
27035,035,27,2021,67342,1258,3,1261,629,790
27035,035,27,2022,67884,728,16,744,633,848
27035,035,27,2023,68304,546,16,562,637,780
27037,037,27,2020,440423,-10,20,10,1192,795
27037,037,27,2021,442730,-27,373,346,4902,3235
27037,037,27,2022,443272,-2084,995,-1089,5054,3382
27037,037,27,2023,447440,1193,1042,2235,5038,3088
27039,039,27,2020,20889,-16,0,-16,66,30
27039,039,27,2021,20952,-28,0,-28,247,171
27039,039,27,2022,20992,-68,14,-54,270,171
27039,039,27,2023,21088,-38,32,-6,268,166
27041,041,27,2020,39087,90,0,90,105,103
27041,041,27,2021,39298,288,7,295,398,492
27041,041,27,2022,39684,423,34,457,397,461
27041,041,27,2023,39953,285,33,318,396,443
27043,043,27,2020,13898,-9,0,-9,31,41
27043,043,27,2021,13906,86,0,86,113,196
27043,043,27,2022,13930,95,4,99,126,194
27043,043,27,2023,13873,-3,6,3,127,188
27045,045,27,2020,21243,9,0,9,60,70
27045,045,27,2021,21331,80,4,84,230,237
27045,045,27,2022,21454,120,18,138,246,258
27045,045,27,2023,21522,59,29,88,227,246
27047,047,27,2020,30896,4,0,4,89,97
27047,047,27,2021,30803,-37,17,-20,308,399
27047,047,27,2022,30683,-30,21,-9,313,409
27047,047,27,2023,30515,-105,20,-85,311,394
27049,049,27,2020,47578,-13,0,-13,129,132
27049,049,27,2021,48042,537,8,545,488,575
27049,049,27,2022,48041,108,18,126,495,590
27049,049,27,2023,48035,20,37,57,486,552
27051,051,27,2020,6093,14,0,14,22,16
27051,051,27,2021,6149,77,1,78,57,80
27051,051,27,2022,6121,-15,2,-13,69,80
27051,051,27,2023,6139,25,4,29,69,79
27053,053,27,2020,1281649,-1378,135,-1243,3901,3012
27053,053,27,2021,1270055,-17899,1793,-16106,14505,9806
27053,053,27,2022,1257066,-22770,4652,-18118,14825,10253
27053,053,27,2023,1258713,-8236,4530,-3706,14847,9452
27055,055,27,2020,18849,-9,0,-9,58,48
27055,055,27,2021,18819,-3,7,4,177,222
27055,055,27,2022,18727,-3,1,-2,131,210
27055,055,27,2023,18582,-11,1,-10,66,200
27057,057,27,2020,21397,49,0,49,47,49
27057,057,27,2021,21749,396,5,401,229,265
27057,057,27,2022,21963,226,12,238,222,248
27057,057,27,2023,22132,179,12,191,220,244
27059,059,27,2020,41396,250,0,250,97,78
27059,059,27,2021,41962,499,4,503,482,419
27059,059,27,2022,42711,694,19,713,478,452
27059,059,27,2023,43182,409,19,428,479,435
27061,061,27,2020,45034,38,0,38,112,136
27061,061,27,2021,45099,282,2,284,365,599
27061,061,27,2022,45194,423,1,424,383,706
27061,061,27,2023,45365,449,1,450,383,659
27063,063,27,2020,9995,-4,0,-4,26,23
27063,063,27,2021,10005,30,2,32,89,118
27063,063,27,2022,9898,-110,7,-103,106,110
27063,063,27,2023,9919,16,12,28,99,106
27065,065,27,2020,16053,22,0,22,50,50
27065,065,27,2021,16170,191,0,191,147,218
27065,065,27,2022,16449,327,0,327,166,218
27065,065,27,2023,16602,199,0,199,164,209
27067,067,27,2020,43722,-71,1,-70,160,97
27067,067,27,2021,43809,-72,85,13,521,478
27067,067,27,2022,43771,-318,219,-99,528,458
27067,067,27,2023,43813,-261,213,-48,527,438
27069,069,27,2020,4208,-12,0,-12,8,12
27069,069,27,2021,4178,7,3,10,35,78
27069,069,27,2022,4086,-75,8,-67,38,63
27069,069,27,2023,4060,-1,7,6,30,61
27071,071,27,2020,12031,-15,0,-15,22,39
27071,071,27,2021,11943,-3,1,-2,84,176
27071,071,27,2022,11848,-1,1,0,102,189
27071,071,27,2023,11751,-12,1,-11,100,185
27073,073,27,2020,6699,-16,0,-16,21,22
27073,073,27,2021,6700,39,5,44,73,118
27073,073,27,2022,6656,-2,0,-2,66,106
27073,073,27,2023,6630,20,0,20,58,102
27075,075,27,2020,10912,14,0,14,36,42
27075,075,27,2021,11004,167,0,167,82,153
27075,075,27,2022,10912,7,0,7,83,176
27075,075,27,2023,10855,30,0,30,83,171
27077,077,27,2020,3765,5,0,5,9,15
27077,077,27,2021,3826,76,1,77,33,46
27077,077,27,2022,3886,68,1,69,38,50
27077,077,27,2023,3778,-95,0,-95,38,50
27079,079,27,2020,28637,-38,0,-38,61,56
27079,079,27,2021,28900,226,10,236,295,276
27079,079,27,2022,29124,186,24,210,318,295
27079,079,27,2023,29255,32,63,95,320,284
27081,081,27,2020,5625,-9,0,-9,17,24
27081,081,27,2021,5576,-43,1,-42,69,78
27081,081,27,2022,5576,40,3,43,63,105
27081,081,27,2023,5521,-3,5,2,46,102
27083,083,27,2020,25423,-105,0,-105,78,59
27083,083,27,2021,25492,-33,50,17,313,275
27083,083,27,2022,25433,-280,136,-144,327,257
27083,083,27,2023,25427,-193,135,-58,294,243
27085,085,27,2020,36755,-28,0,-28,107,102
27085,085,27,2021,36815,81,5,86,359,410
27085,085,27,2022,36734,-39,29,-10,379,433
27085,085,27,2023,36785,29,51,80,380,409
27087,087,27,2020,5380,-24,0,-24,18,21
27087,087,27,2021,5403,24,0,24,81,85
27087,087,27,2022,5339,-40,2,-38,64,90
27087,087,27,2023,5280,-33,1,-32,63,90
27089,089,27,2020,9027,-6,0,-6,21,19
27089,089,27,2021,8997,-43,0,-43,104,95
27089,089,27,2022,8889,-113,2,-111,105,100
27089,089,27,2023,8810,-68,2,-66,82,96
27091,091,27,2020,19987,-34,0,-34,51,54
27091,091,27,2021,19923,-29,0,-29,228,275
27091,091,27,2022,19656,-182,1,-181,222,313
27091,091,27,2023,19657,75,8,83,222,301
27093,093,27,2020,23437,34,0,34,52,58
27093,093,27,2021,23403,-31,4,-27,243,263
27093,093,27,2022,23526,130,4,134,258,252
27093,093,27,2023,23490,-68,16,-52,259,243
27095,095,27,2020,26468,-4,0,-4,81,90
27095,095,27,2021,26913,544,2,546,275,360
27095,095,27,2022,27295,466,0,466,291,388
27095,095,27,2023,27427,214,0,214,290,373
27097,097,27,2020,34014,-24,0,-24,75,68
27097,097,27,2021,34079,124,1,125,335,414
27097,097,27,2022,34237,253,6,259,345,432
27097,097,27,2023,34250,75,4,79,344,409
27099,099,27,2020,40059,-20,2,-18,128,92
27099,099,27,2021,40219,-28,110,82,474,420
27099,099,27,2022,40050,-394,192,-202,496,466
27099,099,27,2023,40058,-278,227,-51,499,441
27101,101,27,2020,8166,-8,0,-8,19,12
27101,101,27,2021,8133,-21,1,-20,76,93
27101,101,27,2022,8040,-65,9,-56,74,112
27101,101,27,2023,8049,50,9,59,60,109
27103,103,27,2020,34494,33,0,33,87,83
27103,103,27,2021,34348,-221,24,-197,315,267
27103,103,27,2022,34343,-72,63,-9,323,306
27103,103,27,2023,34242,-191,58,-133,325,293
27105,105,27,2020,22205,-114,2,-112,84,46
27105,105,27,2021,22070,-362,70,-292,376,213
27105,105,27,2022,21958,-430,136,-294,359,190
27105,105,27,2023,21727,-492,135,-357,309,183
27107,107,27,2020,6436,-9,0,-9,20,18
27107,107,27,2021,6441,14,2,16,68,82
27107,107,27,2022,6371,-65,7,-58,73,87
27107,107,27,2023,6329,-19,9,-10,55,86
27109,109,27,2020,163037,-38,8,-30,482,328
27109,109,27,2021,163742,-380,269,-111,1947,1242
27109,109,27,2022,164036,-957,581,-376,2023,1316
27109,109,27,2023,164784,-596,565,-31,2010,1237
27111,111,27,2020,60099,34,0,34,150,188
27111,111,27,2021,60231,295,8,303,580,775
27111,111,27,2022,60544,475,15,490,641,813
27111,111,27,2023,60626,196,20,216,623,755
27113,113,27,2020,13943,-47,0,-47,30,25
27113,113,27,2021,13781,-143,1,-142,135,156
27113,113,27,2022,13816,41,4,45,154,161
27113,113,27,2023,13714,-97,9,-88,139,152
27115,115,27,2020,28899,28,0,28,61,85
27115,115,27,2021,29414,608,2,610,260,339
27115,115,27,2022,29533,222,17,239,301,402
27115,115,27,2023,30197,732,14,746,300,386
27117,117,27,2020,9417,-15,0,-15,38,25
27117,117,27,2021,9354,-80,15,-65,131,128
27117,117,27,2022,9327,-37,13,-24,131,134
27117,117,27,2023,9245,-73,19,-54,106,133
27119,119,27,2020,31076,-106,0,-106,90,83
27119,119,27,2021,30819,-245,21,-224,370,408
27119,119,27,2022,30725,-103,54,-49,352,388
27119,119,27,2023,30412,-288,55,-233,292,373
27121,121,27,2020,11325,23,0,23,30,33
27121,121,27,2021,11410,97,4,101,120,138
27121,121,27,2022,11420,29,9,38,126,150
27121,121,27,2023,11400,-7,9,2,126,147
27123,123,27,2020,551716,-1271,100,-1171,1810,1321
27123,123,27,2021,544025,-10014,954,-9060,6627,5023
27123,123,27,2022,537303,-11214,2711,-8503,6679,5165
27123,123,27,2023,536075,-5799,2641,-3158,6677,4716
27125,125,27,2020,3938,1,0,1,12,9
27125,125,27,2021,3945,-13,0,-13,54,35
27125,125,27,2022,3881,-71,0,-71,51,44
27125,125,27,2023,3911,29,0,29,46,43
27127,127,27,2020,15418,-24,0,-24,56,41
27127,127,27,2021,15388,-18,4,-14,185,206
27127,127,27,2022,15358,-39,10,-29,194,189
27127,127,27,2023,15288,-86,8,-78,190,183
27129,129,27,2020,14694,-27,0,-27,34,36
27129,129,27,2021,14605,-39,1,-38,146,205
27129,129,27,2022,14473,-55,2,-53,134,209
27129,129,27,2023,14348,-60,6,-54,134,203
27131,131,27,2020,67102,-49,2,-47,184,149
27131,131,27,2021,67341,76,107,183,629,622
27131,131,27,2022,67523,-63,264,201,666,644
27131,131,27,2023,67948,85,268,353,671,602
27133,133,27,2020,9676,0,0,0,19,38
27133,133,27,2021,9685,32,1,33,107,135
27133,133,27,2022,9554,-95,1,-94,89,128
27133,133,27,2023,9551,55,5,60,58,121
27135,135,27,2020,15303,-21,0,-21,35,43
27135,135,27,2021,15274,-13,1,-12,161,187
27135,135,27,2022,15334,57,7,64,180,176
27135,135,27,2023,15252,-98,9,-89,176,170
27137,137,27,2020,200083,-57,0,-57,432,584
27137,137,27,2021,199521,-123,39,-84,1817,2443
27137,137,27,2022,199558,632,84,716,1848,2467
27137,137,27,2023,200514,1264,80,1344,1844,2249
27139,139,27,2020,151347,178,3,181,414,218
27139,139,27,2021,153611,1242,150,1392,1687,885
27139,139,27,2022,154423,-312,377,65,1731,945
27139,139,27,2023,155814,132,411,543,1732,888
27141,141,27,2020,97593,211,1,212,300,137
27141,141,27,2021,99211,1176,25,1201,1137,744
27141,141,27,2022,100540,879,80,959,1183,755
27141,141,27,2023,102206,1095,96,1191,1183,697
27143,143,27,2020,14793,-43,0,-43,45,33
27143,143,27,2021,14923,102,6,108,155,136
27143,143,27,2022,14928,-14,15,1,187,175
27143,143,27,2023,15084,124,16,140,186,167
27145,145,27,2020,158480,-77,9,-68,536,322
27145,145,27,2021,159204,-265,343,78,1912,1358
27145,145,27,2022,160242,-284,736,452,1979,1328
27145,145,27,2023,160977,-708,696,-12,1962,1229
27147,147,27,2020,37384,-29,0,-29,92,88
27147,147,27,2021,37427,-30,11,-19,402,357
27147,147,27,2022,37429,-60,34,-26,437,396
27147,147,27,2023,37421,-109,45,-64,435,382
27149,149,27,2020,9666,-24,0,-24,36,17
27149,149,27,2021,9689,-9,13,4,103,91
27149,149,27,2022,9615,-133,17,-116,112,75
27149,149,27,2023,9728,19,58,77,110,74
27151,151,27,2020,9800,-32,0,-32,31,27
27151,151,27,2021,9782,-20,7,-13,112,121
27151,151,27,2022,9771,-48,22,-26,113,96
27151,151,27,2023,9719,-101,26,-75,114,93
27153,153,27,2020,25294,-15,0,-15,85,46
27153,153,27,2021,25288,-71,16,-55,292,256
27153,153,27,2022,25533,132,69,201,313,257
27153,153,27,2023,25667,14,69,83,306,252
27155,155,27,2020,3354,-9,0,-9,19,12
27155,155,27,2021,3272,-53,0,-53,38,64
27155,155,27,2022,3242,4,1,5,31,65
27155,155,27,2023,3136,-71,3,-68,24,62
27157,157,27,2020,21407,20,0,20,60,62
27157,157,27,2021,21515,94,5,99,217,219
27157,157,27,2022,21652,132,8,140,228,226
27157,157,27,2023,21683,21,7,28,222,218
27159,159,27,2020,14117,42,0,42,57,43
27159,159,27,2021,14141,42,8,50,176,213
27159,159,27,2022,14236,113,20,133,191,228
27159,159,27,2023,14241,14,23,37,189,220
27161,161,27,2020,18963,-14,0,-14,50,38
27161,161,27,2021,19002,15,3,18,187,179
27161,161,27,2022,18914,-96,8,-88,197,192
27161,161,27,2023,18981,41,17,58,198,188
27163,163,27,2020,268389,541,0,541,696,485
27163,163,27,2021,272865,3608,147,3755,2681,1989
27163,163,27,2022,276169,2305,453,2758,2803,2105
27163,163,27,2023,278936,1396,527,1923,2796,1930
27165,165,27,2020,11245,-28,0,-28,49,36
27165,165,27,2021,11164,-104,11,-93,158,144
27165,165,27,2022,11106,-136,32,-104,174,131
27165,165,27,2023,11077,-181,108,-73,174,129
27167,167,27,2020,6479,-12,0,-12,13,30
27167,167,27,2021,6411,-45,0,-45,58,82
27167,167,27,2022,6358,-24,-1,-25,65,91
27167,167,27,2023,6306,-8,-1,-9,46,89
27169,169,27,2020,49647,-42,1,-41,133,120
27169,169,27,2021,49788,55,33,88,466,450
27169,169,27,2022,49469,-344,98,-246,388,447
27169,169,27,2023,49721,236,107,343,336,431
27171,171,27,2020,141883,240,1,241,452,208
27171,171,27,2021,145204,2559,37,2596,1788,1038
27171,171,27,2022,148118,2037,139,2176,1887,1136
27171,171,27,2023,151150,2079,132,2211,1890,1058
27173,173,27,2020,9495,-33,0,-33,26,19
27173,173,27,2021,9439,-64,1,-63,123,117
27173,173,27,2022,9484,37,18,55,104,109
27173,173,27,2023,9467,-28,26,-2,90,105
28001,001,28,2020,29423,-61,0,-61,78,128
28001,001,28,2021,28846,-468,57,-411,314,470
28001,001,28,2022,28517,-347,176,-171,305,464
28001,001,28,2023,28746,-126,459,333,311,416
28003,003,28,2020,34733,-11,0,-11,102,112
28003,003,28,2021,34398,-164,4,-160,388,579
28003,003,28,2022,34147,-94,9,-85,383,538
28003,003,28,2023,34135,55,22,77,383,471
28005,005,28,2020,12700,-8,0,-8,30,43
28005,005,28,2021,12622,17,1,18,120,223
28005,005,28,2022,12559,57,-1,56,113,225
28005,005,28,2023,12442,-14,2,-12,114,218
28007,007,28,2020,17818,-28,0,-28,44,85
28007,007,28,2021,17715,-9,0,-9,212,319
28007,007,28,2022,17530,-97,-1,-98,222,304
28007,007,28,2023,17359,-106,-1,-107,216,281
28009,009,28,2020,7664,25,0,25,19,26
28009,009,28,2021,7638,31,2,33,83,146
28009,009,28,2022,7556,-19,0,-19,75,133
28009,009,28,2023,7438,-66,1,-65,72,125
28011,011,28,2020,30835,-112,0,-112,98,122
28011,011,28,2021,30201,-459,-1,-460,407,575
28011,011,28,2022,29461,-672,3,-669,404,494
28011,011,28,2023,28968,-509,53,-456,407,441
28013,013,28,2020,13219,-22,0,-22,32,57
28013,013,28,2021,12961,-167,1,-166,154,243
28013,013,28,2022,12846,-46,1,-45,167,231
28013,013,28,2023,12685,-134,28,-106,166,220
28015,015,28,2020,9934,-33,0,-33,10,40
28015,015,28,2021,9822,-28,0,-28,76,165
28015,015,28,2022,9736,4,0,4,71,156
28015,015,28,2023,9535,-126,0,-126,72,147
28017,017,28,2020,17086,-17,0,-17,53,62
28017,017,28,2021,17007,-68,0,-68,224,242
28017,017,28,2022,16863,-121,-1,-122,228,247
28017,017,28,2023,16866,5,0,5,233,236
28019,019,28,2020,8211,-19,0,-19,15,33
28019,019,28,2021,8137,-31,0,-31,78,125
28019,019,28,2022,8095,-7,-2,-9,87,116
28019,019,28,2023,8088,17,-2,15,88,109
28021,021,28,2020,9097,-25,0,-25,19,32
28021,021,28,2021,8886,-186,2,-184,112,133
28021,021,28,2022,8775,-90,9,-81,105,133
28021,021,28,2023,8617,-163,20,-143,104,119
28023,023,28,2020,15545,-41,0,-41,52,74
28023,023,28,2021,15415,-43,0,-43,189,283
28023,023,28,2022,15203,-133,-1,-134,181,258
28023,023,28,2023,15228,87,-1,86,178,238
28025,025,28,2020,18622,2,0,2,51,70
28025,025,28,2021,18481,-103,0,-103,243,286
28025,025,28,2022,18311,-91,0,-91,215,287
28025,025,28,2023,18206,-48,0,-48,212,269
28027,027,28,2020,21224,-125,0,-125,67,93
28027,027,28,2021,20721,-400,1,-399,320,412
28027,027,28,2022,20235,-476,65,-411,305,392
28027,027,28,2023,20077,-289,165,-124,303,335
28029,029,28,2020,28270,-71,1,-70,81,109
28029,029,28,2021,27922,-259,24,-235,303,420
28029,029,28,2022,27712,-166,43,-123,317,396
28029,029,28,2023,27664,-96,96,0,323,368
28031,031,28,2020,18295,-7,0,-7,57,95
28031,031,28,2021,18273,29,0,29,250,316
28031,031,28,2022,18142,-65,-2,-67,250,304
28031,031,28,2023,18059,-55,-2,-57,250,276
28033,033,28,2020,186122,640,7,647,544,407
28033,033,28,2021,189004,2540,28,2568,2234,1940
28033,033,28,2022,191144,2236,38,2274,1959,2039
28033,033,28,2023,193247,1946,230,2176,1655,1712
28035,035,28,2020,78189,-52,1,-51,272,224
28035,035,28,2021,77869,-416,27,-389,982,950
28035,035,28,2022,77976,107,62,169,998,1021
28035,035,28,2023,78208,-92,200,108,1006,883
28037,037,28,2020,7665,-7,0,-7,26,35
28037,037,28,2021,7687,57,0,57,93,131
28037,037,28,2022,7611,-22,2,-20,88,143
28037,037,28,2023,7610,43,2,45,89,134
28039,039,28,2020,24364,-10,0,-10,74,55
28039,039,28,2021,24788,452,5,457,338,364
28039,039,28,2022,25199,402,12,414,372,380
28039,039,28,2023,25619,344,34,378,384,343
28041,041,28,2020,13538,-7,0,-7,38,35
28041,041,28,2021,13648,143,3,146,127,164
28041,041,28,2022,13566,-68,-2,-70,137,144
28041,041,28,2023,13601,41,-1,40,134,137
28043,043,28,2020,21577,-20,0,-20,55,89
28043,043,28,2021,21330,-118,6,-112,254,393
28043,043,28,2022,21134,-90,5,-85,243,350
28043,043,28,2023,21065,-3,13,10,232,310
28045,045,28,2020,46123,112,1,113,105,142
28045,045,28,2021,46005,125,-3,122,407,674
28045,045,28,2022,46007,256,3,259,413,654
28045,045,28,2023,46159,255,33,288,425,564
28047,047,28,2020,208809,126,13,139,573,584
28047,047,28,2021,209485,735,61,796,2429,2681
28047,047,28,2022,210443,1213,152,1365,2422,2774
28047,047,28,2023,210612,-450,497,47,2435,2308
28049,049,28,2020,226765,-923,0,-923,682,670
28049,049,28,2021,222464,-4086,62,-4024,2810,2970
28049,049,28,2022,217555,-5133,165,-4968,2741,2805
28049,049,28,2023,214870,-3581,437,-3144,2765,2302
28051,051,28,2020,16882,-64,0,-64,51,105
28051,051,28,2021,16508,-333,0,-333,241,273
28051,051,28,2022,16111,-311,0,-311,210,303
28051,051,28,2023,15777,-262,1,-261,205,279
28053,053,28,2020,7740,-40,0,-40,20,31
28053,053,28,2021,7566,-125,1,-124,91,140
28053,053,28,2022,7354,-167,1,-166,95,145
28053,053,28,2023,7216,-101,5,-96,97,138
28055,055,28,2020,1328,-7,0,-7,0,3
28055,055,28,2021,1294,-26,0,-26,10,16
28055,055,28,2022,1262,-23,0,-23,4,13
28055,055,28,2023,1256,3,0,3,4,13
28057,057,28,2020,23865,11,0,11,66,82
28057,057,28,2021,23885,119,1,120,261,374
28057,057,28,2022,23971,144,1,145,298,357
28057,057,28,2023,24093,134,4,138,301,317
28059,059,28,2020,143373,81,9,90,375,390
28059,059,28,2021,144459,1125,78,1203,1578,1753
28059,059,28,2022,144963,616,141,757,1590,1788
28059,059,28,2023,146389,978,325,1303,1634,1506
28061,061,28,2020,16350,0,0,0,51,69
28061,061,28,2021,16232,-29,0,-29,180,280
28061,061,28,2022,16077,-31,0,-31,201,315
28061,061,28,2023,16013,28,0,28,202,295
28063,063,28,2020,7245,-8,0,-8,22,26
28063,063,28,2021,7136,-59,0,-59,62,114
28063,063,28,2022,7067,-29,1,-28,66,106
28063,063,28,2023,6941,-95,3,-92,67,101
28065,065,28,2020,11269,-33,0,-33,21,37
28065,065,28,2021,11163,-41,0,-41,120,190
28065,065,28,2022,11079,6,-1,5,116,199
28065,065,28,2023,10969,-40,-1,-41,118,186
28067,067,28,2020,67163,-77,0,-77,210,226
28067,067,28,2021,66813,-307,-1,-308,887,963
28067,067,28,2022,66440,-209,-16,-225,923,1035
28067,067,28,2023,66250,-263,49,-214,920,895
28069,069,28,2020,8960,0,0,0,17,42
28069,069,28,2021,8801,-115,0,-115,77,120
28069,069,28,2022,8670,-68,-2,-70,77,134
28069,069,28,2023,8584,-34,-2,-36,77,126
28071,071,28,2020,55913,84,-2,82,109,107
28071,071,28,2021,56902,952,18,970,551,525
28071,071,28,2022,57730,689,66,755,597,520
28071,071,28,2023,58467,414,215,629,589,479
28073,073,28,2020,64389,110,2,112,174,133
28073,073,28,2021,65409,802,21,823,772,583
28073,073,28,2022,65746,176,12,188,765,577
28073,073,28,2023,66217,171,49,220,773,523
28075,075,28,2020,72675,-182,5,-177,200,321
28075,075,28,2021,71937,-464,0,-464,826,1124
28075,075,28,2022,71142,-596,35,-561,830,1063
28075,075,28,2023,70527,-610,87,-523,825,919
28077,077,28,2020,11979,-23,0,-23,35,46
28077,077,28,2021,11781,-118,0,-118,131,210
28077,077,28,2022,11761,31,-1,30,157,203
28077,077,28,2023,11741,10,-1,9,159,188
28079,079,28,2020,21246,-26,0,-26,78,80
28079,079,28,2021,21260,-14,-1,-15,331,317
28079,079,28,2022,21203,-108,56,-52,324,318
28079,079,28,2023,21258,-83,114,31,324,301
28081,081,28,2020,83323,-66,4,-62,270,259
28081,081,28,2021,83008,-247,32,-215,1047,1191
28081,081,28,2022,82824,-71,19,-52,1071,1164
28081,081,28,2023,82799,-164,61,-103,1090,1019
28083,083,28,2020,28188,-93,1,-92,105,162
28083,083,28,2021,27425,-640,10,-630,405,516
28083,083,28,2022,26664,-740,20,-720,381,442
28083,083,28,2023,26378,-320,50,-270,382,398
28085,085,28,2020,34828,-27,0,-27,92,152
28085,085,28,2021,34939,225,4,229,401,535
28085,085,28,2022,34764,-33,7,-26,403,538
28085,085,28,2023,34702,1,17,18,408,489
28087,087,28,2020,58777,-90,0,-90,184,205
28087,087,28,2021,58160,-532,4,-528,722,814
28087,087,28,2022,57671,-501,8,-493,756,751
28087,087,28,2023,57283,-481,43,-438,729,680
28089,089,28,2020,109266,78,2,80,292,299
28089,089,28,2021,109991,570,46,616,1255,1206
28089,089,28,2022,111271,1100,139,1239,1255,1170
28089,089,28,2023,112511,607,374,981,1276,1018
28091,091,28,2020,24375,-13,0,-13,58,114
28091,091,28,2021,24304,106,1,107,256,447
28091,091,28,2022,24166,-4,-1,-5,288,407
28091,091,28,2023,24224,136,-1,135,287,363
28093,093,28,2020,33781,30,0,30,99,107
28093,093,28,2021,33755,135,-1,134,409,580
28093,093,28,2022,33905,382,-6,376,364,588
28093,093,28,2023,34123,400,13,413,339,536
28095,095,28,2020,34139,-16,0,-16,116,145
28095,095,28,2021,33922,-79,0,-79,412,570
28095,095,28,2022,33568,-176,-1,-177,379,546
28095,095,28,2023,33609,158,-1,157,386,501
28097,097,28,2020,9794,-15,0,-15,34,43
28097,097,28,2021,9699,-9,0,-9,117,209
28097,097,28,2022,9563,-88,-1,-89,127,171
28097,097,28,2023,9600,69,-1,68,123,155
28099,099,28,2020,28991,-37,0,-37,104,169
28099,099,28,2021,28908,-13,1,-12,427,516
28099,099,28,2022,28804,-70,4,-66,435,463
28099,099,28,2023,28789,-41,11,-30,431,417
28101,101,28,2020,21256,-31,0,-31,77,88
28101,101,28,2021,21120,-119,0,-119,298,323
28101,101,28,2022,21023,-61,1,-60,292,322
28101,101,28,2023,21019,-6,5,-1,289,294
28103,103,28,2020,10229,-44,0,-44,45,48
28103,103,28,2021,10116,-96,0,-96,141,157
28103,103,28,2022,10000,-117,0,-117,152,154
28103,103,28,2023,9914,-94,0,-94,151,143
28105,105,28,2020,51709,-108,7,-101,130,115
28105,105,28,2021,51812,-47,56,9,491,443
28105,105,28,2022,51384,-612,114,-498,496,428
28105,105,28,2023,51203,-556,272,-284,490,393
28107,107,28,2020,33169,-61,0,-61,130,107
28107,107,28,2021,32908,-201,-5,-206,438,502
28107,107,28,2022,32592,-205,-3,-208,399,496
28107,107,28,2023,32669,151,0,151,379,453
28109,109,28,2020,56211,95,0,95,166,210
28109,109,28,2021,56480,580,2,582,562,886
28109,109,28,2022,57183,1004,2,1006,602,922
28109,109,28,2023,57978,879,45,924,650,778
28111,111,28,2020,11454,-29,0,-29,27,52
28111,111,28,2021,11500,129,0,129,120,204
28111,111,28,2022,11398,-23,0,-23,128,202
28111,111,28,2023,11315,-14,0,-14,128,196
28113,113,28,2020,40192,-77,0,-77,117,177
28113,113,28,2021,40010,-114,1,-113,510,598
28113,113,28,2022,39687,-183,3,-180,508,637
28113,113,28,2023,39394,-241,6,-235,516,576
28115,115,28,2020,31192,10,0,10,92,104
28115,115,28,2021,31325,143,3,146,422,452
28115,115,28,2022,31367,80,12,92,419,451
28115,115,28,2023,31535,127,39,166,415,414
28117,117,28,2020,24971,-9,3,-6,61,97
28117,117,28,2021,24962,72,12,84,288,397
28117,117,28,2022,24891,-16,44,28,282,368
28117,117,28,2023,25135,193,101,294,285,336
28119,119,28,2020,6159,-4,0,-4,13,29
28119,119,28,2021,5900,-178,1,-177,82,156
28119,119,28,2022,5674,-165,2,-163,61,130
28119,119,28,2023,5546,-65,4,-61,59,127
28121,121,28,2020,157162,29,0,29,401,352
28121,121,28,2021,158123,908,12,920,1678,1719
28121,121,28,2022,158978,725,76,801,1720,1584
28121,121,28,2023,160417,826,223,1049,1740,1341
28123,123,28,2020,27974,-61,1,-60,130,88
28123,123,28,2021,27603,-459,20,-439,478,401
28123,123,28,2022,27560,-132,43,-89,444,396
28123,123,28,2023,27507,-280,140,-140,445,356
28125,125,28,2020,3772,-31,0,-31,17,12
28125,125,28,2021,3626,-89,0,-89,46,99
28125,125,28,2022,3462,-133,0,-133,43,78
28125,125,28,2023,3336,-91,0,-91,43,78
28127,127,28,2020,25901,-39,1,-38,67,88
28127,127,28,2021,25702,-91,5,-86,314,438
28127,127,28,2022,25623,1,5,6,333,404
28127,127,28,2023,25715,99,13,112,341,361
28129,129,28,2020,14193,-10,0,-10,39,46
28129,129,28,2021,14191,28,0,28,182,220
28129,129,28,2022,14082,-58,0,-58,180,224
28129,129,28,2023,14099,41,1,42,180,203
28131,131,28,2020,18335,9,0,9,45,61
28131,131,28,2021,18578,321,1,322,199,272
28131,131,28,2022,18641,135,0,135,209,282
28131,131,28,2023,18756,152,2,154,213,251
28133,133,28,2020,25856,-80,0,-80,67,99
28133,133,28,2021,25329,-355,1,-354,275,447
28133,133,28,2022,24837,-376,-2,-378,277,395
28133,133,28,2023,24468,-334,37,-297,285,359
28135,135,28,2020,12648,-47,0,-47,31,46
28135,135,28,2021,12305,-250,2,-248,123,211
28135,135,28,2022,12067,-180,4,-176,133,195
28135,135,28,2023,11837,-200,25,-175,134,189
28137,137,28,2020,28121,61,0,61,77,89
28137,137,28,2021,28103,97,1,98,329,462
28137,137,28,2022,28259,267,-4,263,309,413
28137,137,28,2023,28261,87,9,96,292,389
28139,139,28,2020,21742,-54,0,-54,57,80
28139,139,28,2021,21625,-41,2,-39,245,335
28139,139,28,2022,21438,-104,5,-99,251,333
28139,139,28,2023,21287,-118,18,-100,255,306
28141,141,28,2020,18846,7,0,7,57,76
28141,141,28,2021,18734,79,-1,78,189,385
28141,141,28,2022,18621,87,-4,83,203,392
28141,141,28,2023,18507,32,-2,30,205,350
28143,143,28,2020,9733,-61,0,-61,40,29
28143,143,28,2021,9642,-65,0,-65,127,157
28143,143,28,2022,9407,-185,0,-185,118,165
28143,143,28,2023,9234,-125,0,-125,111,159
28145,145,28,2020,27822,21,0,21,80,80
28145,145,28,2021,28033,199,8,207,371,381
28145,145,28,2022,28132,121,6,127,358,378
28145,145,28,2023,28284,133,14,147,358,355
28147,147,28,2020,13871,4,0,4,32,51
28147,147,28,2021,13830,17,-1,16,166,231
28147,147,28,2022,13824,56,-1,55,176,228
28147,147,28,2023,13863,65,20,85,177,223
28149,149,28,2020,44544,-139,1,-138,121,141
28149,149,28,2021,43430,-882,14,-868,484,699
28149,149,28,2022,42635,-689,26,-663,506,652
28149,149,28,2023,42298,-328,70,-258,501,582
28151,151,28,2020,44640,-229,0,-229,140,173
28151,151,28,2021,43626,-749,0,-749,564,808
28151,151,28,2022,42524,-975,-1,-976,553,712
28151,151,28,2023,41946,-516,-1,-517,565,631
28153,153,28,2020,19808,25,0,25,68,66
28153,153,28,2021,19669,-121,2,-119,268,294
28153,153,28,2022,19583,-56,15,-41,261,301
28153,153,28,2023,19703,106,35,141,260,278
28155,155,28,2020,9902,0,0,0,29,54
28155,155,28,2021,9970,122,-1,121,126,181
28155,155,28,2022,9944,51,0,51,132,205
28155,155,28,2023,9988,100,0,100,132,189
28157,157,28,2020,8526,-42,0,-42,15,31
28157,157,28,2021,8305,-156,0,-156,80,142
28157,157,28,2022,8203,-72,0,-72,93,121
28157,157,28,2023,8058,-126,0,-126,100,117
28159,159,28,2020,17690,-18,0,-18,51,58
28159,159,28,2021,17580,7,-1,6,218,346
28159,159,28,2022,17504,28,-1,27,205,298
28159,159,28,2023,17416,-16,4,-12,201,277
28161,161,28,2020,12438,-18,0,-18,36,65
28161,161,28,2021,12439,53,0,53,166,222
28161,161,28,2022,12413,40,0,40,139,197
28161,161,28,2023,12386,27,0,27,136,189
28163,163,28,2020,26676,-74,1,-73,85,89
28163,163,28,2021,26424,-205,-1,-206,308,365
28163,163,28,2022,25893,-462,-3,-465,291,366
28163,163,28,2023,25796,-72,21,-51,289,335
29001,001,29,2020,25268,-61,4,-57,64,52
29001,001,29,2021,25188,-153,54,-99,288,280
29001,001,29,2022,25151,-147,124,-23,273,278
29001,001,29,2023,25122,-150,101,-49,275,256
29003,003,29,2020,18103,-28,0,-28,37,38
29003,003,29,2021,18015,-56,0,-56,162,205
29003,003,29,2022,18016,36,0,36,171,194
29003,003,29,2023,18127,127,0,127,169,183
29005,005,29,2020,5306,8,0,8,14,20
29005,005,29,2021,5210,-32,0,-32,39,103
29005,005,29,2022,5161,7,0,7,42,95
29005,005,29,2023,5107,-7,0,-7,46,93
29007,007,29,2020,24786,-120,0,-120,60,89
29007,007,29,2021,24861,110,4,114,307,356
29007,007,29,2022,24482,-352,1,-351,287,338
29007,007,29,2023,24394,-47,0,-47,287,331
29009,009,29,2020,34544,17,0,17,91,106
29009,009,29,2021,34762,326,0,326,425,538
29009,009,29,2022,34944,297,1,298,404,522
29009,009,29,2023,35265,400,2,402,407,488
29011,011,29,2020,11623,-14,0,-14,40,41
29011,011,29,2021,11665,59,0,59,136,158
29011,011,29,2022,11695,72,-1,71,131,172
29011,011,29,2023,11731,72,-1,71,133,166
29013,013,29,2020,16053,14,0,14,50,54
29013,013,29,2021,16095,82,1,83,183,230
29013,013,29,2022,16170,151,4,155,175,252
29013,013,29,2023,16242,131,4,135,179,242
29015,015,29,2020,19422,88,0,88,45,95
29015,015,29,2021,19934,760,-1,759,147,355
29015,015,29,2022,20233,494,-5,489,158,374
29015,015,29,2023,20552,529,-5,524,159,362
29017,017,29,2020,10562,-7,0,-7,30,38
29017,017,29,2021,10586,59,0,59,135,175
29017,017,29,2022,10531,-15,0,-15,130,164
29017,017,29,2023,10544,41,0,41,130,158
29019,019,29,2020,184047,143,22,165,521,316
29019,019,29,2021,186115,1134,327,1461,1924,1410
29019,019,29,2022,187721,313,901,1214,1960,1456
29019,019,29,2023,189463,424,697,1121,1954,1339
29021,021,29,2020,84467,-346,3,-343,282,220
29021,021,29,2021,83623,-755,49,-706,1049,1203
29021,021,29,2022,82891,-764,153,-611,987,1112
29021,021,29,2023,82956,-58,151,93,989,1018
29023,023,29,2020,42070,-68,0,-68,128,130
29023,023,29,2021,42170,232,3,235,563,721
29023,023,29,2022,42166,208,4,212,508,713
29023,023,29,2023,41948,-72,1,-71,513,661
29025,025,29,2020,8822,5,0,5,25,22
29025,025,29,2021,8904,111,1,112,97,128
29025,025,29,2022,8939,69,3,72,103,135
29025,025,29,2023,8955,43,3,46,102,131
29027,027,29,2020,44340,18,0,18,140,119
29027,027,29,2021,44640,367,6,373,444,532
29027,027,29,2022,44723,162,6,168,458,517
29027,027,29,2023,44731,35,1,36,460,487
29029,029,29,2020,42806,123,0,123,89,138
29029,029,29,2021,43507,1072,-1,1071,363,685
29029,029,29,2022,43760,522,0,522,364,656
29029,029,29,2023,44044,506,-2,504,366,588
29031,031,29,2020,81821,79,6,85,234,231
29031,031,29,2021,82132,386,52,438,870,1042
29031,031,29,2022,82931,752,115,867,898,948
29031,031,29,2023,82984,-60,83,23,897,871
29033,033,29,2020,8466,-25,0,-25,18,22
29033,033,29,2021,8398,-27,1,-26,93,139
29033,033,29,2022,8420,58,-1,57,87,116
29033,033,29,2023,8391,-1,-2,-3,88,114
29035,035,29,2020,5202,9,0,9,15,22
29035,035,29,2021,5321,147,0,147,76,100
29035,035,29,2022,5254,-62,-1,-63,88,92
29035,035,29,2023,5303,55,-1,54,84,89
29037,037,29,2020,108161,290,0,290,297,255
29037,037,29,2021,109780,1707,-7,1700,1119,1192
29037,037,29,2022,110357,765,0,765,1153,1299
29037,037,29,2023,111732,1356,-7,1349,1199,1170
29039,039,29,2020,14212,16,0,16,50,41
29039,039,29,2021,14515,335,0,335,194,217
29039,039,29,2022,14601,114,-1,113,213,238
29039,039,29,2023,14672,84,-1,83,213,226
29041,041,29,2020,7386,-19,0,-19,21,25
29041,041,29,2021,7361,29,2,31,74,134
29041,041,29,2022,7395,76,6,82,76,122
29041,041,29,2023,7399,41,6,47,76,119
29043,043,29,2020,89285,382,3,385,227,166
29043,043,29,2021,91616,2217,46,2263,1032,911
29043,043,29,2022,93122,1364,75,1439,1049,965
29043,043,29,2023,94422,1074,54,1128,1045,867
29045,045,29,2020,6660,6,0,6,25,10
29045,045,29,2021,6735,103,0,103,79,105
29045,045,29,2022,6715,8,0,8,73,98
29045,045,29,2023,6641,-63,0,-63,81,94
29047,047,29,2020,254137,488,5,493,736,464
29047,047,29,2021,255871,707,177,884,2981,2314
29047,047,29,2022,256930,118,470,588,2960,2346
29047,047,29,2023,259772,1544,378,1922,2984,2072
29049,049,29,2020,21209,25,0,25,67,63
29049,049,29,2021,21213,95,0,95,209,305
29049,049,29,2022,21303,128,-2,126,232,263
29049,049,29,2023,21548,272,-2,270,232,254
29051,051,29,2020,76621,-570,3,-567,195,159
29051,051,29,2021,76603,-31,26,-5,818,889
29051,051,29,2022,76956,281,113,394,814,815
29051,051,29,2023,77278,171,92,263,812,752
29053,053,29,2020,16646,-367,0,-367,47,46
29053,053,29,2021,16676,43,1,44,192,216
29053,053,29,2022,16763,135,1,136,182,225
29053,053,29,2023,16947,212,0,212,184,210
29055,055,29,2020,23035,-2,0,-2,56,76
29055,055,29,2021,22820,-89,1,-88,246,384
29055,055,29,2022,22659,0,3,3,241,393
29055,055,29,2023,22719,193,7,200,237,377
29057,057,29,2020,7584,19,0,19,16,19
29057,057,29,2021,7596,83,0,83,70,140
29057,057,29,2022,7665,129,2,131,60,124
29057,057,29,2023,7716,113,2,115,61,125
29059,059,29,2020,17128,62,0,62,64,62
29059,059,29,2021,17336,331,12,343,205,332
29059,059,29,2022,17587,296,10,306,211,275
29059,059,29,2023,17768,218,8,226,211,255
29061,061,29,2020,8430,-3,0,-3,26,24
29061,061,29,2021,8400,-37,0,-37,111,106
29061,061,29,2022,8457,56,1,57,114,109
29061,061,29,2023,8551,83,1,84,115,104
29063,063,29,2020,11599,686,0,686,24,31
29063,063,29,2021,11690,159,-1,158,91,158
29063,063,29,2022,11310,-355,-6,-361,93,140
29063,063,29,2023,9899,-1382,-6,-1388,97,134
29065,065,29,2020,14387,0,0,0,34,65
29065,065,29,2021,14454,159,1,160,160,253
29065,065,29,2022,14488,158,-2,156,150,273
29065,065,29,2023,14647,271,-2,269,149,257
29067,067,29,2020,11606,37,0,37,38,42
29067,067,29,2021,11749,227,-1,226,137,218
29067,067,29,2022,11981,309,5,314,147,232
29067,067,29,2023,12228,310,4,314,147,211
29069,069,29,2020,28217,-47,0,-47,90,112
29069,069,29,2021,27743,-286,6,-280,365,561
29069,069,29,2022,27411,-161,3,-158,345,515
29069,069,29,2023,27032,-256,8,-248,349,480
29071,071,29,2020,104864,162,0,162,268,276
29071,071,29,2021,105307,653,9,662,1090,1355
29071,071,29,2022,105793,779,20,799,1118,1403
29071,071,29,2023,106404,754,15,769,1090,1245
29073,073,29,2020,14763,-6,0,-6,28,56
29073,073,29,2021,14780,150,0,150,149,285
29073,073,29,2022,14772,99,-1,98,148,251
29073,073,29,2023,14705,24,-1,23,145,234
29075,075,29,2020,6132,-14,0,-14,19,34
29075,075,29,2021,6184,73,0,73,77,100
29075,075,29,2022,6274,116,1,117,78,105
29075,075,29,2023,6287,29,1,30,78,94
29077,077,29,2020,299328,283,5,288,791,728
29077,077,29,2021,301098,1869,153,2022,3206,3588
29077,077,29,2022,303197,2101,469,2570,3264,3707
29077,077,29,2023,304611,1024,363,1387,3262,3247
29079,079,29,2020,9754,-42,0,-42,30,36
29079,079,29,2021,9757,20,2,22,126,152
29079,079,29,2022,9844,97,8,105,141,158
29079,079,29,2023,9815,-23,6,-17,143,154
29081,081,29,2020,8163,2,0,2,21,26
29081,081,29,2021,8184,41,0,41,98,122
29081,081,29,2022,8217,65,4,69,83,114
29081,081,29,2023,8220,25,7,32,84,112
29083,083,29,2020,21976,43,0,43,57,71
29083,083,29,2021,22208,352,3,355,236,352
29083,083,29,2022,22421,310,5,315,254,357
29083,083,29,2023,22485,157,2,159,249,343
29085,085,29,2020,8299,42,0,42,20,33
29085,085,29,2021,8572,395,0,395,92,194
29085,085,29,2022,8575,115,1,116,81,204
29085,085,29,2023,8718,237,1,238,92,188
29087,087,29,2020,4189,-28,0,-28,4,14
29087,087,29,2021,4232,90,0,90,41,88
29087,087,29,2022,4254,54,7,61,46,82
29087,087,29,2023,4248,19,6,25,46,76
29089,089,29,2020,10157,0,0,0,30,30
29089,089,29,2021,10145,6,0,6,90,115
29089,089,29,2022,10179,71,1,72,96,132
29089,089,29,2023,10101,-47,1,-46,95,127
29091,091,29,2020,39799,63,0,63,114,136
29091,091,29,2021,40016,372,0,372,478,642
29091,091,29,2022,40623,815,-6,809,444,668
29091,091,29,2023,40735,301,-8,293,445,624
29093,093,29,2020,9511,5,0,5,18,47
29093,093,29,2021,9429,-4,2,-2,93,180
29093,093,29,2022,9413,89,6,95,87,192
29093,093,29,2023,9440,123,6,129,86,186
29095,095,29,2020,717615,-288,31,-257,2230,1842
29095,095,29,2021,717875,-1707,639,-1068,8477,7681
29095,095,29,2022,716218,-3111,1600,-1511,8400,8148
29095,095,29,2023,718560,-385,1262,877,8531,7078
29097,097,29,2020,122907,26,7,33,384,316
29097,097,29,2021,123324,294,79,373,1515,1558
29097,097,29,2022,124016,591,162,753,1581,1601
29097,097,29,2023,125056,763,119,882,1579,1428
29099,099,29,2020,226937,262,0,262,626,586
29099,099,29,2021,227993,1069,27,1096,2358,2520
29099,099,29,2022,229220,1543,52,1595,2366,2657
29099,099,29,2023,231230,2022,37,2059,2281,2327
29101,101,29,2020,54031,-78,5,-73,193,119
29101,101,29,2021,54194,-53,17,-36,690,532
29101,101,29,2022,54449,3,120,123,709,544
29101,101,29,2023,54962,181,112,293,712,494
29103,103,29,2020,3739,-6,0,-6,14,11
29103,103,29,2021,3785,65,0,65,40,57
29103,103,29,2022,3777,6,0,6,46,60
29103,103,29,2023,3723,-39,0,-39,47,62
29105,105,29,2020,36043,-2,0,-2,103,103
29105,105,29,2021,36156,158,0,158,472,537
29105,105,29,2022,36345,266,13,279,471,552
29105,105,29,2023,36680,348,10,358,470,494
29107,107,29,2020,33055,60,0,60,92,87
29107,107,29,2021,32834,-122,1,-121,364,477
29107,107,29,2022,32967,256,-1,255,359,469
29107,107,29,2023,33196,313,-2,311,355,436
29109,109,29,2020,38000,-37,0,-37,127,104
29109,109,29,2021,38268,366,4,370,486,597
29109,109,29,2022,38689,504,8,512,495,580
29109,109,29,2023,38872,212,6,218,494,527
29111,111,29,2020,10037,5,0,5,23,26
29111,111,29,2021,9994,-8,1,-7,94,132
29111,111,29,2022,9886,-43,4,-39,85,150
29111,111,29,2023,9818,-21,2,-19,96,144
29113,113,29,2020,59854,224,0,224,178,122
29113,113,29,2021,61640,1680,0,1680,761,604
29113,113,29,2022,63182,1272,19,1291,830,631
29113,113,29,2023,64699,1273,22,1295,813,592
29115,115,29,2020,11858,-11,0,-11,28,35
29115,115,29,2021,11842,53,0,53,132,207
29115,115,29,2022,11826,44,0,44,134,189
29115,115,29,2023,11791,5,0,5,135,175
29117,117,29,2020,13985,-453,0,-453,38,33
29117,117,29,2021,14191,266,9,275,170,233
29117,117,29,2022,14335,189,8,197,156,225
29117,117,29,2023,14557,274,5,279,156,212
29119,119,29,2020,23280,-31,1,-30,78,72
29119,119,29,2021,23429,75,43,118,320,307
29119,119,29,2022,23593,41,117,158,324,305
29119,119,29,2023,23903,175,89,264,342,299
29121,121,29,2020,15196,2,0,2,38,57
29121,121,29,2021,15178,41,6,47,183,256
29121,121,29,2022,15076,-47,4,-43,173,229
29121,121,29,2023,15161,120,5,125,173,213
29123,123,29,2020,12626,14,0,14,20,36
29123,123,29,2021,12664,131,-1,130,137,230
29123,123,29,2022,12757,159,14,173,128,212
29123,123,29,2023,12698,11,10,21,127,208
29125,125,29,2020,8451,19,0,19,34,29
29125,125,29,2021,8417,12,5,17,83,141
29125,125,29,2022,8432,47,8,55,97,135
29125,125,29,2023,8430,29,6,35,97,133
29127,127,29,2020,28486,-34,0,-34,68,80
29127,127,29,2021,28556,76,7,83,352,383
29127,127,29,2022,28489,6,28,34,323,408
29127,127,29,2023,28336,-126,22,-104,339,387
29129,129,29,2020,3513,-15,0,-15,13,20
29129,129,29,2021,3481,-24,1,-23,48,57
29129,129,29,2022,3466,-12,3,-9,49,52
29129,129,29,2023,3469,-4,6,2,51,50
29131,131,29,2020,24775,43,0,43,74,72
29131,131,29,2021,24941,218,1,219,293,352
29131,131,29,2022,25403,502,-3,499,304,356
29131,131,29,2023,25590,203,-3,200,305,320
29133,133,29,2020,12125,-359,0,-359,37,39
29133,133,29,2021,12105,85,0,85,123,231
29133,133,29,2022,11665,-386,0,-386,140,222
29133,133,29,2023,11822,226,0,226,144,214
29135,135,29,2020,15212,-211,0,-211,50,51
29135,135,29,2021,15310,68,1,69,201,182
29135,135,29,2022,15260,-70,4,-66,201,185
29135,135,29,2023,15256,-27,4,-23,199,179
29137,137,29,2020,8687,20,0,20,24,19
29137,137,29,2021,8701,63,1,64,89,141
29137,137,29,2022,8635,-40,8,-32,92,123
29137,137,29,2023,8698,89,7,96,93,123
29139,139,29,2020,11281,-33,0,-33,40,39
29139,139,29,2021,11433,223,0,223,118,183
29139,139,29,2022,11479,107,0,107,125,188
29139,139,29,2023,11459,44,0,44,123,188
29141,141,29,2020,20995,15,0,15,54,78
29141,141,29,2021,21430,527,0,527,272,340
29141,141,29,2022,21786,426,-3,423,259,343
29141,141,29,2023,21970,248,-3,245,260,322
29143,143,29,2020,16325,-68,0,-68,42,72
29143,143,29,2021,16035,-172,-1,-173,215,330
29143,143,29,2022,15710,-211,-2,-213,190,307
29143,143,29,2023,15424,-174,-2,-176,188,296
29145,145,29,2020,58692,16,1,17,168,155
29145,145,29,2021,59440,840,32,872,676,798
29145,145,29,2022,60096,646,153,799,696,823
29145,145,29,2023,60677,525,122,647,692,753
29147,147,29,2020,20997,-217,0,-217,64,34
29147,147,29,2021,20983,-50,-1,-51,223,199
29147,147,29,2022,20715,-343,31,-312,213,185
29147,147,29,2023,20695,-80,25,-55,214,179
29149,149,29,2020,8608,-13,0,-13,24,39
29149,149,29,2021,8625,87,1,88,106,180
29149,149,29,2022,8703,153,1,154,109,187
29149,149,29,2023,8720,96,1,97,106,184
29151,151,29,2020,13259,-20,0,-20,32,30
29151,151,29,2021,13398,152,0,152,140,155
29151,151,29,2022,13398,8,0,8,165,165
29151,151,29,2023,13468,61,0,61,164,154
29153,153,29,2020,8517,-1,0,-1,9,43
29153,153,29,2021,8785,379,0,379,70,164
29153,153,29,2022,8954,257,4,261,75,179
29153,153,29,2023,8970,91,2,93,83,161
29155,155,29,2020,15588,-50,0,-50,53,72
29155,155,29,2021,15241,-273,0,-273,230,297
29155,155,29,2022,14865,-316,23,-293,201,294
29155,155,29,2023,14613,-164,16,-148,181,285
29157,157,29,2020,18970,8,0,8,45,43
29157,157,29,2021,18972,16,6,22,216,251
29157,157,29,2022,18878,-75,15,-60,206,235
29157,157,29,2023,18950,76,11,87,206,221
29159,159,29,2020,43006,-21,1,-20,149,116
29159,159,29,2021,43213,148,39,187,573,579
29159,159,29,2022,43397,58,104,162,575,529
29159,159,29,2023,43530,-32,87,55,581,504
29161,161,29,2020,44559,-66,4,-62,98,113
29161,161,29,2021,44899,485,84,569,402,640
29161,161,29,2022,45273,350,214,564,432,592
29161,161,29,2023,45284,-44,166,122,431,541
29163,163,29,2020,17400,-143,0,-143,46,49
29163,163,29,2021,17596,208,3,211,220,233
29163,163,29,2022,17644,82,0,82,194,222
29163,163,29,2023,17935,314,0,314,194,217
29165,165,29,2020,107193,326,3,329,296,178
29165,165,29,2021,108744,1158,95,1253,1211,929
29165,165,29,2022,110570,1315,270,1585,1191,948
29165,165,29,2023,111940,827,207,1034,1205,866
29167,167,29,2020,31617,73,0,73,95,80
29167,167,29,2021,32042,528,6,534,361,464
29167,167,29,2022,32659,631,23,654,382,430
29167,167,29,2023,32780,131,19,150,381,409
29169,169,29,2020,54010,-91,38,-53,177,89
29169,169,29,2021,53815,-432,-28,-460,699,452
29169,169,29,2022,53810,-300,59,-241,718,459
29169,169,29,2023,53812,-328,37,-291,712,418
29171,171,29,2020,4689,6,0,6,12,8
29171,171,29,2021,4695,26,0,26,60,81
29171,171,29,2022,4662,2,2,4,56,89
29171,171,29,2023,4638,-3,3,0,61,85
29173,173,29,2020,10358,6,0,6,28,32
29173,173,29,2021,10368,64,0,64,86,145
29173,173,29,2022,10410,85,1,86,98,139
29173,173,29,2023,10489,114,1,115,99,134
29175,175,29,2020,24448,-219,0,-219,60,59
29175,175,29,2021,24563,196,4,200,268,361
29175,175,29,2022,24626,150,2,152,282,358
29175,175,29,2023,24109,-480,2,-478,282,326
29177,177,29,2020,23133,-16,0,-16,63,79
29177,177,29,2021,23089,5,-1,4,274,338
29177,177,29,2022,23121,149,-2,147,250,360
29177,177,29,2023,23182,160,-2,158,245,338
29179,179,29,2020,6081,-12,0,-12,19,23
29179,179,29,2021,6084,40,0,40,63,101
29179,179,29,2022,5996,-34,-1,-35,59,109
29179,179,29,2023,5950,-2,-1,-3,59,103
29181,181,29,2020,10669,7,0,7,34,51
29181,181,29,2021,10645,20,0,20,165,217
29181,181,29,2022,10714,168,-3,165,132,232
29181,181,29,2023,10806,185,-3,182,133,220
29183,183,29,2020,406417,917,11,928,1034,885
29183,183,29,2021,410465,3375,293,3668,4073,3844
29183,183,29,2022,413798,2435,720,3155,4218,3800
29183,183,29,2023,416659,1602,550,2152,4078,3353
29185,185,29,2020,9347,86,0,86,19,34
29185,185,29,2021,9413,111,2,113,106,152
29185,185,29,2022,9595,210,5,215,115,155
29185,185,29,2023,9752,188,5,193,116,152
29186,186,29,2020,18476,-7,0,-7,48,45
29186,186,29,2021,18569,121,1,122,195,230
29186,186,29,2022,18613,111,1,112,185,247
29186,186,29,2023,18642,76,0,76,182,227
29187,187,29,2020,66443,-386,0,-386,168,178
29187,187,29,2021,67010,962,12,974,660,1062
29187,187,29,2022,66906,244,39,283,665,1006
29187,187,29,2023,67058,367,30,397,654,903
29189,189,29,2020,1003130,-776,92,-684,2600,3241
29189,189,29,2021,998439,-4563,1044,-3519,10471,12071
29189,189,29,2022,990791,-8976,2784,-6192,10428,11898
29189,189,29,2023,987059,-5574,2107,-3467,10035,10364
29195,195,29,2020,23331,-6,0,-6,64,61
29195,195,29,2021,23253,-33,21,-12,243,323
29195,195,29,2022,23003,-215,43,-172,242,319
29195,195,29,2023,23049,66,33,99,242,294
29197,197,29,2020,4006,-23,0,-23,16,15
29197,197,29,2021,4015,5,0,5,70,67
29197,197,29,2022,4000,-17,6,-11,61,62
29197,197,29,2023,4053,46,5,51,62,59
29199,199,29,2020,4707,-18,0,-18,23,13
29199,199,29,2021,4674,-37,0,-37,76,72
29199,199,29,2022,4647,-53,-1,-54,85,58
29199,199,29,2023,4676,5,-1,4,83,59
29201,201,29,2020,38020,-27,0,-27,109,125
29201,201,29,2021,37886,-77,-1,-78,487,564
29201,201,29,2022,37868,96,6,102,466,571
29201,201,29,2023,37889,73,5,78,467,526
29203,203,29,2020,7028,12,0,12,12,22
29203,203,29,2021,7090,117,0,117,90,144
29203,203,29,2022,7216,161,1,162,85,125
29203,203,29,2023,7238,59,1,60,87,124
29205,205,29,2020,6087,-4,0,-4,14,27
29205,205,29,2021,5965,-95,1,-94,59,85
29205,205,29,2022,5996,57,6,63,65,95
29205,205,29,2023,5931,-42,6,-36,65,92
29207,207,29,2020,28651,-1,0,-1,77,109
29207,207,29,2021,28519,-59,0,-59,333,425
29207,207,29,2022,28390,23,-1,22,330,466
29207,207,29,2023,28397,122,-1,121,331,447
29209,209,29,2020,31212,186,0,186,66,99
29209,209,29,2021,31592,625,-1,624,263,485
29209,209,29,2022,32134,721,15,736,273,501
29209,209,29,2023,32658,711,10,721,272,465
29211,211,29,2020,5985,-14,0,-14,19,18
29211,211,29,2021,5898,-55,4,-51,63,98
29211,211,29,2022,5816,-69,8,-61,64,85
29211,211,29,2023,5797,-11,8,-3,66,81
29213,213,29,2020,56062,15,1,16,142,160
29213,213,29,2021,56304,429,2,431,574,782
29213,213,29,2022,56749,666,-5,661,580,801
29213,213,29,2023,56775,174,-9,165,579,721
29215,215,29,2020,24324,-133,0,-133,70,82
29215,215,29,2021,24868,727,0,727,272,427
29215,215,29,2022,25304,563,-2,561,281,428
29215,215,29,2023,25619,428,-2,426,276,388
29217,217,29,2020,19670,-53,0,-53,72,52
29217,217,29,2021,19588,-23,5,-18,235,309
29217,217,29,2022,19599,109,13,122,241,342
29217,217,29,2023,19710,189,9,198,236,322
29219,219,29,2020,35732,218,0,218,87,84
29219,219,29,2021,36551,862,-1,861,388,402
29219,219,29,2022,37290,738,-1,737,445,466
29219,219,29,2023,37806,493,-1,492,440,422
29221,221,29,2020,23424,-78,0,-78,69,69
29221,221,29,2021,23392,122,0,122,248,411
29221,221,29,2022,23392,135,3,138,268,396
29221,221,29,2023,23534,241,3,244,265,366
29223,223,29,2020,10936,-13,0,-13,28,54
29223,223,29,2021,10922,99,0,99,112,224
29223,223,29,2022,10817,16,2,18,117,235
29223,223,29,2023,10811,90,2,92,116,216
29225,225,29,2020,39013,-118,0,-118,145,83
29225,225,29,2021,39601,473,12,485,556,458
29225,225,29,2022,40366,637,21,658,609,502
29225,225,29,2023,41472,945,15,960,609,464
29227,227,29,2020,1963,-8,0,-8,9,6
29227,227,29,2021,1967,16,0,16,17,29
29227,227,29,2022,1940,-4,0,-4,17,40
29227,227,29,2023,1907,-16,0,-16,23,41
29229,229,29,2020,18213,4,0,4,57,38
29229,229,29,2021,18621,468,0,468,234,279
29229,229,29,2022,19143,559,0,559,252,299
29229,229,29,2023,19403,303,-1,302,251,291
29510,510,29,2020,300496,-1049,24,-1025,915,1004
29510,510,29,2021,293622,-7331,460,-6871,3799,3602
29510,510,29,2022,286193,-8494,908,-7586,3517,3493
29510,510,29,2023,281754,-5403,698,-4705,3415,3099
30001,001,30,2020,9382,7,0,7,17,18
30001,001,30,2021,9553,204,0,204,91,120
30001,001,30,2022,9747,233,-5,228,86,129
30001,001,30,2023,9885,165,2,167,87,116
30003,003,30,2020,13080,-55,0,-55,56,41
30003,003,30,2021,12893,-131,-1,-132,171,229
30003,003,30,2022,12826,-43,-2,-45,155,170
30003,003,30,2023,12751,-68,-2,-70,155,160
30005,005,30,2020,7007,-39,0,-39,24,19
30005,005,30,2021,7003,-22,0,-22,96,80
30005,005,30,2022,6972,-34,1,-33,84,77
30005,005,30,2023,6899,-87,0,-87,84,69
30007,007,30,2020,6860,77,0,77,25,8
30007,007,30,2021,7323,482,1,483,69,64
30007,007,30,2022,7771,434,4,438,84,95
30007,007,30,2023,8032,261,2,263,84,87
30009,009,30,2020,10505,65,0,65,12,36
30009,009,30,2021,10889,421,11,432,82,110
30009,009,30,2022,11236,333,34,367,77,110
30009,009,30,2023,11419,199,12,211,76,105
30011,011,30,2020,1404,-4,0,-4,1,4
30011,011,30,2021,1413,14,0,14,9,15
30011,011,30,2022,1403,-13,0,-13,16,12
30011,011,30,2023,1418,14,0,14,14,12
30013,013,30,2020,84407,-62,5,-57,233,200
30013,013,30,2021,84551,228,2,230,923,1055
30013,013,30,2022,85001,527,21,548,950,1038
30013,013,30,2023,84900,-170,8,-162,948,886
30015,015,30,2020,5899,11,0,11,12,22
30015,015,30,2021,5921,47,1,48,38,66
30015,015,30,2022,5908,18,10,28,34,70
30015,015,30,2023,5847,-32,3,-29,34,66
30017,017,30,2020,11866,-5,0,-5,30,30
30017,017,30,2021,11961,137,1,138,107,151
30017,017,30,2022,12000,94,4,98,104,162
30017,017,30,2023,11985,29,-1,28,104,147
30019,019,30,2020,1654,-1,0,-1,2,5
30019,019,30,2021,1671,34,0,34,11,27
30019,019,30,2022,1645,-20,0,-20,15,21
30019,019,30,2023,1633,-7,0,-7,15,20
30021,021,30,2020,8924,-19,0,-19,20,21
30021,021,30,2021,8858,-18,3,-15,87,142
30021,021,30,2022,8807,4,8,12,87,147
30021,021,30,2023,8810,45,3,48,84,128
30023,023,30,2020,9420,16,0,16,14,35
30023,023,30,2021,9518,161,9,170,70,139
30023,023,30,2022,9544,65,20,85,69,127
30023,023,30,2023,9673,174,6,180,70,123
30025,025,30,2020,3029,-11,0,-11,3,10
30025,025,30,2021,3011,-31,3,-28,35,26
30025,025,30,2022,3050,42,-1,41,34,34
30025,025,30,2023,2994,-55,-1,-56,33,33
30027,027,30,2020,11475,30,1,31,29,31
30027,027,30,2021,11622,212,2,214,117,178
30027,027,30,2022,11672,117,4,121,105,176
30027,027,30,2023,11772,158,1,159,104,163
30029,029,30,2020,104876,528,1,529,281,254
30029,029,30,2021,108769,4037,95,4132,1094,1154
30029,029,30,2022,111885,2845,262,3107,1158,1277
30029,029,30,2023,113679,1643,85,1728,1157,1092
30031,031,30,2020,119597,497,7,504,287,133
30031,031,30,2021,123098,2926,131,3057,1193,651
30031,031,30,2022,124938,893,338,1231,1262,677
30031,031,30,2023,126409,686,113,799,1266,606
30033,033,30,2020,1172,-1,0,-1,4,3
30033,033,30,2021,1208,41,0,41,15,17
30033,033,30,2022,1218,9,0,9,19,18
30033,033,30,2023,1211,-8,0,-8,19,18
30035,035,30,2020,13745,-36,1,-35,45,41
30035,035,30,2021,13724,-2,0,-2,167,194
30035,035,30,2022,13650,-50,5,-45,166,187
30035,035,30,2023,13609,-36,1,-35,164,171
30037,037,30,2020,821,-1,0,-1,2,5
30037,037,30,2021,815,4,0,4,8,17
30037,037,30,2022,826,22,0,22,5,17
30037,037,30,2023,835,22,0,22,5,17
30039,039,30,2020,3312,3,0,3,7,7
30039,039,30,2021,3360,56,2,58,30,32
30039,039,30,2022,3497,134,0,134,30,39
30039,039,30,2023,3595,107,0,107,29,37
30041,041,30,2020,16271,-53,0,-53,53,36
30041,041,30,2021,16220,-121,4,-117,234,174
30041,041,30,2022,16118,-136,-3,-139,233,197
30041,041,30,2023,16276,105,-3,102,233,177
30043,043,30,2020,12142,62,0,62,34,34
30043,043,30,2021,12468,411,0,411,99,164
30043,043,30,2022,12831,410,7,417,110,176
30043,043,30,2023,13048,245,23,268,110,161
30045,045,30,2020,2020,-2,0,-2,9,2
30045,045,30,2021,2038,19,0,19,21,22
30045,045,30,2022,2079,42,0,42,19,23
30045,045,30,2023,2093,16,1,17,19,20
30047,047,30,2020,31258,136,0,136,72,81
30047,047,30,2021,32090,914,17,931,287,350
30047,047,30,2022,32853,783,16,799,308,383
30047,047,30,2023,33338,514,3,517,311,345
30049,049,30,2020,71177,173,1,174,200,170
30049,049,30,2021,72507,1362,38,1400,676,712
30049,049,30,2022,73784,1231,103,1334,700,796
30049,049,30,2023,75011,1183,36,1219,699,689
30051,051,30,2020,1954,-3,0,-3,4,3
30051,051,30,2021,1933,-27,0,-27,27,21
30051,051,30,2022,1974,36,-2,34,20,15
30051,051,30,2023,1974,-3,-2,-5,20,15
30053,053,30,2020,19734,97,2,99,34,64
30053,053,30,2021,20582,1015,20,1035,143,279
30053,053,30,2022,21510,1002,29,1031,169,337
30053,053,30,2023,21895,522,5,527,168,308
30055,055,30,2020,1728,2,0,2,3,2
30055,055,30,2021,1709,-21,0,-21,21,20
30055,055,30,2022,1711,3,0,3,26,26
30055,055,30,2023,1676,-36,0,-36,26,24
30057,057,30,2020,8661,56,2,58,15,32
30057,057,30,2021,8953,324,26,350,61,103
30057,057,30,2022,9252,287,41,328,64,111
30057,057,30,2023,9521,296,13,309,63,103
30059,059,30,2020,1920,-3,0,-3,5,7
30059,059,30,2021,1958,46,0,46,16,21
30059,059,30,2022,2026,62,0,62,22,19
30059,059,30,2023,2071,42,0,42,22,18
30061,061,30,2020,4568,43,0,43,13,14
30061,061,30,2021,4859,340,3,343,32,66
30061,061,30,2022,5020,195,4,199,34,84
30061,061,30,2023,5090,111,1,112,34,78
30063,063,30,2020,118347,347,12,359,271,212
30063,063,30,2021,119841,1308,81,1389,1083,986
30063,063,30,2022,121011,950,187,1137,1112,1104
30063,063,30,2023,121849,582,76,658,1113,940
30065,065,30,2020,4750,22,0,22,9,15
30065,065,30,2021,4908,203,0,203,42,78
30065,065,30,2022,5169,303,-1,302,39,92
30065,065,30,2023,5308,192,-1,191,39,90
30067,067,30,2020,17223,53,0,53,37,53
30067,067,30,2021,17515,374,7,381,138,213
30067,067,30,2022,17753,279,19,298,137,215
30067,067,30,2023,17903,208,4,212,138,199
30069,069,30,2020,499,3,0,3,3,1
30069,069,30,2021,518,22,0,22,7,8
30069,069,30,2022,521,0,0,0,11,8
30069,069,30,2023,554,31,0,31,11,8
30071,071,30,2020,4213,-8,0,-8,15,13
30071,071,30,2021,4210,14,0,14,38,56
30071,071,30,2022,4228,38,1,39,43,62
30071,071,30,2023,4249,32,0,32,44,55
30073,073,30,2020,5878,-18,0,-18,12,17
30073,073,30,2021,6018,141,6,147,67,69
30073,073,30,2022,6092,59,17,76,71,68
30073,073,30,2023,6125,15,6,21,71,60
30075,075,30,2020,1696,-2,0,-2,4,3
30075,075,30,2021,1710,19,0,19,14,19
30075,075,30,2022,1732,24,0,24,20,22
30075,075,30,2023,1743,15,0,15,18,22
30077,077,30,2020,6942,1,0,1,12,17
30077,077,30,2021,7025,123,0,123,42,76
30077,077,30,2022,7078,96,-1,95,41,84
30077,077,30,2023,7133,97,-1,96,41,81
30079,079,30,2020,1091,-1,0,-1,4,3
30079,079,30,2021,1097,20,0,20,3,16
30079,079,30,2022,1108,20,0,20,5,13
30079,079,30,2023,1112,9,3,12,5,12
30081,081,30,2020,44411,281,2,283,101,115
30081,081,30,2021,46084,1972,32,2004,369,604
30081,081,30,2022,47177,1257,63,1320,406,685
30081,081,30,2023,47738,719,15,734,408,581
30083,083,30,2020,11534,11,0,11,45,20
30083,083,30,2021,11329,-238,10,-228,144,114
30083,083,30,2022,11230,-172,66,-106,145,136
30083,083,30,2023,11173,-111,28,-83,144,120
30085,085,30,2020,10801,-21,0,-21,52,30
30085,085,30,2021,10788,26,4,30,169,218
30085,085,30,2022,10537,-227,12,-215,152,191
30085,085,30,2023,10319,-181,4,-177,145,185
30087,087,30,2020,8309,-26,0,-26,33,30
30087,087,30,2021,8086,-197,5,-192,122,145
30087,087,30,2022,8152,31,51,82,120,132
30087,087,30,2023,8160,-19,23,4,120,115
30089,089,30,2020,12458,78,0,78,23,33
30089,089,30,2021,12944,642,3,645,81,204
30089,089,30,2022,13384,532,9,541,109,235
30089,089,30,2023,13684,397,2,399,109,209
30091,091,30,2020,3540,-10,0,-10,11,6
30091,091,30,2021,3576,40,1,41,38,43
30091,091,30,2022,3555,6,1,7,37,63
30091,091,30,2023,3498,-33,1,-32,34,58
30093,093,30,2020,35210,86,3,89,85,97
30093,093,30,2021,35502,429,71,500,331,538
30093,093,30,2022,35947,464,158,622,352,551
30093,093,30,2023,36360,495,60,555,354,496
30095,095,30,2020,9003,54,0,54,11,23
30095,095,30,2021,9024,64,0,64,84,128
30095,095,30,2022,9169,188,-1,187,86,133
30095,095,30,2023,9173,46,-2,44,87,127
30097,097,30,2020,3670,-4,0,-4,8,11
30097,097,30,2021,3702,67,1,68,17,52
30097,097,30,2022,3727,46,1,47,24,45
30097,097,30,2023,3763,51,0,51,24,40
30099,099,30,2020,6252,24,0,24,23,21
30099,099,30,2021,6275,35,2,37,63,77
30099,099,30,2022,6346,95,5,100,64,93
30099,099,30,2023,6430,109,1,110,64,87
30101,101,30,2020,4972,-5,0,-5,16,13
30101,101,30,2021,4992,35,8,43,36,60
30101,101,30,2022,5077,64,40,104,49,73
30101,101,30,2023,5133,59,14,73,49,67
30103,103,30,2020,759,-4,0,-4,5,2
30103,103,30,2021,768,10,0,10,9,8
30103,103,30,2022,754,-14,0,-14,9,9
30103,103,30,2023,772,19,0,19,9,9
30105,105,30,2020,7556,-13,0,-13,15,22
30105,105,30,2021,7560,24,7,31,67,97
30105,105,30,2022,7542,-22,19,-3,84,96
30105,105,30,2023,7474,-72,9,-63,84,89
30107,107,30,2020,2076,13,0,13,4,11
30107,107,30,2021,2042,-20,0,-20,24,37
30107,107,30,2022,2038,4,0,4,26,34
30107,107,30,2023,2057,25,0,25,26,33
30109,109,30,2020,935,-3,0,-3,4,3
30109,109,30,2021,936,12,0,12,8,20
30109,109,30,2022,927,4,0,4,10,21
30109,109,30,2023,910,-6,0,-6,10,21
30111,111,30,2020,165218,380,7,387,463,379
30111,111,30,2021,167438,2189,106,2295,1815,1886
30111,111,30,2022,169870,2287,249,2536,1822,1981
30111,111,30,2023,170843,771,58,829,1822,1679
31001,001,31,2020,31178,-24,1,-23,97,96
31001,001,31,2021,30967,-231,34,-197,356,375
31001,001,31,2022,30947,-95,78,-17,380,379
31001,001,31,2023,30899,-181,115,-66,386,370
31003,003,31,2020,6279,-15,0,-15,27,22
31003,003,31,2021,6295,11,1,12,86,85
31003,003,31,2022,6305,1,4,5,85,77
31003,003,31,2023,6302,-19,7,-12,82,72
31005,005,31,2020,429,-1,0,-1,1,1
31005,005,31,2021,432,6,0,6,1,5
31005,005,31,2022,425,-4,0,-4,5,5
31005,005,31,2023,412,-12,0,-12,4,5
31007,007,31,2020,679,5,0,5,2,3
31007,007,31,2021,690,7,0,7,9,6
31007,007,31,2022,657,-33,0,-33,6,6
31007,007,31,2023,674,16,1,17,6,6
31009,009,31,2020,427,2,0,2,0,2
31009,009,31,2021,462,37,0,37,7,6
31009,009,31,2022,452,-9,0,-9,6,8
31009,009,31,2023,436,-14,0,-14,7,8
31011,011,31,2020,5357,-20,0,-20,19,15
31011,011,31,2021,5382,50,1,51,59,86
31011,011,31,2022,5366,-5,4,-1,66,80
31011,011,31,2023,5310,-46,4,-42,66,79
31013,013,31,2020,10828,-19,0,-19,36,30
31013,013,31,2021,10663,-170,18,-152,121,128
31013,013,31,2022,10683,15,36,51,110,134
31013,013,31,2023,10692,-10,45,35,110,136
31015,015,31,2020,1801,-4,0,-4,5,11
31015,015,31,2021,1780,3,0,3,14,38
31015,015,31,2022,1730,-26,0,-26,11,34
31015,015,31,2023,1725,25,0,25,10,39
31017,017,31,2020,2896,6,0,6,10,15
31017,017,31,2021,2913,24,-1,23,35,41
31017,017,31,2022,2883,-25,2,-23,39,46
31017,017,31,2023,2853,-29,4,-25,37,41
31019,019,31,2020,50193,12,0,12,172,91
31019,019,31,2021,50300,-102,17,-85,623,460
31019,019,31,2022,50532,62,34,96,607,445
31019,019,31,2023,50697,-64,49,-15,606,428
31021,021,31,2020,6719,5,0,5,15,26
31021,021,31,2021,6709,19,1,20,62,94
31021,021,31,2022,6770,83,1,84,64,88
31021,021,31,2023,6727,-20,1,-19,64,88
31023,023,31,2020,8360,-6,0,-6,17,26
31023,023,31,2021,8454,81,1,82,104,92
31023,023,31,2022,8443,6,0,6,101,113
31023,023,31,2023,8459,26,0,26,96,105
31025,025,31,2020,26611,10,0,10,57,68
31025,025,31,2021,27080,516,4,520,263,303
31025,025,31,2022,27152,80,13,93,263,269
31025,025,31,2023,27446,273,19,292,262,259
31027,027,31,2020,8375,-2,0,-2,24,27
31027,027,31,2021,8332,-59,1,-58,108,95
31027,027,31,2022,8366,44,0,44,99,102
31027,027,31,2023,8262,-86,0,-86,84,102
31029,029,31,2020,3888,-15,0,-15,20,11
31029,029,31,2021,3824,-50,2,-48,42,57
31029,029,31,2022,3754,-63,9,-54,42,62
31029,029,31,2023,3724,-26,12,-14,42,59
31031,031,31,2020,5452,1,0,1,12,15
31031,031,31,2021,5447,-6,0,-6,78,79
31031,031,31,2022,5485,26,0,26,79,63
31031,031,31,2023,5492,-14,0,-14,76,56
31033,033,31,2020,9483,28,0,28,20,29
31033,033,31,2021,9498,43,3,46,96,132
31033,033,31,2022,9526,38,13,51,101,120
31033,033,31,2023,9541,26,15,41,103,129
31035,035,31,2020,6100,-1,0,-1,15,14
31035,035,31,2021,6039,-41,1,-40,76,96
31035,035,31,2022,6049,9,3,12,81,82
31035,035,31,2023,6116,66,6,72,79,81
31037,037,31,2020,10557,-57,3,-54,55,20
31037,037,31,2021,10477,-224,48,-176,177,73
31037,037,31,2022,10453,-253,135,-118,159,69
31037,037,31,2023,10566,-197,220,23,158,66
31039,039,31,2020,9009,0,0,0,20,21
31039,039,31,2021,8990,-33,0,-33,129,121
31039,039,31,2022,8953,-46,8,-38,123,121
31039,039,31,2023,8918,-56,13,-43,121,113
31041,041,31,2020,10483,-35,0,-35,24,35
31041,041,31,2021,10486,12,0,12,122,137
31041,041,31,2022,10504,33,0,33,133,141
31041,041,31,2023,10581,81,0,81,130,132
31043,043,31,2020,21554,-57,2,-55,95,71
31043,043,31,2021,21282,-439,42,-397,325,187
31043,043,31,2022,21116,-426,96,-330,336,186
31043,043,31,2023,21268,-206,163,-43,375,180
31045,045,31,2020,8156,-37,0,-37,24,26
31045,045,31,2021,8149,0,0,0,79,90
31045,045,31,2022,8252,130,-2,128,76,103
31045,045,31,2023,8133,-91,-2,-93,80,105
31047,047,31,2020,24085,-70,4,-66,107,61
31047,047,31,2021,23934,-320,66,-254,354,247
31047,047,31,2022,23905,-332,186,-146,362,250
31047,047,31,2023,24085,-198,247,49,369,241
31049,049,31,2020,1831,-6,0,-6,4,3
31049,049,31,2021,1847,33,0,33,12,29
31049,049,31,2022,1901,50,0,50,18,18
31049,049,31,2023,1871,-26,0,-26,20,23
31051,051,31,2020,5595,-13,0,-13,18,20
31051,051,31,2021,5570,-21,-1,-22,67,71
31051,051,31,2022,5516,-71,20,-51,57,60
31051,051,31,2023,5491,-44,23,-21,60,63
31053,053,31,2020,37116,-46,0,-46,113,122
31053,053,31,2021,37128,21,17,38,472,519
31053,053,31,2022,37045,-95,23,-72,488,487
31053,053,31,2023,37187,63,37,100,489,448
31055,055,31,2020,585431,-175,60,-115,1965,1193
31055,055,31,2021,585452,-3734,632,-3102,7778,4906
31055,055,31,2022,586106,-3665,1562,-2103,7873,4927
31055,055,31,2023,589540,-1927,2066,139,7842,4562
31057,057,31,2020,1654,0,0,0,3,5
31057,057,31,2021,1633,-10,0,-10,12,23
31057,057,31,2022,1595,-30,0,-30,14,23
31057,057,31,2023,1561,-37,0,-37,18,15
31059,059,31,2020,5574,16,0,16,18,18
31059,059,31,2021,5559,-12,0,-12,76,82
31059,059,31,2022,5541,8,0,8,60,85
31059,059,31,2023,5548,32,0,32,61,87
31061,061,31,2020,2889,-2,0,-2,10,8
31061,061,31,2021,2878,16,0,16,25,55
31061,061,31,2022,2850,1,0,1,28,55
31061,061,31,2023,2825,0,0,0,24,49
31063,063,31,2020,2501,-11,0,-11,6,8
31063,063,31,2021,2544,53,0,53,21,28
31063,063,31,2022,2611,79,0,79,20,34
31063,063,31,2023,2585,-11,0,-11,19,32
31065,065,31,2020,4626,-9,0,-9,15,11
31065,065,31,2021,4607,-6,0,-6,50,66
31065,065,31,2022,4570,-29,3,-26,57,68
31065,065,31,2023,4556,-17,5,-12,56,57
31067,067,31,2020,21656,-21,0,-21,35,68
31067,067,31,2021,21633,44,5,49,221,305
31067,067,31,2022,21564,63,5,68,211,341
31067,067,31,2023,21634,195,9,204,206,337
31069,069,31,2020,1886,13,0,13,11,10
31069,069,31,2021,1838,-27,1,-26,15,36
31069,069,31,2022,1835,16,0,16,16,36
31069,069,31,2023,1794,-21,0,-21,17,36
31071,071,31,2020,1807,-4,0,-4,6,10
31071,071,31,2021,1833,30,0,30,25,28
31071,071,31,2022,1787,-26,0,-26,23,42
31071,071,31,2023,1763,-5,0,-5,22,40
31073,073,31,2020,1896,3,0,3,6,9
31073,073,31,2021,1829,-50,0,-50,16,30
31073,073,31,2022,1835,17,0,17,16,26
31073,073,31,2023,1847,21,0,21,17,25
31075,075,31,2020,613,1,0,1,2,1
31075,075,31,2021,577,-30,0,-30,8,12
31075,075,31,2022,584,1,0,1,10,4
31075,075,31,2023,565,-25,0,-25,8,2
31077,077,31,2020,2179,-8,0,-8,6,7
31077,077,31,2021,2181,10,0,10,21,30
31077,077,31,2022,2235,50,0,50,31,25
31077,077,31,2023,2219,-16,0,-16,26,25
31079,079,31,2020,62764,-186,3,-183,207,143
31079,079,31,2021,62075,-1006,112,-894,887,662
31079,079,31,2022,62096,-517,264,-253,921,641
31079,079,31,2023,62197,-557,333,-224,923,603
31081,081,31,2020,9400,-15,0,-15,25,34
31081,081,31,2021,9384,-10,0,-10,101,110
31081,081,31,2022,9439,66,0,66,108,113
31081,081,31,2023,9537,100,0,100,108,108
31083,083,31,2020,3057,-12,0,-12,6,11
31083,083,31,2021,3097,49,0,49,35,43
31083,083,31,2022,3032,-37,2,-35,32,62
31083,083,31,2023,3045,37,3,40,32,56
31085,085,31,2020,856,1,0,1,0,3
31085,085,31,2021,850,-14,0,-14,14,6
31085,085,31,2022,864,8,4,12,11,7
31085,085,31,2023,846,-27,7,-20,10,8
31087,087,31,2020,2618,8,0,8,8,11
31087,087,31,2021,2599,-1,0,-1,31,50
31087,087,31,2022,2614,32,0,32,30,46
31087,087,31,2023,2552,-47,0,-47,29,45
31089,089,31,2020,10096,-30,0,-30,36,25
31089,089,31,2021,10052,-38,10,-28,118,137
31089,089,31,2022,10013,-52,22,-30,120,128
31089,089,31,2023,10093,39,35,74,129,123
31091,091,31,2020,705,-4,0,-4,1,1
31091,091,31,2021,732,32,0,32,7,9
31091,091,31,2022,682,-43,0,-43,7,16
31091,091,31,2023,679,2,0,2,6,11
31093,093,31,2020,6483,18,0,18,18,24
31093,093,31,2021,6521,36,1,37,78,80
31093,093,31,2022,6509,-2,2,0,78,89
31093,093,31,2023,6527,23,6,29,78,89
31095,095,31,2020,7259,24,0,24,26,31
31095,095,31,2021,7159,-64,3,-61,75,114
31095,095,31,2022,7140,29,5,34,78,125
31095,095,31,2023,7054,-46,5,-41,78,124
31097,097,31,2020,5294,3,0,3,15,13
31097,097,31,2021,5314,54,2,56,41,74
31097,097,31,2022,5245,-44,7,-37,37,67
31097,097,31,2023,5198,-26,9,-17,37,67
31099,099,31,2020,6688,7,0,7,17,19
31099,099,31,2021,6683,-35,8,-27,85,64
31099,099,31,2022,6706,-1,16,15,77,67
31099,099,31,2023,6770,32,24,56,80,73
31101,101,31,2020,8322,-5,0,-5,16,16
31101,101,31,2021,8253,-24,0,-24,81,128
31101,101,31,2022,8179,-17,0,-17,76,133
31101,101,31,2023,8113,-16,0,-16,81,130
31103,103,31,2020,760,-5,0,-5,1,4
31103,103,31,2021,796,32,0,32,10,5
31103,103,31,2022,805,8,0,8,7,5
31103,103,31,2023,805,1,0,1,5,6
31105,105,31,2020,3412,-18,0,-18,10,17
31105,105,31,2021,3411,26,2,28,29,60
31105,105,31,2022,3336,-59,5,-54,25,46
31105,105,31,2023,3289,-32,9,-23,26,49
31107,107,31,2020,8384,-8,0,-8,26,28
31107,107,31,2021,8406,49,0,49,103,133
31107,107,31,2022,8307,-82,2,-80,98,118
31107,107,31,2023,8298,27,3,30,83,120
31109,109,31,2020,323165,64,17,81,940,602
31109,109,31,2021,323404,-1352,348,-1004,3725,2634
31109,109,31,2022,324434,-585,870,285,3653,2768
31109,109,31,2023,326716,43,1088,1131,3664,2529
31111,111,31,2020,34532,-96,0,-96,69,109
31111,111,31,2021,34074,-343,7,-336,370,491
31111,111,31,2022,33614,-306,8,-298,344,505
31111,111,31,2023,33365,-127,15,-112,343,481
31113,113,31,2020,715,-2,0,-2,3,5
31113,113,31,2021,685,-24,0,-24,5,9
31113,113,31,2022,685,-3,1,-2,7,6
31113,113,31,2023,655,-34,1,-33,6,4
31115,115,31,2020,609,-1,0,-1,2,1
31115,115,31,2021,604,-7,0,-7,5,3
31115,115,31,2022,601,-2,0,-2,3,4
31115,115,31,2023,592,-6,0,-6,3,5
31117,117,31,2020,397,-2,0,-2,0,0
31117,117,31,2021,381,-11,0,-11,3,6
31117,117,31,2022,379,-5,0,-5,4,3
31117,117,31,2023,383,-1,0,-1,4,0
31119,119,31,2020,35530,-88,0,-88,119,89
31119,119,31,2021,35395,-254,12,-242,454,354
31119,119,31,2022,35414,-73,26,-47,465,377
31119,119,31,2023,35627,80,35,115,466,368
31121,121,31,2020,7661,-2,0,-2,20,23
31121,121,31,2021,7667,18,1,19,89,107
31121,121,31,2022,7715,59,6,65,86,99
31121,121,31,2023,7755,45,8,53,86,98
31123,123,31,2020,4560,-3,0,-3,14,14
31123,123,31,2021,4569,32,1,33,52,78
31123,123,31,2022,4522,-40,6,-34,59,74
31123,123,31,2023,4504,-6,5,-1,57,74
31125,125,31,2020,3390,12,0,12,10,9
31125,125,31,2021,3375,11,0,11,40,68
31125,125,31,2022,3317,-32,0,-32,38,63
31125,125,31,2023,3274,-24,0,-24,38,57
31127,127,31,2020,7082,15,0,15,12,19
31127,127,31,2021,7004,-72,1,-71,89,96
31127,127,31,2022,7036,51,0,51,80,98
31127,127,31,2023,7076,53,1,54,82,95
31129,129,31,2020,4093,1,0,1,8,14
31129,129,31,2021,4071,12,1,13,42,78
31129,129,31,2022,4069,20,0,20,42,61
31129,129,31,2023,4095,41,0,41,43,57
31131,131,31,2020,15901,-6,0,-6,41,46
31131,131,31,2021,16017,70,25,95,194,180
31131,131,31,2022,16186,122,63,185,193,202
31131,131,31,2023,16335,71,81,152,197,200
31133,133,31,2020,2536,-5,0,-5,4,6
31133,133,31,2021,2538,21,0,21,30,48
31133,133,31,2022,2531,2,2,4,33,43
31133,133,31,2023,2512,-9,2,-7,31,43
31135,135,31,2020,2858,-4,0,-4,8,3
31135,135,31,2021,2819,-32,1,-31,30,39
31135,135,31,2022,2827,15,6,21,24,35
31135,135,31,2023,2795,-32,13,-19,24,38
31137,137,31,2020,8979,3,0,3,26,20
31137,137,31,2021,8923,-33,2,-31,108,138
31137,137,31,2022,8988,67,4,71,116,120
31137,137,31,2023,9057,60,7,67,117,114
31139,139,31,2020,7345,6,0,6,30,11
31139,139,31,2021,7319,-47,5,-42,94,80
31139,139,31,2022,7317,-23,12,-11,93,82
31139,139,31,2023,7299,-55,20,-35,93,77
31141,141,31,2020,34287,-46,3,-43,105,70
31141,141,31,2021,34295,-179,39,-140,498,365
31141,141,31,2022,34355,-184,131,-53,450,327
31141,141,31,2023,34609,-55,161,106,454,306
31143,143,31,2020,5218,18,0,18,9,23
31143,143,31,2021,5191,-8,2,-6,51,75
31143,143,31,2022,5240,54,9,63,54,67
31143,143,31,2023,5228,-4,16,12,54,76
31145,145,31,2020,10682,-21,0,-21,38,34
31145,145,31,2021,10620,-27,1,-26,123,166
31145,145,31,2022,10528,-40,1,-39,114,164
31145,145,31,2023,10457,-19,3,-16,108,163
31147,147,31,2020,7862,-3,0,-3,19,27
31147,147,31,2021,7786,1,-1,0,80,155
31147,147,31,2022,7730,0,-1,-1,71,123
31147,147,31,2023,7689,8,-1,7,71,121
31149,149,31,2020,1265,3,0,3,3,3
31149,149,31,2021,1275,7,0,7,22,19
31149,149,31,2022,1241,-25,0,-25,16,25
31149,149,31,2023,1271,39,0,39,15,25
31151,151,31,2020,14720,-61,0,-61,49,30
31151,151,31,2021,14525,-265,21,-244,193,133
31151,151,31,2022,14548,-53,43,-10,173,136
31151,151,31,2023,14555,-91,59,-32,172,134
31153,153,31,2020,191167,183,0,183,619,298
31153,153,31,2021,193826,1445,43,1488,2414,1331
31153,153,31,2022,196427,1456,201,1657,2356,1362
31153,153,31,2023,199886,2069,301,2370,2363,1278
31155,155,31,2020,22374,97,0,97,58,58
31155,155,31,2021,22832,463,1,464,281,278
31155,155,31,2022,23177,341,5,346,247,251
31155,155,31,2023,23463,280,5,285,244,241
31157,157,31,2020,36051,-33,0,-33,84,93
31157,157,31,2021,35904,-125,16,-109,469,521
31157,157,31,2022,35769,-153,44,-109,426,442
31157,157,31,2023,35699,-146,77,-69,433,434
31159,159,31,2020,17618,-10,0,-10,60,42
31159,159,31,2021,17556,-56,6,-50,170,191
31159,159,31,2022,17625,100,2,102,173,195
31159,159,31,2023,17671,63,2,65,172,191
31161,161,31,2020,5096,-17,0,-17,11,21
31161,161,31,2021,5083,15,1,16,54,85
31161,161,31,2022,5006,-56,4,-52,50,75
31161,161,31,2023,4928,-57,4,-53,46,71
31163,163,31,2020,2956,3,0,3,6,12
31163,163,31,2021,2966,23,0,23,34,46
31163,163,31,2022,3006,52,0,52,32,42
31163,163,31,2023,2983,-17,0,-17,32,39
31165,165,31,2020,1140,11,0,11,4,4
31165,165,31,2021,1146,6,1,7,9,9
31165,165,31,2022,1127,-22,4,-18,12,13
31165,165,31,2023,1154,23,5,28,12,13
31167,167,31,2020,5829,-19,0,-19,12,12
31167,167,31,2021,5837,-11,3,-8,72,58
31167,167,31,2022,5765,-83,0,-83,56,48
31167,167,31,2023,5856,77,0,77,62,46
31169,169,31,2020,5020,-7,0,-7,8,14
31169,169,31,2021,4888,-83,1,-82,46,96
31169,169,31,2022,4854,8,0,8,52,91
31169,169,31,2023,4829,13,1,14,50,88
31171,171,31,2020,671,3,0,3,2,2
31171,171,31,2021,676,3,0,3,7,5
31171,171,31,2022,665,-9,0,-9,7,10
31171,171,31,2023,677,16,0,16,8,11
31173,173,31,2020,6764,-13,0,-13,31,35
31173,173,31,2021,6633,-173,1,-172,135,87
31173,173,31,2022,6555,-124,5,-119,124,87
31173,173,31,2023,6557,-28,6,-22,132,109
31175,175,31,2020,4057,0,0,0,10,10
31175,175,31,2021,4062,15,0,15,52,64
31175,175,31,2022,4058,2,0,2,50,55
31175,175,31,2023,4012,-38,0,-38,51,57
31177,177,31,2020,20927,58,0,58,46,40
31177,177,31,2021,20991,65,3,68,202,217
31177,177,31,2022,21167,180,9,189,203,207
31177,177,31,2023,21152,-21,12,-9,205,211
31179,179,31,2020,9696,-8,0,-8,21,18
31179,179,31,2021,9864,133,2,135,106,73
31179,179,31,2022,9899,-3,9,6,107,74
31179,179,31,2023,9874,-70,10,-60,107,72
31181,181,31,2020,3392,-7,0,-7,9,9
31181,181,31,2021,3402,28,0,28,45,63
31181,181,31,2022,3339,-31,0,-31,34,65
31181,181,31,2023,3351,42,0,42,33,64
31183,183,31,2020,775,1,0,1,3,0
31183,183,31,2021,785,11,0,11,9,10
31183,183,31,2022,782,-3,0,-3,7,8
31183,183,31,2023,775,-11,0,-11,13,8
31185,185,31,2020,14102,-24,0,-24,29,27
31185,185,31,2021,14239,149,5,154,168,186
31185,185,31,2022,14312,91,10,101,159,189
31185,185,31,2023,14356,58,11,69,161,185
32001,001,32,2020,25572,72,0,72,63,78
32001,001,32,2021,25664,206,3,209,262,385
32001,001,32,2022,25798,244,-1,243,284,398
32001,001,32,2023,25803,106,-4,102,280,376
32003,003,32,2020,2274887,8305,132,8437,6084,4841
32003,003,32,2021,2295310,13721,3073,16794,25116,22508
32003,003,32,2022,2322535,16483,8621,25104,25223,23150
32003,003,32,2023,2336573,5404,3693,9097,24876,20042
32005,005,32,2020,49525,102,0,102,85,140
32005,005,32,2021,49999,785,5,790,353,652
32005,005,32,2022,49662,21,14,35,329,671
32005,005,32,2023,49545,172,-2,170,326,613
32007,007,32,2020,53664,-97,0,-97,161,94
32007,007,32,2021,53852,-102,15,-87,681,443
32007,007,32,2022,53979,32,14,46,619,515
32007,007,32,2023,54293,253,-15,238,566,495
32009,009,32,2020,734,3,0,3,0,0
32009,009,32,2021,735,14,1,15,4,15
32009,009,32,2022,747,17,1,18,4,12
32009,009,32,2023,736,-3,1,-2,3,12
32011,011,32,2020,1852,-3,0,-3,5,3
32011,011,32,2021,1908,59,2,61,18,20
32011,011,32,2022,1863,-43,7,-36,19,28
32011,011,32,2023,1917,59,6,65,18,28
32013,013,32,2020,17271,-27,0,-27,55,39
32013,013,32,2021,17632,293,6,299,212,147
32013,013,32,2022,17296,-372,21,-351,210,205
32013,013,32,2023,17136,-162,7,-155,198,202
32015,015,32,2020,5728,-5,0,-5,20,21
32015,015,32,2021,5761,36,-1,35,58,63
32015,015,32,2022,5761,14,1,15,63,76
32015,015,32,2023,5769,23,-1,22,60,74
32017,017,32,2020,4445,-50,0,-50,15,16
32017,017,32,2021,4392,-40,0,-40,48,60
32017,017,32,2022,4440,70,0,70,50,69
32017,017,32,2023,4452,51,0,51,30,69
32019,019,32,2020,59465,281,0,281,153,182
32019,019,32,2021,60961,1805,-5,1800,613,842
32019,019,32,2022,61628,897,-14,883,637,894
32019,019,32,2023,62583,1188,-30,1158,633,835
32021,021,32,2020,4554,17,0,17,10,24
32021,021,32,2021,4617,126,1,127,29,88
32021,021,32,2022,4537,-28,-1,-29,35,86
32021,021,32,2023,4528,45,-1,44,35,88
32023,023,32,2020,51963,565,0,565,93,216
32023,023,32,2021,53324,2102,-2,2100,371,1007
32023,023,32,2022,54769,2099,-5,2094,370,1111
32023,023,32,2023,55720,1592,-21,1571,368,991
32027,027,32,2020,6617,-28,0,-28,15,11
32027,027,32,2021,6427,-157,3,-154,57,83
32027,027,32,2022,6450,49,18,67,50,90
32027,027,32,2023,6364,-51,5,-46,50,90
32029,029,32,2020,4108,10,0,10,4,5
32029,029,32,2021,4142,63,0,63,26,50
32029,029,32,2022,4165,47,0,47,21,50
32029,029,32,2023,4177,45,0,45,18,49
32031,031,32,2020,487710,1037,5,1042,1241,1090
32031,031,32,2021,494300,6112,465,6577,4922,4902
32031,031,32,2022,496980,1325,1433,2758,5022,4954
32031,031,32,2023,498022,-241,613,372,5003,4333
32033,033,32,2020,9059,-15,0,-15,28,28
32033,033,32,2021,8844,-202,7,-195,82,88
32033,033,32,2022,8746,-59,-3,-62,77,108
32033,033,32,2023,8522,-178,-3,-181,67,111
32510,510,32,2020,58686,122,0,122,135,221
32510,510,32,2021,58764,566,39,605,509,1037
32510,510,32,2022,58065,-270,73,-197,529,1018
32510,510,32,2023,58036,339,18,357,524,914
33001,001,33,2020,63776,158,0,158,123,204
33001,001,33,2021,64599,1192,19,1211,466,818
33001,001,33,2022,64705,479,12,491,468,853
33001,001,33,2023,65027,717,-21,696,458,831
33003,003,33,2020,50246,212,0,212,79,130
33003,003,33,2021,51741,1862,15,1877,295,583
33003,003,33,2022,52154,684,49,733,314,660
33003,003,33,2023,52448,638,4,642,310,658
33005,005,33,2020,76547,114,0,114,154,187
33005,005,33,2021,76846,388,31,419,673,838
33005,005,33,2022,77463,738,89,827,684,900
33005,005,33,2023,77703,463,5,468,656,883
33007,007,33,2020,31227,-8,0,-8,67,97
33007,007,33,2021,31379,475,9,484,203,521
33007,007,33,2022,31476,409,27,436,227,587
33007,007,33,2023,31372,240,1,241,224,569
33009,009,33,2020,91198,109,5,114,169,220
33009,009,33,2021,90495,-613,157,-456,666,884
33009,009,33,2022,93131,2404,340,2744,697,995
33009,009,33,2023,93146,250,82,332,662,978
33011,011,33,2020,422913,-158,60,-98,1022,1107
33011,011,33,2021,424413,81,850,931,4087,3859
33011,011,33,2022,427493,944,2204,3148,4222,4090
33011,011,33,2023,427354,-956,593,-363,4170,3952
33013,013,33,2020,154038,236,12,248,326,370
33013,013,33,2021,154622,529,152,681,1320,1521
33013,013,33,2022,156459,1834,288,2122,1338,1636
33013,013,33,2023,157103,884,60,944,1298,1603
33015,015,33,2020,314621,428,9,437,680,756
33015,015,33,2021,318260,3512,173,3685,2786,2879
33015,015,33,2022,319633,1244,519,1763,2838,3063
33015,015,33,2023,320689,1053,80,1133,2877,2945
33017,017,33,2020,131068,145,2,147,304,309
33017,017,33,2021,131534,339,119,458,1193,1289
33017,017,33,2022,132571,972,243,1215,1173,1351
33017,017,33,2023,133243,787,36,823,1155,1309
33019,019,33,2020,43068,36,0,36,70,101
33019,019,33,2021,43605,696,17,713,355,517
33019,019,33,2022,43918,410,63,473,371,539
33019,019,33,2023,43969,222,19,241,345,536
34001,001,34,2020,274190,-154,3,-151,693,952
34001,001,34,2021,274956,1046,275,1321,2716,3424
34001,001,34,2022,275382,363,700,1063,2771,3233
34001,001,34,2023,275213,-881,924,43,2779,2998
34003,003,34,2020,953690,-914,127,-787,2202,3583
34003,003,34,2021,955383,-1581,1358,-223,8869,7541
34003,003,34,2022,953540,-7177,3777,-3400,9207,7554
34003,003,34,2023,957736,-2728,4778,2050,9117,6960
34005,005,34,2020,461682,107,6,113,1057,1508
34005,005,34,2021,464479,2378,247,2625,4444,4508
34005,005,34,2022,466101,1116,641,1757,4730,4541
34005,005,34,2023,469167,1751,849,2600,4731,4254
34007,007,34,2020,523122,-256,17,-239,1421,1714
34007,007,34,2021,524093,-56,439,383,5938,5761
34007,007,34,2022,524649,-840,916,76,6214,5437
34007,007,34,2023,527196,152,1171,1323,6227,5011
34009,009,34,2020,95044,-34,4,-30,196,398
34009,009,34,2021,95706,1399,15,1414,755,1471
34009,009,34,2022,95405,435,17,452,743,1458
34009,009,34,2023,94610,-188,37,-151,744,1383
34011,011,34,2020,153719,-326,3,-323,424,538
34011,011,34,2021,152083,-1588,93,-1495,1779,1908
34011,011,34,2022,151347,-999,270,-729,1830,1834
34011,011,34,2023,152326,382,447,829,1857,1717
34013,013,34,2020,859974,-1870,169,-1701,2439,3606
34013,013,34,2021,854233,-10629,2218,-8411,9423,6744
34013,013,34,2022,849724,-14082,6021,-8061,9958,6616
34013,013,34,2023,851117,-9874,7484,-2390,9950,6183
34015,015,34,2020,302563,432,2,434,674,903
34015,015,34,2021,304592,2226,87,2313,2826,3248
34015,015,34,2022,306767,2096,249,2345,3081,3093
34015,015,34,2023,308423,1178,323,1501,3057,2884
34017,017,34,2020,721879,-3062,186,-2876,2381,2478
34017,017,34,2021,703448,-24844,2980,-21864,9082,4507
34017,017,34,2022,702381,-13043,7422,-5621,9125,4292
34017,017,34,2023,705472,-10956,9343,-1613,8855,3986
34019,019,34,2020,128786,-49,0,-49,268,390
34019,019,34,2021,129671,745,73,818,969,960
34019,019,34,2022,129805,-45,160,115,1109,1039
34019,019,34,2023,130183,68,214,282,1116,1004
34021,021,34,2020,386466,-606,30,-576,1014,1327
34021,021,34,2021,382172,-5486,817,-4669,3873,3341
34021,021,34,2022,380779,-4459,2215,-2244,4126,3365
34021,021,34,2023,381671,-2892,2761,-131,4130,3145
34023,023,34,2020,861408,-1328,113,-1215,2233,2891
34023,023,34,2021,862364,-3074,1981,-1093,8399,6857
34023,023,34,2022,861094,-8712,5414,-3298,8679,6686
34023,023,34,2023,863623,-7000,7001,1,8603,6134
34025,025,34,2020,642836,-119,5,-114,1468,2251
34025,025,34,2021,646517,3531,309,3840,5937,6392
34025,025,34,2022,644228,-2871,668,-2203,6291,6283
34025,025,34,2023,642799,-2915,924,-1991,6315,5769
34027,027,34,2020,508439,-252,31,-221,1161,1869
34027,027,34,2021,510613,624,670,1294,4749,4214
34027,027,34,2022,511219,-1585,1562,-23,5038,4269
34027,027,34,2023,514423,135,2013,2148,5024,3951
34029,029,34,2020,638465,1649,5,1654,2363,2756
34029,029,34,2021,649825,9882,175,10057,9684,8203
34029,029,34,2022,655663,3575,377,3952,10239,8220
34029,029,34,2023,659197,200,628,828,10251,7528
34031,031,34,2020,523439,-1198,86,-1112,1613,2121
34031,031,34,2021,518376,-7817,1035,-6782,6141,4305
34031,031,34,2022,513634,-10032,2834,-7198,6337,4147
34031,031,34,2023,513395,-6396,3661,-2735,6332,3852
34033,033,34,2020,64841,84,0,84,167,258
34033,033,34,2021,65045,418,13,431,700,956
34033,033,34,2022,65157,266,20,286,725,867
34033,033,34,2023,65338,229,41,270,721,808
34035,035,34,2020,344754,-284,34,-250,761,1141
34035,035,34,2021,346498,499,567,1066,3026,2597
34035,035,34,2022,347047,-1310,1394,84,3202,2661
34035,035,34,2023,348842,-641,1750,1109,3190,2494
34037,037,34,2020,143915,-99,0,-99,327,547
34037,037,34,2021,145721,1856,36,1892,1341,1415
34037,037,34,2022,145575,-92,99,7,1409,1464
34037,037,34,2023,146132,392,121,513,1416,1358
34039,039,34,2020,573660,-1123,80,-1043,1626,2305
34039,039,34,2021,572833,-4193,1286,-2907,6398,4512
34039,039,34,2022,570417,-8643,3727,-4916,6636,4310
34039,039,34,2023,572726,-4975,4646,-329,6624,4013
34041,041,34,2020,109520,41,0,41,234,430
34041,041,34,2021,110567,1103,71,1174,952,1107
34041,041,34,2022,110903,434,152,586,1018,1197
34041,041,34,2023,111252,293,182,475,1016,1131
35001,001,35,2020,676853,234,75,309,1608,1699
35001,001,35,2021,675286,-1979,918,-1061,6393,7369
35001,001,35,2022,672957,-3209,2263,-946,6480,7503
35001,001,35,2023,671586,-3170,1603,-1567,6473,6250
35003,003,35,2020,3606,42,0,42,1,8
35003,003,35,2021,3710,149,7,156,14,58
35003,003,35,2022,3793,110,18,128,21,76
35003,003,35,2023,3825,68,15,83,22,73
35005,005,35,2020,65149,-14,1,-13,177,188
35005,005,35,2021,64650,-494,62,-432,784,868
35005,005,35,2022,63892,-798,143,-655,747,860
35005,005,35,2023,63561,-395,88,-307,738,764
35006,006,35,2020,27101,-68,0,-68,73,80
35006,006,35,2021,27185,187,10,197,280,398
35006,006,35,2022,26871,-194,33,-161,227,379
35006,006,35,2023,26780,33,17,50,225,368
35007,007,35,2020,12352,-25,0,-25,23,29
35007,007,35,2021,12346,109,-1,108,89,199
35007,007,35,2022,12272,8,29,37,84,187
35007,007,35,2023,12255,48,25,73,85,175
35009,009,35,2020,48370,-167,6,-161,216,111
35009,009,35,2021,47936,-729,38,-691,779,511
35009,009,35,2022,47430,-788,76,-712,782,576
35009,009,35,2023,47222,-479,53,-426,754,531
35011,011,35,2020,1681,-12,0,-12,6,7
35011,011,35,2021,1679,23,0,23,15,38
35011,011,35,2022,1692,37,0,37,14,39
35011,011,35,2023,1657,-10,0,-10,14,39
35013,013,35,2020,220060,329,36,365,560,473
35013,013,35,2021,221732,1173,303,1476,2467,2380
35013,013,35,2022,223530,1004,762,1766,2465,2365
35013,013,35,2023,225210,1049,342,1391,2285,2008
35015,015,35,2020,62333,-63,1,-62,199,135
35015,015,35,2021,60855,-1531,28,-1503,796,710
35015,015,35,2022,60203,-699,70,-629,752,793
35015,015,35,2023,60275,41,25,66,734,726
35017,017,35,2020,28205,56,0,56,59,101
35017,017,35,2021,27893,-136,16,-120,246,444
35017,017,35,2022,27693,-16,57,41,216,442
35017,017,35,2023,27472,-55,29,-26,214,405
35019,019,35,2020,4439,0,0,0,8,21
35019,019,35,2021,4423,18,0,18,29,61
35019,019,35,2022,4316,-97,22,-75,23,60
35019,019,35,2023,4292,2,10,12,23,59
35021,021,35,2020,653,3,0,3,2,4
35021,021,35,2021,631,-7,0,-7,0,15
35021,021,35,2022,621,4,1,5,0,15
35021,021,35,2023,624,18,1,19,0,15
35023,023,35,2020,4164,-19,0,-19,17,10
35023,023,35,2021,4086,-45,2,-43,26,63
35023,023,35,2022,4011,-60,6,-54,41,64
35023,023,35,2023,3965,-30,3,-27,43,61
35025,025,35,2020,74642,15,6,21,277,137
35025,025,35,2021,73062,-1992,160,-1832,1073,742
35025,025,35,2022,72343,-1446,514,-932,930,756
35025,025,35,2023,72101,-590,223,-367,810,688
35027,027,35,2020,20307,63,0,63,41,59
35027,027,35,2021,20400,201,-2,199,163,269
35027,027,35,2022,20343,91,-5,86,185,326
35027,027,35,2023,20029,-174,-11,-185,181,306
35028,028,35,2020,19418,-7,2,-5,36,37
35028,028,35,2021,19390,-141,58,-83,183,135
35028,028,35,2022,19273,-301,157,-144,170,146
35028,028,35,2023,19444,6,130,136,170,135
35029,029,35,2020,25458,7,1,8,99,80
35029,029,35,2021,25471,29,44,73,348,427
35029,029,35,2022,25693,217,109,326,328,432
35029,029,35,2023,25316,-338,39,-299,326,403
35031,031,35,2020,72590,-192,0,-192,227,345
35031,031,35,2021,71464,-765,25,-740,763,1152
35031,031,35,2022,69931,-1329,81,-1248,758,1074
35031,031,35,2023,68797,-1053,66,-987,756,905
35033,033,35,2020,4191,1,0,1,14,7
35033,033,35,2021,4189,21,0,21,30,55
35033,033,35,2022,4147,-12,0,-12,28,57
35033,033,35,2023,4123,5,0,5,28,56
35035,035,35,2020,67862,-25,7,-18,210,186
35035,035,35,2021,68486,461,156,617,771,790
35035,035,35,2022,68517,-96,295,199,712,843
35035,035,35,2023,68835,170,232,402,687,774
35037,037,35,2020,8712,-12,0,-12,19,39
35037,037,35,2021,8620,-1,0,-1,65,159
35037,037,35,2022,8529,21,0,21,67,179
35037,037,35,2023,8510,86,0,86,62,164
35039,039,35,2020,40271,-68,0,-68,81,103
35039,039,35,2021,40216,18,25,43,428,555
35039,039,35,2022,39991,-120,102,-18,407,597
35039,039,35,2023,39876,-54,71,17,405,535
35041,041,35,2020,19148,-61,0,-61,52,28
35041,041,35,2021,18992,-157,21,-136,198,221
35041,041,35,2022,18858,-126,-14,-140,233,226
35041,041,35,2023,18787,-77,-14,-91,228,208
35043,043,35,2020,149290,478,3,481,310,334
35043,043,35,2021,151478,2321,50,2371,1317,1473
35043,043,35,2022,153597,2139,193,2332,1307,1551
35043,043,35,2023,155936,2280,134,2414,1307,1378
35045,045,35,2020,121376,-205,1,-204,344,440
35045,045,35,2021,120996,-333,40,-293,1326,1484
35045,045,35,2022,120569,-102,113,11,1320,1716
35045,045,35,2023,120675,195,72,267,1326,1490
35047,047,35,2020,27131,-40,0,-40,51,82
35047,047,35,2021,27155,107,9,116,227,333
35047,047,35,2022,26902,-117,49,-68,222,394
35047,047,35,2023,26668,-126,39,-87,223,371
35049,049,35,2020,155043,302,11,313,273,352
35049,049,35,2021,155400,603,198,801,1134,1618
35049,049,35,2022,155761,328,559,887,1140,1607
35049,049,35,2023,155956,156,337,493,1129,1418
35051,051,35,2020,11562,36,0,36,24,66
35051,051,35,2021,11519,174,4,178,75,291
35051,051,35,2022,11474,170,-2,168,69,287
35051,051,35,2023,11488,221,-2,219,67,269
35053,053,35,2020,16551,-26,0,-26,35,52
35053,053,35,2021,16291,-196,2,-194,160,226
35053,053,35,2022,16111,-110,1,-109,152,216
35053,053,35,2023,15963,-90,1,-89,152,212
35055,055,35,2020,34463,-17,1,-16,58,73
35055,055,35,2021,34685,424,1,425,229,427
35055,055,35,2022,34590,63,38,101,236,423
35055,055,35,2023,34405,-46,22,-24,235,394
35057,057,35,2020,15062,10,1,11,30,34
35057,057,35,2021,15313,308,8,316,159,213
35057,057,35,2022,15383,165,0,165,154,245
35057,057,35,2023,15633,336,0,336,154,238
35059,059,35,2020,4071,-2,0,-2,6,14
35059,059,35,2021,4096,49,2,51,36,61
35059,059,35,2022,3982,-92,3,-89,38,62
35059,059,35,2023,3964,7,0,7,35,59
35061,061,35,2020,76374,149,6,155,191,189
35061,061,35,2021,77315,925,75,1000,830,895
35061,061,35,2022,78201,859,166,1025,843,974
35061,061,35,2023,79141,878,92,970,837,867
36001,001,36,2020,314018,-729,18,-711,765,861
36001,001,36,2021,316178,1988,479,2467,2813,3192
36001,001,36,2022,315921,-1026,1182,156,2862,3112
36001,001,36,2023,316659,-328,1140,812,2861,2943
36003,003,36,2020,47328,1049,0,1049,127,124
36003,003,36,2021,46938,-321,6,-315,453,539
36003,003,36,2022,46726,-168,27,-141,496,557
36003,003,36,2023,46651,-54,22,-32,496,540
36005,005,36,2020,1461151,-8289,294,-7995,4391,7099
36005,005,36,2021,1424084,-44747,4168,-40579,16929,11382
36005,005,36,2022,1381808,-61394,10618,-50776,16893,11243
36005,005,36,2023,1356476,-41473,10224,-31249,16614,10648
36007,007,36,2020,198156,-392,6,-386,424,570
36007,007,36,2021,198562,886,191,1077,1833,2561
36007,007,36,2022,197258,-1157,482,-675,1869,2450
36007,007,36,2023,196077,-1189,455,-734,1873,2326
36009,009,36,2020,76974,-62,0,-62,220,218
36009,009,36,2021,76539,-268,5,-263,818,1034
36009,009,36,2022,76050,-107,25,-82,789,1152
36009,009,36,2023,75600,-170,27,-143,791,1102
36011,011,36,2020,76147,-85,0,-85,186,214
36011,011,36,2021,75451,-450,11,-439,690,964
36011,011,36,2022,74679,-524,27,-497,669,931
36011,011,36,2023,74485,-13,27,14,669,877
36013,013,36,2020,127376,-225,1,-224,323,361
36013,013,36,2021,126183,-710,25,-685,1230,1776
36013,013,36,2022,125344,-251,70,-181,1273,1863
36013,013,36,2023,124891,-29,70,41,1273,1765
36015,015,36,2020,83668,-389,0,-389,206,237
36015,015,36,2021,83039,-367,17,-350,829,1155
36015,015,36,2022,81641,-1233,97,-1136,818,1129
36015,015,36,2023,81325,-150,87,-63,820,1073
36017,017,36,2020,47064,-103,0,-103,119,164
36017,017,36,2021,46569,-300,0,-300,447,653
36017,017,36,2022,46331,14,2,16,474,697
36017,017,36,2023,45920,-239,2,-237,473,650
36019,019,36,2020,79699,-104,0,-104,150,192
36019,019,36,2021,78993,-545,24,-521,649,847
36019,019,36,2022,78037,-874,73,-801,679,861
36019,019,36,2023,78115,139,74,213,676,813
36021,021,36,2020,61414,-48,0,-48,115,216
36021,021,36,2021,61961,821,23,844,432,717
36021,021,36,2022,61108,-603,44,-559,463,758
36021,021,36,2023,60470,-430,51,-379,463,721
36023,023,36,2020,46741,-78,1,-77,137,125
36023,023,36,2021,46413,-249,5,-244,435,546
36023,023,36,2022,46081,-185,14,-171,419,557
36023,023,36,2023,45752,-229,17,-212,419,536
36025,025,36,2020,44231,-51,0,-51,109,143
36025,025,36,2021,44718,765,9,774,362,626
36025,025,36,2022,44774,344,18,362,354,666
36025,025,36,2023,44410,-100,18,-82,354,634
36027,027,36,2020,295901,-858,0,-858,669,810
36027,027,36,2021,298776,3122,209,3331,2616,3090
36027,027,36,2022,297609,-1266,502,-764,2726,3059
36027,027,36,2023,297150,-800,504,-296,2726,2896
36029,029,36,2020,952342,-1401,55,-1346,2416,3042
36029,029,36,2021,952912,526,879,1405,9436,10955
36029,029,36,2022,948423,-5441,2210,-3231,9588,10636
36029,029,36,2023,946147,-4097,2074,-2023,9592,9885
36031,031,36,2020,37275,-44,0,-44,65,118
36031,031,36,2021,37233,158,14,172,248,473
36031,031,36,2022,36763,-280,38,-242,267,488
36031,031,36,2023,36775,175,39,214,267,467
36033,033,36,2020,47477,-92,0,-92,122,121
36033,033,36,2021,47106,-306,7,-299,419,500
36033,033,36,2022,46393,-665,26,-639,451,552
36033,033,36,2023,46502,167,29,196,451,540
36035,035,36,2020,53100,-151,0,-151,113,181
36035,035,36,2021,52747,-87,6,-81,440,739
36035,035,36,2022,52256,-180,16,-164,481,791
36035,035,36,2023,52234,237,16,253,481,757
36037,037,36,2020,58302,-84,0,-84,157,160
36037,037,36,2021,57889,-200,5,-195,509,762
36037,037,36,2022,57398,-302,10,-292,542,730
36037,037,36,2023,57529,272,10,282,542,691
36039,039,36,2020,47752,-142,0,-142,110,131
36039,039,36,2021,47884,366,7,373,392,646
36039,039,36,2022,47345,-291,23,-268,393,650
36039,039,36,2023,47062,-78,22,-56,393,617
36041,041,36,2020,5079,-10,0,-10,9,24
36041,041,36,2021,5122,94,0,94,23,70
36041,041,36,2022,5121,48,-2,46,27,79
36041,041,36,2023,5082,15,-2,13,27,78
36043,043,36,2020,60037,-79,0,-79,143,174
36043,043,36,2021,60023,107,5,112,631,794
36043,043,36,2022,59584,-171,18,-153,564,828
36043,043,36,2023,59484,99,16,115,563,776
36045,045,36,2020,116069,-810,6,-804,495,244
36045,045,36,2021,116902,5,18,23,1741,973
36045,045,36,2022,115461,-2504,217,-2287,1858,1076
36045,045,36,2023,114787,-1772,273,-1499,1856,1023
36047,047,36,2020,2718447,-14297,255,-14042,8395,11048
36047,047,36,2021,2637522,-95883,5078,-90805,33117,18381
36047,047,36,2022,2589531,-78188,14105,-64083,32458,18101
36047,047,36,2023,2561225,-55308,13292,-42016,31066,16892
36049,049,36,2020,26560,-35,0,-35,68,61
36049,049,36,2021,26722,115,3,118,302,273
36049,049,36,2022,26595,-107,4,-103,287,302
36049,049,36,2023,26548,-44,7,-37,289,299
36051,051,36,2020,61590,-224,0,-224,144,141
36051,051,36,2021,61691,190,23,213,493,642
36051,051,36,2022,61340,-221,46,-175,518,672
36051,051,36,2023,61158,-114,55,-59,518,642
36053,053,36,2020,67935,-78,0,-78,146,157
36053,053,36,2021,67382,-403,11,-392,550,735
36053,053,36,2022,67054,-190,47,-143,547,711
36053,053,36,2023,66921,-40,44,4,546,684
36055,055,36,2020,757551,-1754,32,-1722,1941,2014
36055,055,36,2021,755813,-2482,759,-1723,7568,8068
36055,055,36,2022,750887,-6367,1646,-4721,7776,7882
36055,055,36,2023,748482,-4457,1584,-2873,7776,7332
36057,057,36,2020,49485,-61,0,-61,155,140
36057,057,36,2021,49482,111,9,120,592,741
36057,057,36,2022,49333,-8,24,16,602,737
36057,057,36,2023,49368,111,27,138,603,704
36059,059,36,2020,1390491,-2883,54,-2829,3362,5696
36059,059,36,2021,1391809,-2353,1079,-1274,13515,11780
36059,059,36,2022,1385294,-11922,2937,-8985,14254,11816
36059,059,36,2023,1381715,-9618,2743,-6875,14213,10994
36061,061,36,2020,1677232,-13387,193,-13194,3706,5457
36061,061,36,2021,1578055,-98504,3978,-94526,13363,11308
36061,061,36,2022,1594543,2450,11003,13453,13623,10926
36061,061,36,2023,1597451,-10303,10499,196,13309,10288
36063,063,36,2020,212126,-306,0,-306,502,751
36063,063,36,2021,211719,284,64,348,2000,2911
36063,063,36,2022,210467,-431,169,-262,1999,2887
36063,063,36,2023,209457,-431,161,-270,2001,2746
36065,065,36,2020,231082,-789,3,-786,659,806
36065,065,36,2021,229620,-1199,207,-992,2376,2941
36065,065,36,2022,228358,-1173,471,-702,2480,2965
36065,065,36,2023,227555,-939,438,-501,2481,2788
36067,067,36,2020,474192,-1997,4,-1993,1231,1294
36067,067,36,2021,471887,-2628,507,-2121,4844,5220
36067,067,36,2022,469728,-3107,1198,-1909,4927,5012
36067,067,36,2023,467873,-3179,1118,-2061,4930,4744
36069,069,36,2020,112363,-80,0,-80,237,290
36069,069,36,2021,112661,376,40,416,942,1132
36069,069,36,2022,112481,-22,95,73,984,1181
36069,069,36,2023,112494,47,102,149,983,1118
36071,071,36,2020,400986,-494,3,-491,1325,1163
36071,071,36,2021,405167,1541,250,1791,5344,3189
36071,071,36,2022,406491,-1866,734,-1132,5609,3096
36071,071,36,2023,407470,-2466,760,-1706,5585,2933
36073,073,36,2020,40135,-155,0,-155,102,149
36073,073,36,2021,39515,-522,10,-512,383,471
36073,073,36,2022,39163,-287,32,-255,391,483
36073,073,36,2023,39124,-1,37,36,391,465
36075,075,36,2020,117429,-141,0,-141,296,268
36075,075,36,2021,117984,600,28,628,1159,1278
36075,075,36,2022,118239,411,62,473,1147,1317
36075,075,36,2023,118162,-42,58,16,1148,1242
36077,077,36,2020,58373,-103,0,-103,125,180
36077,077,36,2021,60732,2732,12,2744,500,721
36077,077,36,2022,60409,-91,49,-42,483,731
36077,077,36,2023,60126,-122,46,-76,483,691
36079,079,36,2020,97635,12,0,12,215,294
36079,079,36,2021,98228,407,37,444,885,787
36079,079,36,2022,98312,-182,129,-53,926,749
36079,079,36,2023,98060,-588,131,-457,926,723
36081,081,36,2020,2388864,-11650,232,-11418,6240,10534
36081,081,36,2021,2329008,-69771,6388,-63383,23189,16443
36081,081,36,2022,2278558,-77029,16958,-60071,23688,16586
36081,081,36,2023,2252196,-50161,16290,-33871,23304,15544
36083,083,36,2020,160871,-255,0,-255,398,412
36083,083,36,2021,160622,-337,129,-208,1527,1687
36083,083,36,2022,159421,-1243,344,-899,1496,1759
36083,083,36,2023,159305,-267,330,63,1496,1674
36085,085,36,2020,494598,-603,7,-596,1297,1932
36085,085,36,2021,493547,-2287,385,-1902,4868,4252
36085,085,36,2022,491358,-4121,1257,-2864,5026,4277
36085,085,36,2023,490687,-2767,1200,-1567,4920,4046
36087,087,36,2020,337367,-941,5,-936,1400,1356
36087,087,36,2021,339786,-1521,396,-1125,5899,2448
36087,087,36,2022,340357,-4502,1017,-3485,6318,2421
36087,087,36,2023,340807,-4460,937,-3523,6236,2311
36089,089,36,2020,108329,-201,0,-201,277,250
36089,089,36,2021,107823,-384,45,-339,987,1199
36089,089,36,2022,107089,-621,131,-490,1025,1255
36089,089,36,2023,106940,-104,125,21,1022,1193
36091,091,36,2020,235793,225,0,225,509,512
36091,091,36,2021,237846,2064,101,2165,2024,2197
36091,091,36,2022,238468,733,236,969,2123,2312
36091,091,36,2023,238711,72,224,296,2122,2177
36093,093,36,2020,159289,1494,1,1495,440,476
36093,093,36,2021,160046,560,134,694,1771,1783
36093,093,36,2022,159694,-625,333,-292,1833,1821
36093,093,36,2023,159902,-210,310,100,1835,1730
36095,095,36,2020,29753,34,0,34,56,61
36095,095,36,2021,30132,490,1,491,262,364
36095,095,36,2022,30091,52,8,60,267,356
36095,095,36,2023,30105,90,8,98,267,350
36097,097,36,2020,17864,-18,0,-18,37,49
36097,097,36,2021,17789,-19,0,-19,172,240
36097,097,36,2022,17609,-97,2,-95,177,256
36097,097,36,2023,17507,-22,2,-20,177,258
36099,099,36,2020,33516,-256,1,-255,92,87
36099,099,36,2021,33414,-68,5,-63,350,413
36099,099,36,2022,32586,-837,18,-819,344,407
36099,099,36,2023,32349,-200,17,-183,343,397
36101,101,36,2020,93309,-205,0,-205,237,280
36101,101,36,2021,93087,-98,43,-55,963,1185
36101,101,36,2022,92505,-374,83,-291,993,1253
36101,101,36,2023,92162,-235,81,-154,993,1185
36103,103,36,2020,1522064,-2295,84,-2211,3913,5670
36103,103,36,2021,1533815,8575,1179,9754,15157,13749
36103,103,36,2022,1527974,-11577,3574,-8003,16113,13873
36103,103,36,2023,1523170,-11561,3416,-8145,16113,12881
36105,105,36,2020,78453,-94,2,-92,208,273
36105,105,36,2021,79702,1208,47,1255,893,863
36105,105,36,2022,79735,-187,146,-41,997,875
36105,105,36,2023,79920,-93,134,41,995,850
36107,107,36,2020,48348,-79,0,-79,118,141
36107,107,36,2021,48080,-174,-2,-176,435,550
36107,107,36,2022,47766,-207,0,-207,463,555
36107,107,36,2023,47715,19,-1,18,464,531
36109,109,36,2020,99772,-4791,5,-4786,176,155
36109,109,36,2021,105966,6553,184,6737,649,764
36109,109,36,2022,104299,-2290,568,-1722,701,752
36109,109,36,2023,103558,-1263,532,-731,699,718
36111,111,36,2020,181271,-365,0,-365,360,541
36111,111,36,2021,183489,2692,86,2778,1557,2057
36111,111,36,2022,182320,-899,246,-653,1577,2007
36111,111,36,2023,182333,102,229,331,1576,1894
36113,113,36,2020,65609,-45,0,-45,106,200
36113,113,36,2021,65735,395,10,405,507,810
36113,113,36,2022,65427,61,24,85,526,876
36113,113,36,2023,65380,235,20,255,525,823
36115,115,36,2020,61091,-152,0,-152,141,181
36115,115,36,2021,60858,-32,5,-27,522,774
36115,115,36,2022,60810,167,30,197,564,773
36115,115,36,2023,60047,-617,27,-590,562,738
36117,117,36,2020,91202,-113,0,-113,234,219
36117,117,36,2021,91149,-15,7,-8,915,1023
36117,117,36,2022,90958,-25,14,-11,902,1030
36117,117,36,2023,90829,-67,18,-49,900,984
36119,119,36,2020,1001453,-1866,81,-1785,2477,3751
36119,119,36,2021,999856,-5284,1411,-3873,9755,7944
36119,119,36,2022,991736,-14726,3781,-10945,10312,7799
36119,119,36,2023,990817,-7565,3628,-3937,10278,7313
36121,121,36,2020,40259,-227,0,-227,92,112
36121,121,36,2021,39927,-258,6,-252,359,446
36121,121,36,2022,39601,-261,17,-244,350,428
36121,121,36,2023,39532,-50,33,-17,350,403
36123,123,36,2020,24722,-46,0,-46,68,68
36123,123,36,2021,24638,-118,1,-117,345,325
36123,123,36,2022,24502,-216,10,-206,345,278
36123,123,36,2023,24472,-113,10,-103,345,271
37001,001,37,2020,171960,594,0,594,437,486
37001,001,37,2021,173968,2061,122,2183,1871,2071
37001,001,37,2022,176618,2443,286,2729,1952,2082
37001,001,37,2023,179165,2208,315,2523,1944,1926
37003,003,37,2020,36489,45,0,45,85,90
37003,003,37,2021,36364,110,0,110,353,610
37003,003,37,2022,36316,162,-2,160,356,556
37003,003,37,2023,36473,308,-2,306,352,502
37005,005,37,2020,10895,35,0,35,19,39
37005,005,37,2021,11079,253,0,253,105,165
37005,005,37,2022,11193,174,1,175,105,174
37005,005,37,2023,11342,214,1,215,102,167
37007,007,37,2020,22037,-7,0,-7,54,71
37007,007,37,2021,21905,-26,0,-26,284,406
37007,007,37,2022,21958,178,2,180,266,397
37007,007,37,2023,21897,33,6,39,267,367
37009,009,37,2020,26584,42,0,42,54,94
37009,009,37,2021,26757,389,5,394,213,426
37009,009,37,2022,27062,516,11,527,207,448
37009,009,37,2023,27063,214,17,231,205,434
37011,011,37,2020,17847,53,0,53,34,51
37011,011,37,2021,17522,-203,5,-198,137,256
37011,011,37,2022,17541,107,27,134,138,246
37011,011,37,2023,17561,82,39,121,137,239
37013,013,37,2020,44694,53,0,53,118,138
37013,013,37,2021,44462,13,4,17,454,721
37013,013,37,2022,44400,213,20,233,446,719
37013,013,37,2023,44481,295,25,320,443,683
37015,015,37,2020,17863,-43,0,-43,46,69
37015,015,37,2021,17371,-281,0,-281,135,340
37015,015,37,2022,17068,-147,-1,-148,156,311
37015,015,37,2023,16922,9,-1,8,152,304
37017,017,37,2020,29632,49,1,50,78,118
37017,017,37,2021,29544,80,-1,79,350,534
37017,017,37,2022,29391,63,-2,61,356,559
37017,017,37,2023,29484,255,-2,253,349,507
37019,019,37,2020,138168,1930,0,1930,221,416
37019,019,37,2021,144843,7899,26,7925,1082,1876
37019,019,37,2022,152908,8446,22,8468,1139,2102
37019,019,37,2023,159964,7796,25,7821,1127,1921
37021,021,37,2020,269702,382,7,389,583,740
37021,021,37,2021,271945,2800,182,2982,2377,3112
37021,021,37,2022,273790,2111,465,2576,2445,3187
37021,021,37,2023,275901,2051,512,2563,2432,2901
37023,023,37,2020,87565,109,0,109,184,292
37023,023,37,2021,87589,443,13,456,811,1285
37023,023,37,2022,87972,818,37,855,880,1347
37023,023,37,2023,88338,697,36,733,861,1227
37025,025,37,2020,227219,1262,2,1264,646,444
37025,025,37,2021,231788,3836,107,3943,2616,1965
37025,025,37,2022,235909,3125,314,3439,2726,2045
37025,025,37,2023,240016,2942,345,3287,2723,1893
37027,027,37,2020,80652,22,1,23,183,255
37027,027,37,2021,80547,398,7,405,728,1280
37027,027,37,2022,80347,412,2,414,759,1351
37027,027,37,2023,80574,696,5,701,753,1228
37029,029,37,2020,10408,52,0,52,26,25
37029,029,37,2021,10821,456,5,461,79,108
37029,029,37,2022,11090,283,6,289,83,108
37029,029,37,2023,11137,74,7,81,77,111
37031,031,37,2020,67728,145,2,147,106,201
37031,031,37,2021,68729,1560,4,1564,480,999
37031,031,37,2022,69326,1146,19,1165,491,1088
37031,031,37,2023,69615,762,31,793,488,990
37033,033,37,2020,22697,1,0,1,41,83
37033,033,37,2021,22691,164,2,166,185,366
37033,033,37,2022,22431,-85,3,-82,193,365
37033,033,37,2023,22807,540,4,544,192,355
37035,035,37,2020,160888,270,2,272,424,437
37035,035,37,2021,161675,1308,75,1383,1611,2256
37035,035,37,2022,163167,1888,164,2052,1681,2252
37035,035,37,2023,164645,1626,195,1821,1670,2019
37037,037,37,2020,76664,456,0,456,196,209
37037,037,37,2021,78141,1695,50,1745,646,858
37037,037,37,2022,79939,1814,121,1935,681,873
37037,037,37,2023,81624,1676,153,1829,689,828
37039,039,37,2020,28858,148,0,148,52,93
37039,039,37,2021,29194,596,2,598,243,483
37039,039,37,2022,29459,513,-3,510,244,520
37039,039,37,2023,29959,700,-3,697,285,481
37041,041,37,2020,13703,-1,0,-1,37,42
37041,041,37,2021,13761,183,0,183,135,257
37041,041,37,2022,13898,241,-2,239,140,244
37041,041,37,2023,13891,99,-2,97,137,240
37043,043,37,2020,11142,84,0,84,21,37
37043,043,37,2021,11375,313,2,315,88,153
37043,043,37,2022,11615,321,2,323,81,184
37043,043,37,2023,11864,326,2,328,90,169
37045,045,37,2020,99817,354,0,354,262,323
37045,045,37,2021,100341,939,2,941,1072,1505
37045,045,37,2022,100653,725,17,742,1144,1547
37045,045,37,2023,101378,999,26,1025,1127,1427
37047,047,37,2020,50496,-34,0,-34,127,237
37047,047,37,2021,50020,-238,8,-230,592,860
37047,047,37,2022,50075,346,3,349,607,895
37047,047,37,2023,50121,280,3,283,583,823
37049,049,37,2020,100307,-431,14,-417,370,300
37049,049,37,2021,100396,257,26,283,1167,1395
37049,049,37,2022,101087,699,85,784,1267,1361
37049,049,37,2023,102391,1192,136,1328,1257,1287
37051,051,37,2020,335470,111,5,116,1304,761
37051,051,37,2021,337888,192,270,462,5097,3368
37051,051,37,2022,336781,-3806,992,-2814,5268,3552
37051,051,37,2023,337890,-2125,1175,-950,5281,3231
37053,053,37,2020,28405,307,0,307,85,64
37053,053,37,2021,29700,1366,-1,1365,301,311
37053,053,37,2022,31008,1231,-6,1225,345,318
37053,053,37,2023,31593,589,-6,583,290,288
37055,055,37,2020,37039,137,1,138,80,84
37055,055,37,2021,37914,974,22,996,322,406
37055,055,37,2022,37987,143,56,199,290,415
37055,055,37,2023,38110,169,64,233,283,395
37057,057,37,2020,169203,357,5,362,425,529
37057,057,37,2021,170717,2069,105,2174,1695,2362
37057,057,37,2022,172380,2111,181,2292,1781,2409
37057,057,37,2023,174804,2616,200,2816,1779,2174
37059,059,37,2020,42903,193,0,193,114,117
37059,059,37,2021,43652,933,7,940,388,554
37059,059,37,2022,44115,623,18,641,424,600
37059,059,37,2023,44599,613,23,636,420,569
37061,061,37,2020,48658,-32,5,-27,174,201
37061,061,37,2021,48558,-154,86,-68,682,742
37061,061,37,2022,48934,157,202,359,729,699
37061,061,37,2023,49520,293,229,522,720,656
37063,063,37,2020,325567,269,62,331,986,639
37063,063,37,2021,329849,1776,902,2678,4105,2443
37063,063,37,2022,333292,-330,2162,1832,4202,2444
37063,063,37,2023,336892,-615,2338,1723,4190,2280
37065,065,37,2020,48775,-96,0,-96,148,172
37065,065,37,2021,48333,-185,17,-168,542,837
37065,065,37,2022,48389,186,50,236,598,757
37065,065,37,2023,48832,521,52,573,592,716
37067,067,37,2020,383202,358,7,365,1071,934
37067,067,37,2021,386376,2533,313,2846,4334,4183
37067,067,37,2022,389661,2437,779,3216,4538,4371
37067,067,37,2023,392921,1798,900,2698,4504,3955
37069,069,37,2020,69164,573,3,576,184,167
37069,069,37,2021,71832,2727,48,2775,780,768
37069,069,37,2022,74400,2324,69,2393,845,776
37069,069,37,2023,77001,2406,86,2492,846,735
37071,071,37,2020,228532,563,1,564,649,643
37071,071,37,2021,231277,3071,122,3193,2544,2992
37071,071,37,2022,233970,2754,265,3019,2744,3127
37071,071,37,2023,237242,3020,307,3327,2752,2822
37073,073,37,2020,10452,-8,0,-8,15,36
37073,073,37,2021,10403,4,1,5,99,159
37073,073,37,2022,10370,37,-4,33,96,159
37073,073,37,2023,10343,51,-4,47,86,159
37075,075,37,2020,8036,9,0,9,27,29
37075,075,37,2021,8008,29,-1,28,78,136
37075,075,37,2022,8032,45,4,49,91,116
37075,075,37,2023,8052,31,9,40,96,115
37077,077,37,2020,61061,73,0,73,130,161
37077,077,37,2021,61365,427,6,433,593,755
37077,077,37,2022,61702,424,5,429,644,725
37077,077,37,2023,62192,522,14,536,644,689
37079,079,37,2020,20446,6,0,6,37,58
37079,079,37,2021,20280,-138,8,-130,211,252
37079,079,37,2022,20367,134,13,147,196,257
37079,079,37,2023,20530,168,31,199,199,235
37081,081,37,2020,539321,-1897,50,-1847,1496,1297
37081,081,37,2021,542495,1982,749,2731,5709,5600
37081,081,37,2022,546457,2131,1910,4041,5862,5738
37081,081,37,2023,549866,661,2068,2729,5862,5185
37083,083,37,2020,48528,-34,0,-34,125,191
37083,083,37,2021,48353,128,9,137,525,863
37083,083,37,2022,47711,-373,39,-334,531,844
37083,083,37,2023,47298,-198,45,-153,528,785
37085,085,37,2020,133757,1,-1,0,455,319
37085,085,37,2021,135586,1243,48,1291,1844,1339
37085,085,37,2022,138478,2255,135,2390,1860,1418
37085,085,37,2023,141477,2212,210,2422,1858,1299
37087,087,37,2020,62218,226,0,226,125,203
37087,087,37,2021,62522,779,15,794,507,986
37087,087,37,2022,62615,569,15,584,524,1029
37087,087,37,2023,62969,775,18,793,519,964
37089,089,37,2020,116574,453,0,453,250,406
37089,089,37,2021,117155,1135,26,1161,986,1568
37089,089,37,2022,118298,1719,30,1749,1031,1693
37089,089,37,2023,119230,1399,53,1452,1032,1552
37091,091,37,2020,21378,-126,0,-126,48,77
37091,091,37,2021,19953,-1151,9,-1142,190,384
37091,091,37,2022,19634,-228,41,-187,183,319
37091,091,37,2023,19453,-101,43,-58,183,307
37093,093,37,2020,52236,63,3,66,201,110
37093,093,37,2021,53179,531,18,549,863,480
37093,093,37,2022,53691,44,44,88,939,496
37093,093,37,2023,54446,231,72,303,932,479
37095,095,37,2020,4553,-24,0,-24,8,16
37095,095,37,2021,4643,114,0,114,40,58
37095,095,37,2022,4656,32,-1,31,34,53
37095,095,37,2023,4607,-32,-1,-33,38,54
37097,097,37,2020,187683,1069,4,1073,443,465
37097,097,37,2021,192186,4601,129,4730,1898,1994
37097,097,37,2022,195874,3312,367,3679,2038,2089
37097,097,37,2023,199710,3342,395,3737,2016,1908
37099,099,37,2020,42237,-672,1,-671,73,111
37099,099,37,2021,42587,446,13,459,326,435
37099,099,37,2022,43922,1292,38,1330,341,449
37099,099,37,2023,44574,667,69,736,346,428
37101,101,37,2020,217808,1766,8,1774,606,442
37101,101,37,2021,227302,9152,111,9263,2592,1968
37101,101,37,2022,234902,6262,365,6627,2825,2109
37101,101,37,2023,241955,5726,419,6145,2831,1923
37103,103,37,2020,9149,-10,0,-10,22,38
37103,103,37,2021,9210,159,1,160,71,167
37103,103,37,2022,9219,84,4,88,90,172
37103,103,37,2023,9401,246,7,253,96,164
37105,105,37,2020,63434,101,1,102,206,168
37105,105,37,2021,64052,649,9,658,756,799
37105,105,37,2022,65543,1247,199,1446,780,801
37105,105,37,2023,67059,1250,226,1476,783,751
37107,107,37,2020,55046,-39,1,-38,156,205
37107,107,37,2021,54683,-112,13,-99,639,932
37107,107,37,2022,54499,119,25,144,655,950
37107,107,37,2023,54895,603,32,635,657,897
37109,109,37,2020,87220,451,2,453,220,255
37109,109,37,2021,89941,2914,57,2971,888,1028
37109,109,37,2022,93108,3094,94,3188,933,1088
37109,109,37,2023,95675,2518,110,2628,932,989
37111,111,37,2020,44547,-17,1,-16,99,130
37111,111,37,2021,44530,238,15,253,369,659
37111,111,37,2022,44755,480,40,520,393,702
37111,111,37,2023,44893,346,52,398,392,653
37113,113,37,2020,37098,119,1,120,78,109
37113,113,37,2021,37470,673,12,685,310,604
37113,113,37,2022,37969,773,14,787,327,643
37113,113,37,2023,38412,693,32,725,323,606
37115,115,37,2020,21287,120,0,120,46,57
37115,115,37,2021,21728,561,10,571,187,296
37115,115,37,2022,21881,245,15,260,193,310
37115,115,37,2023,22071,278,17,295,189,295
37117,117,37,2020,21952,-36,0,-36,61,102
37117,117,37,2021,21741,-38,0,-38,227,411
37117,117,37,2022,21478,-67,1,-66,219,405
37117,117,37,2023,21447,146,1,147,218,397
37119,119,37,2020,1117423,-509,238,-271,3524,1885
37119,119,37,2021,1126283,-1658,3155,1497,14581,7918
37119,119,37,2022,1144075,2717,8170,10887,15115,7884
37119,119,37,2023,1163701,2805,8796,11601,15062,7093
37121,121,37,2020,14900,17,0,17,33,49
37121,121,37,2021,14975,213,-1,212,143,277
37121,121,37,2022,15048,218,8,226,114,275
37121,121,37,2023,14999,94,12,106,115,269
37123,123,37,2020,25731,13,3,16,53,104
37123,123,37,2021,25862,250,16,266,261,393
37123,123,37,2022,25841,97,29,126,253,396
37123,123,37,2023,26085,328,44,372,253,381
37125,125,37,2020,100296,624,3,627,290,314
37125,125,37,2021,103044,2989,32,3021,1223,1376
37125,125,37,2022,105491,2514,82,2596,1203,1456
37125,125,37,2023,106898,1452,107,1559,1192,1345
37127,127,37,2020,95157,197,0,197,250,266
37127,127,37,2021,95204,248,39,287,1022,1328
37127,127,37,2022,95820,768,58,826,1081,1269
37127,127,37,2023,96551,755,73,828,1076,1174
37129,129,37,2020,226326,655,8,663,516,543
37129,129,37,2021,230019,3996,95,4091,2116,2412
37129,129,37,2022,235784,5351,316,5667,2216,2468
37129,129,37,2023,238852,2748,347,3095,2215,2266
37131,131,37,2020,17433,5,0,5,48,91
37131,131,37,2021,17116,-159,3,-156,176,341
37131,131,37,2022,16827,-124,4,-120,165,327
37131,131,37,2023,16715,44,4,48,161,319
37133,133,37,2020,207757,3047,63,3110,897,338
37133,133,37,2021,206018,-3608,-170,-3778,3750,1589
37133,133,37,2022,209031,741,99,840,3910,1703
37133,133,37,2023,213676,1988,315,2303,3888,1563
37135,135,37,2020,143602,-4139,10,-4129,290,221
37135,135,37,2021,148693,4932,260,5192,1098,949
37135,135,37,2022,150253,863,568,1431,1196,976
37135,135,37,2023,150626,-522,613,91,1195,922
37137,137,37,2020,12300,51,0,51,25,41
37137,137,37,2021,12342,172,1,173,81,204
37137,137,37,2022,12234,32,1,33,87,220
37137,137,37,2023,12423,311,3,314,87,212
37139,139,37,2020,40577,20,1,21,113,134
37139,139,37,2021,40807,241,14,255,485,515
37139,139,37,2022,41168,377,29,406,466,524
37139,139,37,2023,41444,303,31,334,429,489
37141,141,37,2020,60639,485,0,485,148,151
37141,141,37,2021,63020,2609,33,2642,612,758
37141,141,37,2022,65698,2589,77,2666,677,781
37141,141,37,2023,68521,2798,87,2885,672,732
37143,143,37,2020,13018,34,0,34,24,46
37143,143,37,2021,13117,241,-2,239,108,240
37143,143,37,2022,13221,193,-7,186,122,210
37143,143,37,2023,13377,248,-7,241,114,199
37145,145,37,2020,39187,106,0,106,106,113
37145,145,37,2021,39148,89,1,90,447,601
37145,145,37,2022,39343,314,12,326,423,549
37145,145,37,2023,39737,476,12,488,424,518
37147,147,37,2020,170390,24,3,27,448,380
37147,147,37,2021,172235,1429,70,1499,1981,1700
37147,147,37,2022,173610,815,284,1099,2074,1733
37147,147,37,2023,175119,710,345,1055,2059,1614
37149,149,37,2020,19390,120,0,120,24,75
37149,149,37,2021,19714,545,7,552,138,345
37149,149,37,2022,20012,499,-7,492,143,357
37149,149,37,2023,20060,248,-3,245,136,332
37151,151,37,2020,144425,356,1,357,388,478
37151,151,37,2021,145154,1077,19,1096,1528,1955
37151,151,37,2022,146196,1478,91,1569,1550,2048
37151,151,37,2023,147458,1453,120,1573,1550,1860
37153,153,37,2020,42914,-38,0,-38,144,148
37153,153,37,2021,42805,17,-5,12,565,717
37153,153,37,2022,42573,-13,-5,-18,542,734
37153,153,37,2023,42324,-90,-2,-92,526,685
37155,155,37,2020,116309,-166,0,-166,380,428
37155,155,37,2021,116142,-215,44,-171,1766,1828
37155,155,37,2022,116466,257,135,392,1867,1860
37155,155,37,2023,117365,573,162,735,1862,1702
37157,157,37,2020,91195,168,1,169,245,332
37157,157,37,2021,91211,664,14,678,856,1535
37157,157,37,2022,91966,1313,20,1333,920,1511
37157,157,37,2023,92518,995,25,1020,919,1387
37159,159,37,2020,147167,321,2,323,408,462
37159,159,37,2021,147937,1216,59,1275,1549,2093
37159,159,37,2022,149673,2030,174,2204,1628,2136
37159,159,37,2023,151661,2106,200,2306,1626,1941
37161,161,37,2020,64486,96,0,96,149,212
37161,161,37,2021,64616,593,6,599,634,1112
37161,161,37,2022,64945,778,21,799,631,1116
37161,161,37,2023,65507,925,24,949,630,1016
37163,163,37,2020,59085,-4,2,-2,189,163
37163,163,37,2021,59022,-31,43,12,752,868
37163,163,37,2022,59027,-10,119,109,808,879
37163,163,37,2023,59601,447,141,588,813,826
37165,165,37,2020,34290,153,0,153,86,111
37165,165,37,2021,34285,171,14,185,377,586
37165,165,37,2022,34350,151,58,209,399,531
37165,165,37,2023,34376,64,63,127,412,515
37167,167,37,2020,62642,216,0,216,136,210
37167,167,37,2021,63100,688,6,694,648,892
37167,167,37,2022,64231,1273,34,1307,707,913
37167,167,37,2023,65699,1551,59,1610,704,844
37169,169,37,2020,44572,81,1,82,112,152
37169,169,37,2021,44625,361,8,369,383,711
37169,169,37,2022,45136,796,-6,790,423,709
37169,169,37,2023,45532,656,-5,651,421,675
37171,171,37,2020,71373,47,0,47,168,229
37171,171,37,2021,71257,236,16,252,725,1137
37171,171,37,2022,71482,631,18,649,744,1150
37171,171,37,2023,71462,254,40,294,737,1053
37173,173,37,2020,14103,-11,0,-11,40,47
37173,173,37,2021,14128,139,5,144,149,272
37173,173,37,2022,13936,-110,15,-95,169,258
37173,173,37,2023,13916,42,25,67,166,254
37175,175,37,2020,33048,123,0,123,57,104
37175,175,37,2021,33272,490,7,497,240,503
37175,175,37,2022,33373,317,33,350,250,510
37175,175,37,2023,33549,363,48,411,245,483
37177,177,37,2020,3241,-5,0,-5,11,14
37177,177,37,2021,3379,166,1,167,30,49
37177,177,37,2022,3473,91,3,94,42,50
37177,177,37,2023,3461,-7,3,-4,40,49
37179,179,37,2020,239470,1018,1,1019,573,380
37179,179,37,2021,244259,4083,171,4254,2387,1862
37179,179,37,2022,249172,3898,515,4413,2528,1975
37179,179,37,2023,256452,6010,613,6623,2512,1806
37181,181,37,2020,42540,2,1,3,135,178
37181,181,37,2021,42101,-351,45,-306,517,659
37181,181,37,2022,42154,71,124,195,538,653
37181,181,37,2023,42301,116,140,256,522,631
37183,183,37,2020,1130483,-571,145,-426,3042,1553
37183,183,37,2021,1152301,14051,1959,16010,12740,7019
37183,183,37,2022,1170778,7974,4916,12890,13249,7203
37183,183,37,2023,1190275,7401,5326,12727,13218,6484
37185,185,37,2020,18596,-6,0,-6,45,85
37185,185,37,2021,18798,353,1,354,165,307
37185,185,37,2022,18677,16,12,28,173,312
37185,185,37,2023,18836,272,17,289,175,303
37187,187,37,2020,10980,-18,0,-18,41,45
37187,187,37,2021,10883,23,0,23,95,219
37187,187,37,2022,10776,-8,6,-2,110,211
37187,187,37,2023,10713,13,6,19,111,194
37189,189,37,2020,54122,52,1,53,70,93
37189,189,37,2021,54968,1002,21,1023,321,473
37189,189,37,2022,55013,202,34,236,304,462
37189,189,37,2023,54748,-161,34,-127,306,446
37191,191,37,2020,117221,-75,5,-70,356,411
37191,191,37,2021,116857,-480,60,-420,1568,1578
37191,191,37,2022,117449,303,252,555,1604,1491
37191,191,37,2023,118686,707,291,998,1593,1352
37193,193,37,2020,65916,0,1,1,161,231
37193,193,37,2021,65826,216,35,251,671,1046
37193,193,37,2022,65791,322,43,365,676,1060
37193,193,37,2023,66013,467,49,516,681,973
37195,195,37,2020,78804,33,0,33,233,278
37195,195,37,2021,78241,-312,30,-282,852,1172
37195,195,37,2022,78306,335,54,389,887,1178
37195,195,37,2023,78970,789,61,850,887,1074
37197,197,37,2020,37254,35,0,35,111,115
37197,197,37,2021,37276,185,8,193,333,524
37197,197,37,2022,37507,371,20,391,379,543
37197,197,37,2023,37774,371,44,415,381,527
37199,199,37,2020,18496,31,0,31,55,65
37199,199,37,2021,18764,405,5,410,162,291
37199,199,37,2022,18768,122,17,139,174,311
37199,199,37,2023,18938,268,26,294,174,299
38001,001,38,2020,2195,-8,0,-8,7,11
38001,001,38,2021,2169,-21,0,-21,25,29
38001,001,38,2022,2133,-28,0,-28,23,31
38001,001,38,2023,2163,38,0,38,20,28
38003,003,38,2020,10851,9,0,9,23,34
38003,003,38,2021,10815,26,7,33,99,173
38003,003,38,2022,10761,-7,27,20,86,155
38003,003,38,2023,10726,-19,45,26,85,144
38005,005,38,2020,5935,-27,0,-27,28,20
38005,005,38,2021,5773,-157,0,-157,116,115
38005,005,38,2022,5772,-11,5,-6,106,97
38005,005,38,2023,5745,-50,7,-43,104,89
38007,007,38,2020,933,-11,0,-11,0,0
38007,007,38,2021,963,24,0,24,11,6
38007,007,38,2022,1025,53,0,53,14,8
38007,007,38,2023,1034,1,0,1,14,7
38009,009,38,2020,6388,5,0,5,13,14
38009,009,38,2021,6448,57,2,59,76,76
38009,009,38,2022,6384,-75,4,-71,75,68
38009,009,38,2023,6349,-49,8,-41,74,69
38011,011,38,2020,2980,-9,0,-9,10,11
38011,011,38,2021,2900,-67,0,-67,34,44
38011,011,38,2022,2899,2,1,3,37,39
38011,011,38,2023,2867,-28,1,-27,30,35
38013,013,38,2020,2194,-5,0,-5,4,1
38013,013,38,2021,2154,-35,0,-35,25,30
38013,013,38,2022,2132,-24,0,-24,24,20
38013,013,38,2023,2134,1,0,1,22,21
38015,015,38,2020,98601,14,1,15,308,208
38015,015,38,2021,98965,60,36,96,1174,986
38015,015,38,2022,99396,40,178,218,1171,899
38015,015,38,2023,100012,-27,318,291,1144,820
38017,017,38,2020,184876,76,17,93,593,388
38017,017,38,2021,189377,3281,231,3512,2424,1338
38017,017,38,2022,192713,1639,613,2252,2438,1392
38017,017,38,2023,196362,1394,1103,2497,2408,1273
38019,019,38,2020,3704,-7,0,-7,11,17
38019,019,38,2021,3680,-17,0,-17,42,50
38019,019,38,2022,3608,-62,-1,-63,38,50
38019,019,38,2023,3596,-1,1,0,36,47
38021,021,38,2020,4969,-27,0,-27,16,15
38021,021,38,2021,4901,-46,1,-45,59,84
38021,021,38,2022,4928,30,8,38,64,71
38021,021,38,2023,4900,-30,14,-16,58,71
38023,023,38,2020,2205,10,0,10,9,7
38023,023,38,2021,2182,-15,0,-15,18,25
38023,023,38,2022,2169,-1,0,-1,20,31
38023,023,38,2023,2135,-23,0,-23,19,30
38025,025,38,2020,4098,1,0,1,14,11
38025,025,38,2021,4018,-112,5,-107,68,36
38025,025,38,2022,3994,-65,11,-54,71,43
38025,025,38,2023,4019,-25,22,-3,69,41
38027,027,38,2020,2324,-11,0,-11,5,10
38027,027,38,2021,2324,19,0,19,30,48
38027,027,38,2022,2307,4,0,4,29,48
38027,027,38,2023,2263,-30,0,-30,31,47
38029,029,38,2020,3286,-5,0,-5,10,17
38029,029,38,2021,3257,-7,0,-7,30,52
38029,029,38,2022,3254,13,0,13,36,51
38029,029,38,2023,3224,-19,0,-19,36,48
38031,031,38,2020,3387,-9,0,-9,11,9
38031,031,38,2021,3364,-11,0,-11,44,56
38031,031,38,2022,3380,26,0,26,36,44
38031,031,38,2023,3309,-65,0,-65,37,43
38033,033,38,2020,1721,-9,0,-9,4,4
38033,033,38,2021,1755,40,0,40,17,21
38033,033,38,2022,1746,-13,0,-13,23,19
38033,033,38,2023,1743,-3,0,-3,18,19
38035,035,38,2020,73141,-139,2,-137,229,142
38035,035,38,2021,72586,-957,56,-901,900,545
38035,035,38,2022,72421,-554,154,-400,860,580
38035,035,38,2023,72708,-327,303,-24,853,546
38037,037,38,2020,2286,-10,0,-10,7,9
38037,037,38,2021,2303,45,0,45,22,49
38037,037,38,2022,2238,-50,6,-44,23,44
38037,037,38,2023,2215,-11,10,-1,21,43
38039,039,38,2020,2291,1,0,1,2,12
38039,039,38,2021,2281,-4,0,-4,25,31
38039,039,38,2022,2249,-24,0,-24,25,33
38039,039,38,2023,2248,5,0,5,23,29
38041,041,38,2020,2467,-14,0,-14,6,7
38041,041,38,2021,2425,-31,0,-31,28,40
38041,041,38,2022,2411,-8,0,-8,25,30
38041,041,38,2023,2415,7,0,7,24,27
38043,043,38,2020,2382,-7,0,-7,6,6
38043,043,38,2021,2354,-20,0,-20,26,33
38043,043,38,2022,2381,42,0,42,20,34
38043,043,38,2023,2342,-30,0,-30,20,28
38045,045,38,2020,4101,-5,0,-5,26,10
38045,045,38,2021,4079,-8,0,-8,42,57
38045,045,38,2022,4076,-7,0,-7,51,47
38045,045,38,2023,4096,13,0,13,51,44
38047,047,38,2020,1885,6,0,6,7,3
38047,047,38,2021,1863,-3,0,-3,14,33
38047,047,38,2022,1838,-23,-1,-24,26,27
38047,047,38,2023,1869,29,-1,28,30,26
38049,049,38,2020,5332,-14,0,-14,11,18
38049,049,38,2021,5238,-46,0,-46,51,98
38049,049,38,2022,5195,-27,1,-26,61,75
38049,049,38,2023,5131,-58,2,-56,62,72
38051,051,38,2020,2517,-3,1,-2,2,18
38051,051,38,2021,2517,19,1,20,34,53
38051,051,38,2022,2495,-11,8,-3,31,49
38051,051,38,2023,2488,6,5,11,30,48
38053,053,38,2020,14776,2,0,2,77,16
38053,053,38,2021,13858,-1007,4,-1003,242,98
38053,053,38,2022,13889,-111,15,-96,215,93
38053,053,38,2023,14252,216,17,233,219,90
38055,055,38,2020,9766,-2,0,-2,17,28
38055,055,38,2021,9823,70,0,70,99,116
38055,055,38,2022,9858,56,2,58,93,115
38055,055,38,2023,9832,-16,5,-11,93,109
38057,057,38,2020,8347,-11,0,-11,21,15
38057,057,38,2021,8339,-17,4,-13,79,76
38057,057,38,2022,8327,-6,11,5,83,97
38057,057,38,2023,8309,-19,20,1,78,97
38059,059,38,2020,33315,18,0,18,87,85
38059,059,38,2021,33565,191,10,201,429,391
38059,059,38,2022,33705,85,10,95,432,371
38059,059,38,2023,33895,108,10,118,418,345
38061,061,38,2020,9788,-29,0,-29,44,22
38061,061,38,2021,9562,-268,2,-266,171,119
38061,061,38,2022,9241,-395,6,-389,152,100
38061,061,38,2023,9383,76,11,87,151,95
38063,063,38,2020,2994,-11,0,-11,6,14
38063,063,38,2021,3049,85,4,89,21,51
38063,063,38,2022,2999,-30,6,-24,25,52
38063,063,38,2023,2991,0,11,11,25,45
38065,065,38,2020,1869,-9,0,-9,6,3
38065,065,38,2021,1876,2,0,2,22,18
38065,065,38,2022,1862,-20,0,-20,16,10
38065,065,38,2023,1879,7,0,7,18,9
38067,067,38,2020,6838,-13,0,-13,19,12
38067,067,38,2021,6773,-40,0,-40,69,96
38067,067,38,2022,6745,-8,6,-2,66,88
38067,067,38,2023,6661,-66,11,-55,61,88
38069,069,38,2020,3982,-15,0,-15,10,9
38069,069,38,2021,3944,3,3,6,28,73
38069,069,38,2022,3931,17,2,19,29,60
38069,069,38,2023,3902,1,5,6,28,62
38071,071,38,2020,11572,-23,0,-23,36,41
38071,071,38,2021,11611,34,6,40,134,141
38071,071,38,2022,11516,-90,7,-83,134,145
38071,071,38,2023,11463,-52,9,-43,134,143
38073,073,38,2020,5692,3,0,3,13,23
38073,073,38,2021,5682,2,4,6,56,75
38073,073,38,2022,5647,-10,5,-5,51,78
38073,073,38,2023,5603,-31,8,-23,51,72
38075,075,38,2020,2274,-7,0,-7,4,5
38075,075,38,2021,2265,3,0,3,26,38
38075,075,38,2022,2250,-29,15,-14,30,30
38075,075,38,2023,2279,8,23,31,28,30
38077,077,38,2020,16534,-21,0,-21,50,29
38077,077,38,2021,16557,-2,-1,-3,169,150
38077,077,38,2022,16574,-12,-7,-19,179,135
38077,077,38,2023,16558,-40,-7,-47,169,138
38079,079,38,2020,12193,-26,0,-26,67,38
38079,079,38,2021,12067,-127,1,-126,204,207
38079,079,38,2022,11867,-176,4,-172,173,204
38079,079,38,2023,11728,-122,7,-115,166,189
38081,081,38,2020,3828,-10,0,-10,5,17
38081,081,38,2021,3829,-9,0,-9,51,42
38081,081,38,2022,3804,-16,1,-15,40,48
38081,081,38,2023,3776,-22,1,-21,42,47
38083,083,38,2020,1259,-6,0,-6,5,4
38083,083,38,2021,1263,14,0,14,12,23
38083,083,38,2022,1286,33,0,33,10,19
38083,083,38,2023,1266,-9,0,-9,8,19
38085,085,38,2020,3880,-16,0,-16,16,14
38085,085,38,2021,3747,-123,0,-123,66,70
38085,085,38,2022,3686,-53,0,-53,58,64
38085,085,38,2023,3643,-40,0,-40,55,61
38087,087,38,2020,703,-2,0,-2,0,2
38087,087,38,2021,696,-12,0,-12,7,2
38087,087,38,2022,682,-16,0,-16,5,4
38087,087,38,2023,674,-11,0,-11,6,4
38089,089,38,2020,33832,95,3,98,142,59
38089,089,38,2021,33029,-978,8,-970,505,296
38089,089,38,2022,32718,-543,16,-527,488,285
38089,089,38,2023,33001,30,41,71,484,273
38091,091,38,2020,1794,-4,0,-4,7,3
38091,091,38,2021,1806,12,0,12,22,22
38091,091,38,2022,1793,-11,0,-11,20,22
38091,091,38,2023,1782,-9,0,-9,18,19
38093,093,38,2020,21540,-40,0,-40,46,55
38093,093,38,2021,21579,79,14,93,222,288
38093,093,38,2022,21476,-84,29,-55,204,244
38093,093,38,2023,21392,-83,30,-53,204,235
38095,095,38,2020,2147,-14,0,-14,6,6
38095,095,38,2021,2128,-4,2,-2,25,41
38095,095,38,2022,2060,-68,8,-60,20,30
38095,095,38,2023,2030,-33,8,-25,22,26
38097,097,38,2020,7987,-11,0,-11,24,22
38097,097,38,2021,7987,18,4,22,80,107
38097,097,38,2022,7955,-21,5,-16,79,97
38097,097,38,2023,7908,-40,8,-32,77,92
38099,099,38,2020,10529,-28,0,-28,26,29
38099,099,38,2021,10490,-24,2,-22,123,145
38099,099,38,2022,10460,-28,6,-22,123,128
38099,099,38,2023,10305,-165,11,-154,125,126
38101,101,38,2020,69921,-133,3,-130,258,142
38101,101,38,2021,69364,-899,13,-886,1009,686
38101,101,38,2022,68788,-1109,65,-1044,1030,578
38101,101,38,2023,68332,-1072,150,-922,1001,531
38103,103,38,2020,3972,-10,0,-10,10,13
38103,103,38,2021,3903,-37,0,-37,32,64
38103,103,38,2022,3922,49,0,49,32,62
38103,103,38,2023,3876,-14,0,-14,29,60
38105,105,38,2020,41182,73,2,75,199,43
38105,105,38,2021,38499,-2988,34,-2954,682,223
38105,105,38,2022,37966,-990,34,-956,639,246
38105,105,38,2023,39113,690,81,771,620,245
39001,001,39,2020,27440,-12,0,-12,68,90
39001,001,39,2021,27574,199,7,206,358,442
39001,001,39,2022,27459,57,26,83,304,490
39001,001,39,2023,27521,131,32,163,327,427
39003,003,39,2020,102125,-103,0,-103,293,284
39003,003,39,2021,101784,-215,26,-189,1171,1379
39003,003,39,2022,101097,-521,51,-470,1194,1390
39003,003,39,2023,100838,-302,66,-236,1209,1236
39005,005,39,2020,52470,13,0,13,136,133
39005,005,39,2021,52183,-161,14,-147,548,708
39005,005,39,2022,52024,21,16,37,574,739
39005,005,39,2023,52190,269,20,289,571,691
39007,007,39,2020,97495,-41,0,-41,261,312
39007,007,39,2021,97439,294,9,303,987,1400
39007,007,39,2022,96960,38,11,49,1059,1526
39007,007,39,2023,96845,187,18,205,1010,1328
39009,009,39,2020,62393,-52,3,-49,116,126
39009,009,39,2021,59096,-2983,88,-2895,462,640
39009,009,39,2022,60881,1582,266,1848,462,664
39009,009,39,2023,62706,1645,315,1960,456,607
39011,011,39,2020,46472,22,0,22,140,130
39011,011,39,2021,46255,-155,4,-151,532,622
39011,011,39,2022,45946,-213,3,-210,521,611
39011,011,39,2023,46050,127,6,133,522,548
39013,013,39,2020,66292,-111,0,-111,150,243
39013,013,39,2021,65899,34,1,35,602,1081
39013,013,39,2022,65495,170,-3,167,554,1087
39013,013,39,2023,64918,-118,-3,-121,483,940
39015,015,39,2020,43673,0,0,0,132,147
39015,015,39,2021,43696,203,2,205,451,659
39015,015,39,2022,43700,237,2,239,471,683
39015,015,39,2023,43777,195,3,198,482,600
39017,017,39,2020,390878,147,24,171,1167,956
39017,017,39,2021,387619,-3557,473,-3084,4215,4333
39017,017,39,2022,389728,898,1423,2321,4286,4300
39017,017,39,2023,393043,1090,1631,2721,4310,3737
39019,019,39,2020,26702,-1,0,-1,75,95
39019,019,39,2021,26700,130,0,130,238,382
39019,019,39,2022,26686,172,1,173,232,409
39019,019,39,2023,26758,233,1,234,229,385
39021,021,39,2020,38743,20,0,20,103,104
39021,021,39,2021,38794,131,3,134,382,491
39021,021,39,2022,38743,62,3,65,423,513
39021,021,39,2023,38845,139,6,145,432,476
39023,023,39,2020,135887,-60,1,-59,381,433
39023,023,39,2021,135608,359,47,406,1478,2245
39023,023,39,2022,134732,-310,127,-183,1543,2186
39023,023,39,2023,134610,133,143,276,1535,1933
39025,025,39,2020,208750,48,2,50,524,493
39025,025,39,2021,209893,1110,104,1214,2194,2373
39025,025,39,2022,210679,961,210,1171,2212,2488
39025,025,39,2023,211972,998,251,1249,2190,2154
39027,027,39,2020,42028,-10,0,-10,130,126
39027,027,39,2021,42115,95,33,128,489,559
39027,027,39,2022,41890,-152,69,-83,469,590
39027,027,39,2023,41938,35,85,120,484,556
39029,029,39,2020,101642,-70,1,-69,213,394
39029,029,39,2021,101352,161,0,161,1018,1544
39029,029,39,2022,100569,-49,-7,-56,970,1635
39029,029,39,2023,100182,78,-7,71,958,1415
39031,031,39,2020,36584,-21,0,-21,111,117
39031,031,39,2021,36658,100,3,103,441,495
39031,031,39,2022,36615,67,10,77,429,530
39031,031,39,2023,36869,295,12,307,424,476
39033,033,39,2020,42013,7,0,7,117,135
39033,033,39,2021,41782,-1,20,19,454,733
39033,033,39,2022,41509,-31,41,10,434,692
39033,033,39,2023,41529,161,46,207,442,630
39035,035,39,2020,1262573,-1912,102,-1810,3292,3848
39035,035,39,2021,1247496,-12975,1210,-11765,13074,16416
39035,035,39,2022,1236994,-10473,3280,-7193,12957,15992
39035,035,39,2023,1233088,-6999,3965,-3034,13037,13916
39037,037,39,2020,51893,17,0,17,146,158
39037,037,39,2021,51642,-141,-1,-142,591,724
39037,037,39,2022,51526,70,9,79,575,741
39037,037,39,2023,51415,-46,11,-35,586,664
39039,039,39,2020,38262,-36,0,-36,113,98
39039,039,39,2021,38170,-16,29,13,400,521
39039,039,39,2022,38128,-25,86,61,402,490
39039,039,39,2023,38315,149,88,237,407,457
39041,041,39,2020,215166,875,7,882,503,357
39041,041,39,2021,221282,5461,211,5672,2093,1513
39041,041,39,2022,226526,3996,603,4599,2188,1584
39041,041,39,2023,231636,3666,736,4402,2162,1420
39043,043,39,2020,75481,-48,0,-48,173,274
39043,043,39,2021,74886,-136,10,-126,686,1201
39043,043,39,2022,74514,75,41,116,656,1101
39043,043,39,2023,74035,-193,49,-144,656,993
39045,045,39,2020,159448,518,2,520,400,399
39045,045,39,2021,161209,1713,80,1793,1661,1738
39045,045,39,2022,162956,1687,235,1922,1730,1843
39045,045,39,2023,165360,2014,286,2300,1727,1605
39047,047,39,2020,28975,29,0,29,86,95
39047,047,39,2021,28934,27,7,34,314,405
39047,047,39,2022,28832,10,19,29,334,447
39047,047,39,2023,28817,40,24,64,337,416
39049,049,39,2020,1324441,-1364,190,-1174,4382,3091
39049,049,39,2021,1317346,-15288,2879,-12409,17174,11905
39049,049,39,2022,1321730,-8151,7967,-184,17389,12086
39049,049,39,2023,1326063,-11882,9355,-2527,17429,10554
39051,051,39,2020,42646,-68,0,-68,117,114
39051,051,39,2021,42499,-123,22,-101,453,514
39051,051,39,2022,42158,-267,44,-223,433,549
39051,051,39,2023,42007,-125,41,-84,440,509
39053,053,39,2020,29233,-5,0,-5,105,91
39053,053,39,2021,29224,38,6,44,370,444
39053,053,39,2022,29030,-72,6,-66,331,452
39053,053,39,2023,28986,62,5,67,319,430
39055,055,39,2020,95387,-30,1,-29,240,258
39055,055,39,2021,95708,344,34,378,940,1048
39055,055,39,2022,95491,-95,72,-23,920,1092
39055,055,39,2023,95407,-101,69,-32,914,962
39057,057,39,2020,168131,89,2,91,427,411
39057,057,39,2021,168236,146,134,280,1627,1913
39057,057,39,2022,169027,818,314,1132,1639,1909
39057,057,39,2023,169691,278,389,667,1649,1652
39059,059,39,2020,38423,-5,0,-5,105,130
39059,059,39,2021,38287,-4,4,0,422,586
39059,059,39,2022,38060,36,1,37,412,653
39059,059,39,2023,38089,215,3,218,410,595
39061,061,39,2020,830377,-879,73,-806,2579,2233
39061,061,39,2021,827430,-5151,1089,-4062,10223,9457
39061,061,39,2022,824721,-6004,2675,-3329,10245,9308
39061,061,39,2023,827058,-3058,3200,142,10244,8060
39063,063,39,2020,74928,-61,4,-57,219,172
39063,063,39,2021,74764,-189,72,-117,855,951
39063,063,39,2022,74774,19,137,156,835,938
39063,063,39,2023,74704,-226,164,-62,840,851
39065,065,39,2020,30727,28,0,28,105,105
39065,065,39,2021,30448,-229,11,-218,362,428
39065,065,39,2022,30391,39,25,64,367,472
39065,065,39,2023,30368,11,29,40,365,428
39067,067,39,2020,14491,10,0,10,44,51
39067,067,39,2021,14458,68,1,69,164,271
39067,067,39,2022,14351,17,1,18,148,268
39067,067,39,2023,14159,-78,1,-77,135,250
39069,069,39,2020,27668,-9,0,-9,83,73
39069,069,39,2021,27560,-41,0,-41,295,381
39069,069,39,2022,27526,53,3,56,301,373
39069,069,39,2023,27520,32,4,36,306,348
39071,071,39,2020,43359,43,0,43,126,134
39071,071,39,2021,43444,141,1,142,508,596
39071,071,39,2022,43426,104,8,112,556,658
39071,071,39,2023,43614,222,10,232,556,600
39073,073,39,2020,28040,-17,0,-17,74,75
39073,073,39,2021,28101,211,1,212,269,432
39073,073,39,2022,27818,-115,-1,-116,275,433
39073,073,39,2023,27540,-153,0,-153,276,402
39075,075,39,2020,44227,-102,0,-102,214,98
39075,075,39,2021,44349,-257,1,-256,804,437
39075,075,39,2022,44375,-390,6,-384,811,398
39075,075,39,2023,44386,-413,7,-406,779,366
39077,077,39,2020,58495,-67,0,-67,148,162
39077,077,39,2021,58412,21,19,40,610,779
39077,077,39,2022,58219,-95,41,-54,647,763
39077,077,39,2023,58199,-2,41,39,650,710
39079,079,39,2020,32662,41,0,41,77,111
39079,079,39,2021,32539,-40,3,-37,384,494
39079,079,39,2022,32611,199,18,217,382,516
39079,079,39,2023,32606,69,20,89,377,471
39081,081,39,2020,65178,-21,0,-21,164,225
39081,081,39,2021,65085,374,4,378,633,1126
39081,081,39,2022,64273,-263,17,-246,621,1162
39081,081,39,2023,64026,244,20,264,533,1042
39083,083,39,2020,62803,49,0,49,183,165
39083,083,39,2021,62543,-211,11,-200,733,804
39083,083,39,2022,63196,655,29,684,754,812
39083,083,39,2023,63320,48,38,86,756,717
39085,085,39,2020,232516,47,2,49,489,617
39085,085,39,2021,232222,455,132,587,2087,3134
39085,085,39,2022,231736,475,286,761,2071,3167
39085,085,39,2023,231640,277,314,591,2074,2758
39087,087,39,2020,58137,-50,0,-50,176,230
39087,087,39,2021,57408,-358,3,-355,634,1027
39087,087,39,2022,56572,-291,-2,-293,572,1096
39087,087,39,2023,56118,-14,-1,-15,524,962
39089,089,39,2020,178784,207,0,207,464,448
39089,089,39,2021,180021,1282,59,1341,1864,2058
39089,089,39,2022,181765,1847,155,2002,1927,2185
39089,089,39,2023,183201,1256,177,1433,1902,1900
39091,091,39,2020,46116,-64,0,-64,143,124
39091,091,39,2021,46158,81,7,88,501,579
39091,091,39,2022,46062,10,16,26,516,611
39091,091,39,2023,46057,-9,19,10,524,537
39093,093,39,2020,313498,522,3,525,806,851
39093,093,39,2021,314216,1036,165,1201,3190,3861
39093,093,39,2022,316031,2484,298,2782,3192,4082
39093,093,39,2023,317910,1927,321,2248,3200,3558
39095,095,39,2020,430859,-355,12,-343,1318,1506
39095,095,39,2021,429482,-1323,202,-1121,4967,5487
39095,095,39,2022,426719,-2549,460,-2089,4933,5505
39095,095,39,2023,425484,-1964,563,-1401,4957,4811
39097,097,39,2020,43849,-3,0,-3,107,109
39097,097,39,2021,44428,661,12,673,422,509
39097,097,39,2022,43581,-872,49,-823,446,525
39097,097,39,2023,44602,986,52,1038,449,474
39099,099,39,2020,228009,-201,2,-199,554,986
39099,099,39,2021,226529,-327,67,-260,2294,3657
39099,099,39,2022,225922,558,264,822,2361,3662
39099,099,39,2023,225596,213,284,497,2379,3197
39101,101,39,2020,65388,45,0,45,173,203
39101,101,39,2021,65310,62,7,69,676,868
39101,101,39,2022,64609,-492,10,-482,715,941
39101,101,39,2023,64851,351,8,359,723,845
39103,103,39,2020,182646,166,3,169,385,438
39103,103,39,2021,183394,854,46,900,1676,1939
39103,103,39,2022,183489,455,101,556,1670,2031
39103,103,39,2023,184042,543,117,660,1667,1761
39105,105,39,2020,22159,-19,0,-19,47,76
39105,105,39,2021,22078,82,7,89,194,376
39105,105,39,2022,21961,46,19,65,215,388
39105,105,39,2023,21767,-45,17,-28,207,374
39107,107,39,2020,42542,-49,0,-49,164,114
39107,107,39,2021,42392,-281,8,-273,625,514
39107,107,39,2022,42424,-141,19,-122,638,469
39107,107,39,2023,42439,-224,24,-200,650,437
39109,109,39,2020,108959,119,1,120,293,259
39109,109,39,2021,109411,618,50,668,1146,1419
39109,109,39,2022,110213,1045,122,1167,1133,1469
39109,109,39,2023,110876,651,150,801,1147,1280
39111,111,39,2020,13350,-11,0,-11,35,59
39111,111,39,2021,13331,51,3,54,125,205
39111,111,39,2022,13215,-15,8,-7,133,234
39111,111,39,2023,13153,30,9,39,121,220
39113,113,39,2020,537119,-224,26,-198,1495,1645
39113,113,39,2021,536155,-417,518,101,6146,7629
39113,113,39,2022,533474,-1999,1059,-940,6053,7568
39113,113,39,2023,533796,-505,1282,777,6115,6581
39115,115,39,2020,13762,-29,0,-29,35,49
39115,115,39,2021,13703,17,0,17,155,241
39115,115,39,2022,13669,87,0,87,137,252
39115,115,39,2023,13646,71,0,71,137,231
39117,117,39,2020,34980,12,0,12,92,81
39117,117,39,2021,35205,240,1,241,367,399
39117,117,39,2022,35336,186,1,187,378,416
39117,117,39,2023,35595,280,0,280,373,392
39119,119,39,2020,86468,9,0,9,264,257
39119,119,39,2021,86577,233,6,239,997,1187
39119,119,39,2022,86114,-233,3,-230,987,1180
39119,119,39,2023,86305,245,7,252,985,1045
39121,121,39,2020,14090,-15,0,-15,36,40
39121,121,39,2021,14309,243,1,244,140,160
39121,121,39,2022,14325,39,2,41,143,160
39121,121,39,2023,14311,-14,2,-12,147,149
39123,123,39,2020,40296,-8,0,-8,86,150
39123,123,39,2021,40166,174,7,181,291,617
39123,123,39,2022,39968,153,15,168,275,627
39123,123,39,2023,39803,114,14,128,280,573
39125,125,39,2020,18811,-2,0,-2,48,44
39125,125,39,2021,18902,89,0,89,229,237
39125,125,39,2022,18762,-112,3,-109,202,228
39125,125,39,2023,18706,-57,3,-54,220,224
39127,127,39,2020,35446,22,0,22,109,101
39127,127,39,2021,35464,73,1,74,385,463
39127,127,39,2022,35471,125,2,127,379,481
39127,127,39,2023,35551,131,2,133,379,430
39129,129,39,2020,58656,121,0,121,168,190
39129,129,39,2021,58765,194,6,200,609,731
39129,129,39,2022,60007,1326,14,1340,624,762
39129,129,39,2023,61086,1142,13,1155,625,701
39131,131,39,2020,27072,-5,0,-5,82,101
39131,131,39,2021,27094,96,0,96,334,426
39131,131,39,2022,27012,84,-1,83,321,477
39131,131,39,2023,27001,112,-1,111,315,436
39133,133,39,2020,161853,88,7,95,326,424
39133,133,39,2021,159076,-2284,105,-2179,1327,1782
39133,133,39,2022,161742,2846,256,3102,1362,1964
39133,133,39,2023,162665,966,315,1281,1363,1720
39135,135,39,2020,41007,13,0,13,92,108
39135,135,39,2021,40871,59,5,64,400,626
39135,135,39,2022,40574,-76,7,-69,384,598
39135,135,39,2023,40556,112,7,119,401,534
39137,137,39,2020,34385,-57,0,-57,98,89
39137,137,39,2021,34341,-76,7,-69,420,411
39137,137,39,2022,34330,-34,14,-20,409,387
39137,137,39,2023,34199,-196,16,-180,416,370
39139,139,39,2020,124966,15,0,15,341,356
39139,139,39,2021,125341,685,28,713,1376,1772
39139,139,39,2022,125261,416,52,468,1362,1866
39139,139,39,2023,125064,21,65,86,1354,1638
39141,141,39,2020,77049,6,0,6,191,252
39141,141,39,2021,76500,-236,2,-234,796,1151
39141,141,39,2022,76508,440,2,442,768,1182
39141,141,39,2023,76501,279,3,282,776,1068
39143,143,39,2020,58856,-27,2,-25,156,172
39143,143,39,2021,58741,30,45,75,568,800
39143,143,39,2022,58567,58,80,138,575,855
39143,143,39,2023,58709,245,83,328,577,762
39145,145,39,2020,73848,-60,0,-60,189,304
39145,145,39,2021,72989,-275,1,-274,721,1333
39145,145,39,2022,72189,-195,9,-186,721,1311
39145,145,39,2023,71969,187,14,201,731,1152
39147,147,39,2020,55054,-17,0,-17,153,171
39147,147,39,2021,54864,-70,20,-50,580,749
39147,147,39,2022,54534,-192,47,-145,592,758
39147,147,39,2023,54527,13,57,70,592,669
39149,149,39,2020,48146,-86,0,-86,140,136
39149,149,39,2021,48023,-128,11,-117,589,616
39149,149,39,2022,47684,-378,26,-352,622,605
39149,149,39,2023,47765,-25,33,8,619,546
39151,151,39,2020,374522,-107,1,-106,948,1258
39151,151,39,2021,373792,339,97,436,3968,5405
39151,151,39,2022,372785,490,205,695,3865,5338
39151,151,39,2023,372716,403,235,638,3934,4637
39153,153,39,2020,539821,-373,24,-349,1378,1751
39153,153,39,2021,537436,-1647,433,-1214,5388,6870
39153,153,39,2022,535769,-542,970,428,5464,7233
39153,153,39,2023,535733,-300,1166,866,5430,6346
39155,155,39,2020,201681,-143,0,-143,495,757
39155,155,39,2021,201572,945,14,959,2013,3180
39155,155,39,2022,200726,558,36,594,1979,3308
39155,155,39,2023,200373,486,45,531,1974,2854
39157,157,39,2020,93193,-58,0,-58,265,297
39157,157,39,2021,92618,-400,25,-375,1103,1350
39157,157,39,2022,91971,-435,56,-379,1144,1392
39157,157,39,2023,91874,-93,69,-24,1131,1206
39159,159,39,2020,63085,256,0,256,154,111
39159,159,39,2021,65106,1844,33,1877,685,482
39159,159,39,2022,66876,1474,87,1561,712,522
39159,159,39,2023,69637,2437,100,2537,723,497
39161,161,39,2020,28916,-20,0,-20,89,87
39161,161,39,2021,28784,-96,7,-89,313,372
39161,161,39,2022,28804,75,25,100,337,402
39161,161,39,2023,28704,-105,26,-79,339,361
39163,163,39,2020,12801,2,0,2,36,41
39163,163,39,2021,12703,-19,0,-19,112,198
39163,163,39,2022,12577,-46,0,-46,151,228
39163,163,39,2023,12474,-32,0,-32,149,220
39165,165,39,2020,243228,746,21,767,559,479
39165,165,39,2021,246828,3161,306,3467,2460,2372
39165,165,39,2022,249735,2274,680,2954,2489,2391
39165,165,39,2023,252148,1243,814,2057,2462,2078
39167,167,39,2020,59647,-53,0,-53,126,198
39167,167,39,2021,59486,65,13,78,552,832
39167,167,39,2022,58868,-239,28,-211,543,926
39167,167,39,2023,58577,-6,42,36,524,849
39169,169,39,2020,116923,-25,1,-24,358,343
39169,169,39,2021,116175,-751,52,-699,1365,1422
39169,169,39,2022,116552,411,125,536,1406,1527
39169,169,39,2023,116510,-265,152,-113,1410,1346
39171,171,39,2020,37078,-46,0,-46,104,87
39171,171,39,2021,36763,-258,21,-237,391,481
39171,171,39,2022,36648,-1,32,31,389,516
39171,171,39,2023,36591,-27,36,9,404,471
39173,173,39,2020,132256,3,1,4,312,352
39173,173,39,2021,130310,-1765,74,-1691,1213,1386
39173,173,39,2022,131642,1232,207,1439,1247,1370
39173,173,39,2023,132650,739,241,980,1254,1232
39175,175,39,2020,21864,-10,0,-10,39,65
39175,175,39,2021,21689,-69,1,-68,212,329
39175,175,39,2022,21552,-31,5,-26,209,311
39175,175,39,2023,21457,-12,6,-6,209,299
40001,001,40,2020,19456,-54,0,-54,72,59
40001,001,40,2021,19442,37,1,38,250,318
40001,001,40,2022,19516,121,4,125,291,341
40001,001,40,2023,19627,111,6,117,313,319
40003,003,40,2020,5711,15,0,15,11,19
40003,003,40,2021,5695,8,4,12,38,69
40003,003,40,2022,5689,-5,14,9,41,53
40003,003,40,2023,5673,-27,18,-9,41,47
40005,005,40,2020,14165,43,0,43,30,54
40005,005,40,2021,14294,167,4,171,152,194
40005,005,40,2022,14327,76,16,92,137,194
40005,005,40,2023,14525,219,23,242,133,177
40007,007,40,2020,5030,-19,0,-19,15,14
40007,007,40,2021,4994,-27,8,-19,44,66
40007,007,40,2022,5019,10,22,32,58,63
40007,007,40,2023,5018,-41,33,-8,64,57
40009,009,40,2020,22334,-77,0,-77,56,51
40009,009,40,2021,22032,-227,3,-224,242,322
40009,009,40,2022,21976,40,-6,34,225,306
40009,009,40,2023,22042,133,-4,129,221,285
40011,011,40,2020,8701,-9,0,-9,19,38
40011,011,40,2021,8547,-131,20,-111,123,161
40011,011,40,2022,8445,-104,40,-64,120,163
40011,011,40,2023,8539,61,60,121,120,147
40013,013,40,2020,46330,251,0,251,154,129
40013,013,40,2021,47126,968,12,980,563,721
40013,013,40,2022,48038,1011,27,1038,561,725
40013,013,40,2023,48967,1008,42,1050,526,644
40015,015,40,2020,26909,-44,0,-44,108,102
40015,015,40,2021,26461,-314,24,-290,319,479
40015,015,40,2022,26237,-122,50,-72,307,452
40015,015,40,2023,26214,6,83,89,307,419
40017,017,40,2020,155434,1131,4,1135,469,250
40017,017,40,2021,161999,6284,42,6326,1892,1396
40017,017,40,2022,169254,6285,89,6374,1990,1382
40017,017,40,2023,175829,5634,158,5792,1977,1185
40019,019,40,2020,48042,11,0,11,158,149
40019,019,40,2021,48254,389,28,417,591,814
40019,019,40,2022,48336,270,56,326,610,839
40019,019,40,2023,48596,316,79,395,608,747
40021,021,40,2020,47096,27,0,27,118,144
40021,021,40,2021,47659,617,16,633,565,633
40021,021,40,2022,48074,512,24,536,511,640
40021,021,40,2023,48185,145,38,183,514,588
40023,023,40,2020,14205,12,0,12,49,63
40023,023,40,2021,14363,209,0,209,226,277
40023,023,40,2022,14407,143,4,147,195,296
40023,023,40,2023,14276,-21,4,-17,177,290
40025,025,40,2020,2289,-3,0,-3,5,4
40025,025,40,2021,2247,-39,0,-39,25,29
40025,025,40,2022,2233,-4,0,-4,23,31
40025,025,40,2023,2191,-34,0,-34,23,31
40027,027,40,2020,296236,506,8,514,678,561
40027,027,40,2021,298110,1412,193,1605,2648,2569
40027,027,40,2022,299484,1008,475,1483,2688,2617
40027,027,40,2023,301193,588,662,1250,2688,2227
40029,029,40,2020,5279,24,0,24,16,24
40029,029,40,2021,5304,55,1,56,84,115
40029,029,40,2022,5291,18,2,20,67,99
40029,029,40,2023,5266,2,2,4,65,94
40031,031,40,2020,121125,-158,27,-131,370,273
40031,031,40,2021,122324,874,17,891,1624,1371
40031,031,40,2022,122225,-256,97,-159,1570,1449
40031,031,40,2023,121574,-1057,142,-915,1553,1286
40033,033,40,2020,5535,21,0,21,17,25
40033,033,40,2021,5442,-23,0,-23,46,119
40033,033,40,2022,5449,57,0,57,58,109
40033,033,40,2023,5427,27,0,27,57,104
40035,035,40,2020,14141,49,0,49,39,52
40035,035,40,2021,14201,123,5,128,160,234
40035,035,40,2022,14176,35,25,60,156,232
40035,035,40,2023,14494,338,41,379,159,216
40037,037,40,2020,71841,90,0,90,177,192
40037,037,40,2021,72224,585,10,595,804,1037
40037,037,40,2022,72686,768,15,783,779,1093
40037,037,40,2023,73332,803,20,823,774,945
40039,039,40,2020,28449,-79,0,-79,93,82
40039,039,40,2021,28175,-232,7,-225,330,383
40039,039,40,2022,28039,-162,8,-154,357,342
40039,039,40,2023,28266,183,18,201,357,328
40041,041,40,2020,40392,94,0,94,79,177
40041,041,40,2021,40970,954,2,956,372,717
40041,041,40,2022,41480,829,4,833,419,768
40041,041,40,2023,41703,476,12,488,436,705
40043,043,40,2020,4475,-14,0,-14,16,9
40043,043,40,2021,4418,-36,0,-36,62,81
40043,043,40,2022,4404,8,1,9,63,85
40043,043,40,2023,4286,-102,1,-101,63,80
40045,045,40,2020,3739,-7,0,-7,6,6
40045,045,40,2021,3733,19,0,19,39,65
40045,045,40,2022,3683,-46,5,-41,41,50
40045,045,40,2023,3648,-34,9,-25,40,50
40047,047,40,2020,62691,-164,6,-158,182,166
40047,047,40,2021,61964,-721,43,-678,823,867
40047,047,40,2022,61951,9,76,85,819,886
40047,047,40,2023,62023,-89,121,32,819,781
40049,049,40,2020,25647,5,0,5,67,88
40049,049,40,2021,25770,245,7,252,327,461
40049,049,40,2022,25771,131,14,145,325,461
40049,049,40,2023,25865,172,23,195,325,426
40051,051,40,2020,54881,42,0,42,153,135
40051,051,40,2021,55595,918,8,926,564,770
40051,051,40,2022,56648,1185,21,1206,573,751
40051,051,40,2023,57375,776,33,809,572,650
40053,053,40,2020,4180,10,0,10,13,12
40053,053,40,2021,4145,7,0,7,37,81
40053,053,40,2022,4122,5,-1,4,45,71
40053,053,40,2023,4083,-14,1,-13,45,70
40055,055,40,2020,5492,5,0,5,17,23
40055,055,40,2021,5480,28,0,28,49,90
40055,055,40,2022,5546,104,1,105,54,96
40055,055,40,2023,5466,-42,2,-40,53,93
40057,057,40,2020,2476,-17,0,-17,10,5
40057,057,40,2021,2403,-40,0,-40,24,56
40057,057,40,2022,2416,33,0,33,28,47
40057,057,40,2023,2392,-4,0,-4,27,47
40059,059,40,2020,3252,-13,0,-13,4,8
40059,059,40,2021,3177,-47,3,-44,29,59
40059,059,40,2022,3165,-15,14,-1,27,38
40059,059,40,2023,3190,12,24,36,27,38
40061,061,40,2020,11550,2,0,2,27,39
40061,061,40,2021,11615,110,2,112,138,186
40061,061,40,2022,11667,111,5,116,143,204
40061,061,40,2023,11832,192,9,201,152,189
40063,063,40,2020,13346,-19,0,-19,46,46
40063,063,40,2021,13401,134,0,134,151,229
40063,063,40,2022,13434,114,-1,113,160,234
40063,063,40,2023,13436,66,-1,65,158,222
40065,065,40,2020,24747,-61,1,-60,76,62
40065,065,40,2021,24744,-37,1,-36,352,338
40065,065,40,2022,24659,-178,28,-150,362,294
40065,065,40,2023,24669,-121,52,-69,358,276
40067,067,40,2020,5322,-2,0,-2,10,22
40067,067,40,2021,5390,135,0,135,52,115
40067,067,40,2022,5408,54,3,57,57,98
40067,067,40,2023,5347,-29,3,-26,57,93
40069,069,40,2020,10249,-34,0,-34,30,27
40069,069,40,2021,10332,142,0,142,123,183
40069,069,40,2022,10346,70,3,73,125,181
40069,069,40,2023,10216,-74,4,-70,117,175
40071,071,40,2020,43599,-73,0,-73,125,145
40071,071,40,2021,43715,324,4,328,525,752
40071,071,40,2022,43738,174,6,180,552,692
40071,071,40,2023,43641,-28,9,-19,553,631
40073,073,40,2020,15178,-30,0,-30,52,30
40073,073,40,2021,15223,44,23,67,165,196
40073,073,40,2022,15228,-14,48,34,154,178
40073,073,40,2023,15481,193,74,267,153,166
40075,075,40,2020,8501,4,0,4,26,41
40075,075,40,2021,8404,-27,0,-27,93,168
40075,075,40,2022,8480,106,4,110,108,142
40075,075,40,2023,8398,-50,4,-46,107,141
40077,077,40,2020,9479,22,0,22,33,22
40077,077,40,2021,9454,23,0,23,92,147
40077,077,40,2022,9556,165,1,166,102,173
40077,077,40,2023,9526,31,2,33,101,162
40079,079,40,2020,48197,65,0,65,140,147
40079,079,40,2021,48603,611,15,626,585,808
40079,079,40,2022,49002,526,23,549,674,819
40079,079,40,2023,49596,525,35,560,769,736
40081,081,40,2020,33498,35,0,35,93,97
40081,081,40,2021,33846,473,2,475,345,473
40081,081,40,2022,34134,444,6,450,333,497
40081,081,40,2023,34562,555,7,562,325,452
40083,083,40,2020,49736,171,0,171,111,94
40083,083,40,2021,50900,1166,14,1180,485,471
40083,083,40,2022,51924,930,51,981,541,520
40083,083,40,2023,53029,950,83,1033,541,467
40085,085,40,2020,10158,18,0,18,30,36
40085,085,40,2021,10237,105,5,110,103,136
40085,085,40,2022,10174,-19,9,-10,102,149
40085,085,40,2023,10296,151,10,161,101,140
40087,087,40,2020,41914,253,0,253,97,88
40087,087,40,2021,43535,1728,5,1733,422,463
40087,087,40,2022,45410,1797,11,1808,455,452
40087,087,40,2023,47072,1599,16,1615,455,403
40089,089,40,2020,30852,9,0,9,120,108
40089,089,40,2021,30824,131,13,144,429,616
40089,089,40,2022,30773,146,32,178,398,614
40089,089,40,2023,30660,45,41,86,356,554
40091,091,40,2020,18950,58,0,58,41,90
40091,091,40,2021,19249,522,0,522,201,405
40091,091,40,2022,19403,379,0,379,191,425
40091,091,40,2023,19603,404,1,405,189,393
40093,093,40,2020,7746,-21,0,-21,14,27
40093,093,40,2021,7636,-72,3,-69,80,119
40093,093,40,2022,7536,-65,5,-60,85,122
40093,093,40,2023,7581,66,7,73,86,115
40095,095,40,2020,15340,38,0,38,45,45
40095,095,40,2021,15552,284,10,294,207,280
40095,095,40,2022,15921,373,31,404,222,270
40095,095,40,2023,15970,38,52,90,214,257
40097,097,40,2020,39059,45,0,45,102,141
40097,097,40,2021,39259,342,0,342,457,608
40097,097,40,2022,39570,474,1,475,481,659
40097,097,40,2023,39889,445,4,449,478,607
40099,099,40,2020,13876,-14,0,-14,34,47
40099,099,40,2021,13716,-79,1,-78,157,242
40099,099,40,2022,13681,56,-1,55,155,243
40099,099,40,2023,13754,138,-1,137,153,216
40101,101,40,2020,66246,-81,0,-81,220,251
40101,101,40,2021,66267,256,15,271,825,1112
40101,101,40,2022,66307,364,28,392,840,1159
40101,101,40,2023,66677,527,39,566,845,1045
40103,103,40,2020,10927,-8,0,-8,38,34
40103,103,40,2021,10941,54,5,59,112,165
40103,103,40,2022,10845,-7,9,2,88,182
40103,103,40,2023,10832,56,15,71,88,171
40105,105,40,2020,9320,-2,0,-2,28,26
40105,105,40,2021,9352,78,3,81,117,171
40105,105,40,2022,9413,117,6,123,105,168
40105,105,40,2023,9438,60,8,68,107,151
40107,107,40,2020,11268,-35,0,-35,29,35
40107,107,40,2021,11222,36,0,36,130,215
40107,107,40,2022,11227,56,11,67,141,196
40107,107,40,2023,11300,100,12,112,140,179
40109,109,40,2020,798241,663,58,721,2656,1898
40109,109,40,2021,799845,-1260,614,-646,10886,9278
40109,109,40,2022,803103,123,1660,1783,10978,9083
40109,109,40,2023,808866,-56,2539,2483,10906,7664
40111,111,40,2020,36693,-3,0,-3,110,135
40111,111,40,2021,36848,375,1,376,414,642
40111,111,40,2022,37011,409,3,412,435,683
40111,111,40,2023,37035,225,3,228,432,636
40113,113,40,2020,45787,-27,0,-27,98,118
40113,113,40,2021,45882,294,1,295,355,569
40113,113,40,2022,45852,193,-1,192,421,630
40113,113,40,2023,46130,429,-1,428,420,569
40115,115,40,2020,30222,-37,0,-37,80,107
40115,115,40,2021,30380,309,5,314,405,567
40115,115,40,2022,30329,96,18,114,421,574
40115,115,40,2023,30287,31,27,58,432,533
40117,117,40,2020,15557,5,0,5,44,51
40117,117,40,2021,15707,283,1,284,149,280
40117,117,40,2022,15681,83,0,83,161,263
40117,117,40,2023,15864,279,0,279,162,256
40119,119,40,2020,81648,-65,14,-51,182,146
40119,119,40,2021,82163,287,153,440,723,704
40119,119,40,2022,82701,268,344,612,754,774
40119,119,40,2023,83352,130,463,593,750,692
40121,121,40,2020,43788,31,0,31,123,150
40121,121,40,2021,43630,128,5,133,477,794
40121,121,40,2022,43476,176,7,183,488,805
40121,121,40,2023,43479,204,12,216,487,699
40123,123,40,2020,38095,19,0,19,110,117
40123,123,40,2021,38184,119,3,122,496,554
40123,123,40,2022,38032,-4,6,2,462,603
40123,123,40,2023,38396,446,11,457,458,549
40125,125,40,2020,72559,82,0,82,212,213
40125,125,40,2021,73045,740,9,749,819,1097
40125,125,40,2022,73351,619,13,632,850,1167
40125,125,40,2023,73791,608,18,626,841,1033
40127,127,40,2020,10792,5,0,5,19,44
40127,127,40,2021,10767,96,0,96,114,234
40127,127,40,2022,10709,92,4,96,110,260
40127,127,40,2023,10800,235,6,241,100,249
40129,129,40,2020,3429,-5,0,-5,9,14
40129,129,40,2021,3365,-41,1,-40,35,58
40129,129,40,2022,3337,-13,4,-9,35,53
40129,129,40,2023,3295,-41,7,-34,35,43
40131,131,40,2020,95386,102,0,102,257,241
40131,131,40,2021,96871,1591,9,1600,1006,1110
40131,131,40,2022,99060,2188,43,2231,1058,1129
40131,131,40,2023,100248,1073,57,1130,1055,988
40133,133,40,2020,23517,-6,0,-6,59,101
40133,133,40,2021,23542,166,4,170,281,434
40133,133,40,2022,23464,67,9,76,285,425
40133,133,40,2023,23565,201,12,213,286,398
40135,135,40,2020,39257,-2,0,-2,111,152
40135,135,40,2021,39494,424,4,428,474,671
40135,135,40,2022,39801,461,-1,460,532,682
40135,135,40,2023,40291,481,2,483,600,594
40137,137,40,2020,42822,-20,0,-20,114,128
40137,137,40,2021,43110,553,11,564,465,742
40137,137,40,2022,43616,692,29,721,488,711
40137,137,40,2023,44014,520,40,560,480,640
40139,139,40,2020,21289,-116,7,-109,74,49
40139,139,40,2021,20849,-597,82,-515,284,182
40139,139,40,2022,20505,-636,133,-503,303,168
40139,139,40,2023,20371,-512,191,-321,339,152
40141,141,40,2020,6947,-6,0,-6,19,30
40141,141,40,2021,7040,144,0,144,74,122
40141,141,40,2022,6971,-4,0,-4,65,126
40141,141,40,2023,6869,-39,0,-39,63,125
40143,143,40,2020,670702,723,47,770,2064,1595
40143,143,40,2021,674051,1008,647,1655,8692,7510
40143,143,40,2022,677061,836,1835,2671,8648,7929
40143,143,40,2023,682868,1152,2642,3794,8632,6662
40145,145,40,2020,81384,396,0,396,200,173
40145,145,40,2021,84230,2911,21,2932,877,844
40145,145,40,2022,86697,2336,65,2401,917,930
40145,145,40,2023,89280,2391,100,2491,914,816
40147,147,40,2020,52615,168,0,168,147,155
40147,147,40,2021,52903,375,23,398,603,738
40147,147,40,2022,53238,517,61,578,579,800
40147,147,40,2023,53706,508,89,597,579,702
40149,149,40,2020,10903,-15,0,-15,35,36
40149,149,40,2021,10899,15,4,19,135,163
40149,149,40,2022,10736,-118,4,-114,117,164
40149,149,40,2023,10736,29,7,36,117,155
40151,151,40,2020,8598,-18,0,-18,25,29
40151,151,40,2021,8623,32,1,33,86,99
40151,151,40,2022,8602,-3,3,0,87,104
40151,151,40,2023,8564,-36,3,-33,87,93
40153,153,40,2020,20412,-67,0,-67,63,57
40153,153,40,2021,20241,-149,10,-139,225,261
40153,153,40,2022,20015,-191,8,-183,215,256
40153,153,40,2023,19947,-55,16,-39,211,241
41001,001,41,2020,16731,68,0,68,45,48
41001,001,41,2021,16880,249,5,254,157,258
41001,001,41,2022,16937,174,7,181,152,279
41001,001,41,2023,16912,98,4,102,144,270
41003,003,41,2020,95214,-7,9,2,154,141
41003,003,41,2021,96321,899,209,1108,630,662
41003,003,41,2022,97661,934,487,1421,636,716
41003,003,41,2023,97713,-223,323,100,620,670
41005,005,41,2020,422468,922,7,929,1015,941
41005,005,41,2021,423804,923,200,1123,3706,3810
41005,005,41,2022,423118,-472,430,-42,3757,4195
41005,005,41,2023,423173,76,228,304,3638,3881
41007,007,41,2020,41162,85,0,85,98,93
41007,007,41,2021,41932,901,12,913,363,475
41007,007,41,2022,41652,-63,38,-25,323,554
41007,007,41,2023,41102,-334,27,-307,304,540
41009,009,41,2020,52724,98,0,98,143,115
41009,009,41,2021,53202,595,-4,591,462,576
41009,009,41,2022,53607,511,-1,510,505,596
41009,009,41,2023,53880,401,-6,395,442,563
41011,011,41,2020,64979,138,0,138,130,216
41011,011,41,2021,65126,630,5,635,559,1050
41011,011,41,2022,64923,437,41,478,518,1190
41011,011,41,2023,64212,-111,22,-89,507,1117
41013,013,41,2020,24929,223,0,223,53,63
41013,013,41,2021,25762,936,0,936,232,288
41013,013,41,2022,26377,659,1,660,250,333
41013,013,41,2023,26952,657,0,657,244,326
41015,015,41,2020,23519,174,0,174,37,119
41015,015,41,2021,23719,560,-3,557,153,487
41015,015,41,2022,23613,245,-7,238,152,505
41015,015,41,2023,23296,21,-10,11,144,469
41017,017,41,2020,199464,1237,0,1237,462,375
41017,017,41,2021,205283,5978,18,5996,1794,1706
41017,017,41,2022,206483,1049,119,1168,1893,1878
41017,017,41,2023,208513,1841,48,1889,1848,1729
41019,019,41,2020,111295,287,0,287,236,420
41019,019,41,2021,112149,1636,8,1644,1055,1820
41019,019,41,2022,112290,1181,15,1196,974,2048
41019,019,41,2023,112435,1078,4,1082,951,1889
41021,021,41,2020,2016,20,0,20,7,5
41021,021,41,2021,2013,1,0,1,17,24
41021,021,41,2022,2008,12,-1,11,20,36
41021,021,41,2023,2026,38,-1,37,18,36
41023,023,41,2020,7240,13,0,13,19,24
41023,023,41,2021,7288,90,0,90,65,105
41023,023,41,2022,7225,-17,6,-11,69,117
41023,023,41,2023,7215,30,5,35,69,115
41025,025,41,2020,7507,5,0,5,23,26
41025,025,41,2021,7602,121,0,121,76,98
41025,025,41,2022,7532,-29,-2,-31,78,116
41025,025,41,2023,7440,-59,-2,-61,78,109
41027,027,41,2020,23962,-31,0,-31,53,43
41027,027,41,2021,24086,80,8,88,221,203
41027,027,41,2022,24035,-80,11,-69,228,205
41027,027,41,2023,23745,-313,-2,-315,221,194
41029,029,41,2020,223620,410,1,411,546,606
41029,029,41,2021,224353,1245,10,1255,2113,2703
41029,029,41,2022,221669,-1826,36,-1790,2145,2997
41029,029,41,2023,220768,-216,-9,-225,2083,2758
41031,031,41,2020,24581,55,0,55,83,63
41031,031,41,2021,25105,599,1,600,258,315
41031,031,41,2022,25324,239,-1,238,281,311
41031,031,41,2023,25454,162,-3,159,262,293
41033,033,41,2020,88238,259,1,260,195,288
41033,033,41,2021,88637,988,15,1003,823,1424
41033,033,41,2022,87800,-101,43,-58,827,1560
41033,033,41,2023,87821,644,23,667,802,1446
41035,035,41,2020,69553,151,0,151,203,224
41035,035,41,2021,70246,954,12,966,721,990
41035,035,41,2022,70190,290,-3,287,769,1088
41035,035,41,2023,70003,93,-12,81,740,1009
41037,037,41,2020,8172,14,0,14,19,24
41037,037,41,2021,8290,155,10,165,86,129
41037,037,41,2022,8373,127,18,145,82,151
41037,037,41,2023,8293,-29,13,-16,81,145
41039,039,41,2020,383308,414,8,422,775,949
41039,039,41,2021,384121,1652,193,1845,3026,4251
41039,039,41,2022,382181,-482,438,-44,3108,4774
41039,039,41,2023,381181,154,255,409,3033,4439
41041,041,41,2020,50510,226,0,226,84,175
41041,041,41,2021,51013,839,14,853,378,702
41041,041,41,2022,50752,120,42,162,379,794
41041,041,41,2023,50821,442,32,474,356,765
41043,043,41,2020,128981,409,1,410,358,387
41043,043,41,2021,130120,1149,6,1155,1480,1528
41043,043,41,2022,130622,776,28,804,1433,1726
41043,043,41,2023,131496,1045,10,1055,1391,1576
41045,045,41,2020,31642,49,0,49,105,86
41045,045,41,2021,31677,30,11,41,379,404
41045,045,41,2022,31858,183,26,209,386,402
41045,045,41,2023,32044,188,11,199,365,376
41047,047,41,2020,346350,188,9,197,982,833
41047,047,41,2021,347851,532,130,662,3809,3189
41047,047,41,2022,346719,-1748,476,-1272,3910,3647
41047,047,41,2023,346741,-712,265,-447,3847,3380
41049,049,41,2020,12221,5,0,5,45,18
41049,049,41,2021,12359,61,14,75,176,117
41049,049,41,2022,12292,-130,29,-101,163,127
41049,049,41,2023,12302,-21,18,-3,139,126
41051,051,41,2020,816514,415,59,474,1956,1470
41051,051,41,2021,805319,-12357,691,-11666,7342,6747
41051,051,41,2022,794563,-12995,1931,-11064,7548,7206
41051,051,41,2023,789698,-6518,1158,-5360,7271,6731
41053,053,41,2020,87956,519,1,520,222,187
41053,053,41,2021,89373,1367,33,1400,833,802
41053,053,41,2022,89593,214,84,298,896,929
41053,053,41,2023,89805,192,43,235,864,885
41055,055,41,2020,1871,1,0,1,9,4
41055,055,41,2021,1907,37,0,37,23,24
41055,055,41,2022,1947,40,1,41,23,27
41055,055,41,2023,1951,7,1,8,22,25
41057,057,41,2020,27461,119,0,119,62,93
41057,057,41,2021,27808,474,4,478,250,364
41057,057,41,2022,27521,-55,-1,-56,215,430
41057,057,41,2023,27417,107,-3,104,209,419
41059,059,41,2020,80108,-60,0,-60,239,174
41059,059,41,2021,80153,-83,27,-56,909,862
41059,059,41,2022,80261,23,57,80,966,891
41059,059,41,2023,80053,-185,27,-158,789,842
41061,061,41,2020,26173,-24,0,-24,70,77
41061,061,41,2021,26288,150,6,156,249,304
41061,061,41,2022,26165,-21,8,-13,265,357
41061,061,41,2023,25944,-132,7,-125,255,351
41063,063,41,2020,7406,9,0,9,17,12
41063,063,41,2021,7558,191,0,191,56,88
41063,063,41,2022,7650,138,0,138,63,117
41063,063,41,2023,7674,80,0,80,60,115
41065,065,41,2020,26640,-25,0,-25,73,83
41065,065,41,2021,26739,189,4,193,253,353
41065,065,41,2022,26555,-47,5,-42,264,392
41065,065,41,2023,26333,-80,0,-80,248,388
41067,067,41,2020,601130,-168,78,-90,1507,911
41067,067,41,2021,602453,-2037,928,-1109,5967,3958
41067,067,41,2022,600086,-6795,2686,-4109,6174,4427
41067,067,41,2023,598865,-4782,1709,-3073,5973,4131
41069,069,41,2020,1454,15,0,15,2,4
41069,069,41,2021,1447,4,0,4,8,19
41069,069,41,2022,1435,3,0,3,7,21
41069,069,41,2023,1436,14,0,14,7,21
41071,071,41,2020,107945,194,3,197,254,249
41071,071,41,2021,108481,515,42,557,1031,1108
41071,071,41,2022,108362,-69,187,118,1062,1227
41071,071,41,2023,108644,296,119,415,1021,1156
42001,001,42,2020,103798,41,1,42,203,317
42001,001,42,2021,105686,2209,23,2232,935,1206
42001,001,42,2022,105959,546,57,603,956,1239
42001,001,42,2023,106748,909,76,985,953,1142
42003,003,42,2020,1249565,-888,63,-825,3105,3604
42003,003,42,2021,1245220,-2943,1124,-1819,12182,15576
42003,003,42,2022,1232605,-12288,2669,-9619,12401,15214
42003,003,42,2023,1224825,-8665,2674,-5991,11896,13684
42005,005,42,2020,65470,-30,0,-30,141,212
42005,005,42,2021,65212,89,3,92,541,938
42005,005,42,2022,64704,60,11,71,538,1078
42005,005,42,2023,64074,-192,12,-180,526,977
42007,007,42,2020,167873,-154,0,-154,368,590
42007,007,42,2021,166967,-126,15,-111,1547,2451
42007,007,42,2022,165737,-265,61,-204,1496,2426
42007,007,42,2023,165631,568,63,631,1463,2202
42009,009,42,2020,47568,14,0,14,118,143
42009,009,42,2021,47487,170,3,173,472,752
42009,009,42,2022,47421,193,15,208,470,718
42009,009,42,2023,47350,126,19,145,463,675
42011,011,42,2020,428671,-88,23,-65,1097,1327
42011,011,42,2021,429635,524,438,962,4375,4689
42011,011,42,2022,431573,1263,1060,2323,4589,4781
42011,011,42,2023,432821,-103,1086,983,4567,4304
42013,013,42,2020,122666,-82,0,-82,287,386
42013,013,42,2021,122150,180,17,197,1156,1956
42013,013,42,2022,120734,-703,49,-654,1137,1884
42013,013,42,2023,120273,46,54,100,1123,1685
42015,015,42,2020,59968,-16,0,-16,155,151
42015,015,42,2021,60137,266,11,277,659,798
42015,015,42,2022,59854,-79,41,-38,633,846
42015,015,42,2023,59695,-34,41,7,622,788
42017,017,42,2020,646173,141,16,157,1421,2095
42017,017,42,2021,647397,1910,374,2284,5337,6849
42017,017,42,2022,645557,-1276,827,-449,5692,6863
42017,017,42,2023,645984,-52,875,823,5821,6193
42019,019,42,2020,194077,313,0,313,458,505
42019,019,42,2021,196759,3524,34,3558,1662,2447
42019,019,42,2022,197368,1326,120,1446,1670,2430
42019,019,42,2023,198413,1530,120,1650,1615,2207
42021,021,42,2020,133211,-166,0,-166,310,416
42021,021,42,2021,132237,-8,8,0,1184,2235
42021,021,42,2022,131429,168,37,205,1132,2058
42021,021,42,2023,130668,-46,41,-5,1125,1876
42023,023,42,2020,4527,-12,0,-12,12,13
42023,023,42,2021,4458,-21,0,-21,26,74
42023,023,42,2022,4406,1,1,2,27,80
42023,023,42,2023,4380,27,1,28,27,80
42025,025,42,2020,64752,78,0,78,138,225
42025,025,42,2021,65522,1141,5,1146,625,982
42025,025,42,2022,65493,372,22,394,586,992
42025,025,42,2023,65458,267,25,292,583,911
42027,027,42,2020,157979,-209,24,-185,266,285
42027,027,42,2021,157984,-274,313,39,1122,1280
42027,027,42,2022,157533,-1181,842,-339,1113,1235
42027,027,42,2023,157795,-528,828,300,1088,1133
42029,029,42,2020,534830,145,34,179,1379,1309
42029,029,42,2021,540939,4691,411,5102,5294,4452
42029,029,42,2022,546638,3511,1088,4599,5711,4404
42029,029,42,2023,549784,279,1163,1442,5675,3971
42031,031,42,2020,37199,-17,0,-17,81,110
42031,031,42,2021,37594,619,5,624,368,581
42031,031,42,2022,37227,-118,22,-96,352,613
42031,031,42,2023,36970,-48,22,-26,344,576
42033,033,42,2020,80432,-49,0,-49,152,239
42033,033,42,2021,78335,-1556,18,-1538,663,1135
42033,033,42,2022,77824,73,28,101,683,1244
42033,033,42,2023,77090,-298,28,-270,675,1142
42035,035,42,2020,37370,-73,0,-73,110,112
42035,035,42,2021,38015,750,4,754,384,466
42035,035,42,2022,37776,-119,10,-109,374,492
42035,035,42,2023,37607,-56,10,-46,349,472
42037,037,42,2020,64686,16,0,16,131,202
42037,037,42,2021,64981,578,8,586,525,831
42037,037,42,2022,65289,602,30,632,546,881
42037,037,42,2023,65439,403,28,431,542,821
42039,039,42,2020,83807,-118,0,-118,197,210
42039,039,42,2021,83209,-303,13,-290,873,1203
42039,039,42,2022,82405,-455,18,-437,880,1244
42039,039,42,2023,82001,-152,18,-134,870,1141
42041,041,42,2020,260258,674,0,674,704,623
42041,041,42,2021,265537,5515,181,5696,2594,2853
42041,041,42,2022,268532,2741,454,3195,2595,2773
42041,041,42,2023,270738,1773,451,2224,2508,2504
42043,043,42,2020,286710,104,10,114,889,786
42043,043,42,2021,288252,810,316,1126,3318,3075
42043,043,42,2022,288687,-254,806,552,3237,3175
42043,043,42,2023,289234,-482,823,341,3081,2887
42045,045,42,2020,576356,-193,31,-162,1633,2097
42045,045,42,2021,576892,-718,646,-72,6179,6023
42045,045,42,2022,575873,-3017,1610,-1407,6428,5907
42045,045,42,2023,576720,-1788,1585,-203,6383,5362
42047,047,42,2020,30946,-33,0,-33,61,82
42047,047,42,2021,30796,9,0,9,246,422
42047,047,42,2022,30467,-103,-2,-105,259,473
42047,047,42,2023,30198,-81,-2,-83,259,445
42049,049,42,2020,270578,-241,2,-239,635,753
42049,049,42,2021,269257,-826,144,-682,2631,3428
42049,049,42,2022,268840,3,364,367,2767,3397
42049,049,42,2023,267571,-1332,366,-966,2738,3050
42051,051,42,2020,128588,-136,0,-136,299,411
42051,051,42,2021,127122,-547,32,-515,1239,2247
42051,051,42,2022,125368,-431,77,-354,976,2333
42051,051,42,2023,123915,-148,84,-64,723,2112
42053,053,42,2020,6958,0,0,0,8,25
42053,053,42,2021,6890,9,0,9,26,109
42053,053,42,2022,6603,-210,2,-208,23,117
42053,053,42,2023,6449,-62,2,-60,23,117
42055,055,42,2020,155949,3,6,9,400,452
42055,055,42,2021,156573,845,88,933,1646,2023
42055,055,42,2022,156951,519,231,750,1733,2036
42055,055,42,2023,157854,818,226,1044,1718,1855
42057,057,42,2020,14579,5,0,5,37,32
42057,057,42,2021,14551,18,0,18,144,197
42057,057,42,2022,14554,100,4,104,136,234
42057,057,42,2023,14468,6,4,10,135,231
42059,059,42,2020,35868,-65,0,-65,80,101
42059,059,42,2021,35284,-384,-2,-386,331,528
42059,059,42,2022,34529,-450,-4,-454,233,548
42059,059,42,2023,34357,181,-4,177,158,507
42061,061,42,2020,44049,-31,0,-31,96,110
42061,061,42,2021,43958,48,4,52,414,587
42061,061,42,2022,43297,-500,9,-491,420,609
42061,061,42,2023,43514,355,10,365,417,567
42063,063,42,2020,83151,-47,0,-47,195,245
42063,063,42,2021,83201,317,24,341,760,1097
42063,063,42,2022,83064,213,77,290,755,1132
42063,063,42,2023,83094,256,78,334,733,1038
42065,065,42,2020,44487,-17,0,-17,111,115
42065,065,42,2021,44120,-171,2,-169,460,682
42065,065,42,2022,43731,-152,3,-149,449,672
42065,065,42,2023,43612,50,3,53,445,617
42067,067,42,2020,23484,-33,0,-33,79,71
42067,067,42,2021,23355,-113,15,-98,300,344
42067,067,42,2022,23281,-14,29,15,282,358
42067,067,42,2023,23243,12,29,41,263,342
42069,069,42,2020,215539,-98,4,-94,567,898
42069,069,42,2021,216043,1078,158,1236,2027,2870
42069,069,42,2022,215750,271,402,673,2110,2954
42069,069,42,2023,216123,565,403,968,2093,2675
42071,071,42,2020,552821,-238,13,-225,1628,1682
42071,071,42,2021,556292,1625,423,2048,6976,5869
42071,071,42,2022,556660,-1389,881,-508,6980,5893
42071,071,42,2023,558589,-556,871,315,6887,5280
42073,073,42,2020,85970,-22,0,-22,228,325
42073,073,42,2021,85554,143,2,145,798,1420
42073,073,42,2022,84812,-48,7,-41,776,1424
42073,073,42,2023,84472,200,7,207,766,1313
42075,075,42,2020,143278,54,5,59,382,458
42075,075,42,2021,143759,647,115,762,1534,1889
42075,075,42,2022,143902,300,230,530,1587,1884
42075,075,42,2023,144252,250,226,476,1578,1707
42077,077,42,2020,374501,-41,46,5,1013,1198
42077,077,42,2021,375889,276,718,994,4015,3909
42077,077,42,2022,376274,-1208,1770,562,3968,3984
42077,077,42,2023,377754,-616,1745,1129,3940,3605
42079,079,42,2020,325217,3,7,10,766,1256
42079,079,42,2021,325942,1723,371,2094,3165,4709
42079,079,42,2022,326496,1202,953,2155,3199,4613
42079,079,42,2023,327388,914,930,1844,3191,4124
42081,081,42,2020,114125,-31,1,-30,285,341
42081,081,42,2021,113561,-221,45,-176,1164,1613
42081,081,42,2022,113034,7,106,113,1011,1584
42081,081,42,2023,112724,89,100,189,934,1436
42083,083,42,2020,40399,-27,0,-27,107,120
42083,083,42,2021,40317,120,10,130,347,579
42083,083,42,2022,39819,-192,10,-182,330,630
42083,083,42,2023,39519,-44,12,-32,324,592
42085,085,42,2020,110550,-57,0,-57,272,339
42085,085,42,2021,109958,111,6,117,987,1769
42085,085,42,2022,109137,43,0,43,1029,1826
42085,085,42,2023,108503,7,0,7,1014,1654
42087,087,42,2020,46137,-14,0,-14,152,146
42087,087,42,2021,46171,194,5,199,538,729
42087,087,42,2022,45984,-45,7,-38,543,663
42087,087,42,2023,45922,17,7,24,535,622
42089,089,42,2020,168314,63,2,65,370,478
42089,089,42,2021,168676,611,54,665,1415,1823
42089,089,42,2022,167451,-836,122,-714,1349,1809
42089,089,42,2023,166053,-1165,120,-1045,1338,1702
42091,091,42,2020,856998,733,50,783,2161,2747
42091,091,42,2021,864249,6430,676,7106,8332,8483
42091,091,42,2022,865044,-853,1692,839,8753,8407
42091,091,42,2023,868742,880,1703,2583,8700,7570
42093,093,42,2020,18131,-22,0,-22,53,48
42093,093,42,2021,18089,1,11,12,214,280
42093,093,42,2022,18054,4,40,44,182,250
42093,093,42,2023,17860,-175,40,-135,180,237
42095,095,42,2020,312784,102,7,109,696,1066
42095,095,42,2021,318157,6038,217,6255,2817,3520
42095,095,42,2022,317900,37,609,646,2798,3538
42095,095,42,2023,319091,1019,599,1618,2787,3201
42097,097,42,2020,91545,-34,0,-34,211,298
42097,097,42,2021,90989,-62,19,-43,902,1465
42097,097,42,2022,90123,-413,30,-383,885,1350
42097,097,42,2023,90120,327,29,356,874,1233
42099,099,42,2020,45825,-24,0,-24,126,119
42099,099,42,2021,45943,181,3,184,480,570
42099,099,42,2022,46113,278,42,320,458,584
42099,099,42,2023,46083,35,45,80,433,544
42101,101,42,2020,1600684,-3242,272,-2970,4897,5480
42101,101,42,2021,1589623,-16703,2689,-14014,19411,16992
42101,101,42,2022,1566836,-33153,7122,-26031,19276,16336
42101,101,42,2023,1550542,-27667,7038,-20629,19208,14689
42103,103,42,2020,58574,117,0,117,93,186
42103,103,42,2021,59997,1713,10,1723,399,624
42103,103,42,2022,60576,767,50,817,416,674
42103,103,42,2023,61247,857,48,905,420,649
42105,105,42,2020,16383,-3,0,-3,44,57
42105,105,42,2021,16311,-10,0,-10,165,235
42105,105,42,2022,16206,39,0,39,168,302
42105,105,42,2023,15999,-83,0,-83,167,289
42107,107,42,2020,142963,54,0,54,325,509
42107,107,42,2021,143157,1199,25,1224,1221,2299
42107,107,42,2022,143188,935,84,1019,1199,2128
42107,107,42,2023,143786,1268,95,1363,1187,1936
42109,109,42,2020,39733,-12,0,-12,98,93
42109,109,42,2021,39734,11,2,13,408,443
42109,109,42,2022,39506,-216,20,-196,420,446
42109,109,42,2023,39717,207,19,226,406,421
42111,111,42,2020,74019,-48,0,-48,158,242
42111,111,42,2021,72989,-460,1,-459,599,1172
42111,111,42,2022,72629,265,4,269,597,1196
42111,111,42,2023,72197,72,5,77,576,1086
42113,113,42,2020,5828,6,0,6,8,25
42113,113,42,2021,5859,113,0,113,50,129
42113,113,42,2022,5845,74,4,78,42,133
42113,113,42,2023,5834,70,11,81,37,131
42115,115,42,2020,38346,-19,0,-19,86,158
42115,115,42,2021,38417,244,-1,243,343,526
42115,115,42,2022,38139,-56,9,-47,369,579
42115,115,42,2023,38109,144,11,155,360,543
42117,117,42,2020,41025,-31,0,-31,105,106
42117,117,42,2021,41308,460,3,463,390,565
42117,117,42,2022,40967,-126,2,-124,397,599
42117,117,42,2023,40840,63,3,66,373,566
42119,119,42,2020,42646,-27,-1,-28,103,115
42119,119,42,2021,42469,-130,12,-118,385,469
42119,119,42,2022,42690,318,36,354,351,489
42119,119,42,2023,42042,-579,37,-542,345,457
42121,121,42,2020,50365,-59,0,-59,102,143
42121,121,42,2021,50040,13,6,19,461,843
42121,121,42,2022,49734,131,8,139,465,877
42121,121,42,2023,49431,39,8,47,459,805
42123,123,42,2020,38511,-17,0,-17,65,125
42123,123,42,2021,38161,-128,2,-126,375,614
42123,123,42,2022,37818,0,10,10,359,689
42123,123,42,2023,37572,27,11,38,354,637
42125,125,42,2020,209434,164,0,164,491,640
42125,125,42,2021,210054,1584,41,1625,1856,2927
42125,125,42,2022,209940,924,97,1021,1936,2964
42125,125,42,2023,210232,996,103,1099,1867,2664
42127,127,42,2020,51151,59,0,59,105,166
42127,127,42,2021,51188,387,6,393,409,779
42127,127,42,2022,51084,339,3,342,402,827
42127,127,42,2023,51262,552,2,554,396,774
42129,129,42,2020,354346,35,0,35,700,1140
42129,129,42,2021,353717,1677,39,1716,2842,5363
42129,129,42,2022,351998,837,90,927,2855,5279
42129,129,42,2023,351163,1017,90,1107,2788,4710
42131,131,42,2020,26032,-23,0,-23,61,80
42131,131,42,2021,26106,215,3,218,219,369
42131,131,42,2022,26024,93,6,99,249,416
42131,131,42,2023,25902,17,7,24,249,396
42133,133,42,2020,456720,167,10,177,1089,1151
42133,133,42,2021,459183,2491,251,2742,4783,5299
42133,133,42,2022,461049,1864,607,2471,4862,5249
42133,133,42,2023,464640,2889,612,3501,4812,4706
44001,001,44,2020,50784,24,0,24,95,139
44001,001,44,2021,50774,229,5,234,320,595
44001,001,44,2022,50307,-223,-6,-229,358,589
44001,001,44,2023,50255,164,18,182,342,573
44003,003,44,2020,170406,201,0,201,365,552
44003,003,44,2021,171077,1165,84,1249,1457,2098
44003,003,44,2022,171134,531,148,679,1542,2104
44003,003,44,2023,171278,319,339,658,1458,1977
44005,005,44,2020,85515,-112,3,-109,163,188
44005,005,44,2021,85608,267,12,279,581,794
44005,005,44,2022,84721,-733,57,-676,631,830
44005,005,44,2023,83832,-818,147,-671,632,845
44007,007,44,2020,659963,-621,73,-548,1738,2144
44007,007,44,2021,658782,-2856,909,-1947,6855,6477
44007,007,44,2022,657424,-4229,2340,-1889,6975,6208
44007,007,44,2023,660615,-2798,4985,2187,6744,5740
44009,009,44,2020,129776,78,1,79,185,366
44009,009,44,2021,130851,1560,62,1622,817,1368
44009,009,44,2022,130256,-201,124,-77,880,1347
44009,009,44,2023,129982,-91,288,197,830,1299
45001,001,45,2020,24266,-21,0,-21,63,73
45001,001,45,2021,24262,180,4,184,207,402
45001,001,45,2022,24338,262,11,273,221,423
45001,001,45,2023,24434,276,8,284,217,404
45003,003,45,2020,169168,449,5,454,427,516
45003,003,45,2021,171247,2302,102,2404,1847,2160
45003,003,45,2022,174228,2775,157,2932,2166,2172
45003,003,45,2023,177130,2727,130,2857,2272,2225
45005,005,45,2020,7934,-80,0,-80,18,32
45005,005,45,2021,7714,-136,1,-135,63,145
45005,005,45,2022,7418,-224,1,-223,66,148
45005,005,45,2023,7369,33,1,34,68,152
45007,007,45,2020,204195,595,5,600,499,629
45007,007,45,2021,206885,3554,84,3638,2206,3090
45007,007,45,2022,209652,3251,207,3458,2287,3053
45007,007,45,2023,213076,3654,177,3831,2265,2670
45009,009,45,2020,13260,-33,0,-33,29,46
45009,009,45,2021,13117,-24,6,-18,136,270
45009,009,45,2022,12950,-95,31,-64,136,241
45009,009,45,2023,12974,97,28,125,133,234
45011,011,45,2020,20586,-10,0,-10,74,71
45011,011,45,2021,20594,68,1,69,277,351
45011,011,45,2022,20471,-92,35,-57,258,317
45011,011,45,2023,20447,-2,32,30,260,315
45013,013,45,2020,187815,765,22,787,471,465
45013,013,45,2021,191997,4415,160,4575,1806,2016
45013,013,45,2022,196147,3693,435,4128,1906,2074
45013,013,45,2023,198979,2420,402,2822,1910,1906
45015,015,45,2020,231533,1515,32,1547,675,425
45015,015,45,2021,236857,4509,245,4754,2766,2114
45015,015,45,2022,244952,6555,583,7138,2858,2166
45015,015,45,2023,255217,8801,534,9335,2826,1916
45017,017,45,2020,14114,31,0,31,20,60
45017,017,45,2021,14138,145,0,145,120,242
45017,017,45,2022,14197,169,0,169,123,237
45017,017,45,2023,14186,97,0,97,121,230
45019,019,45,2020,409899,1157,37,1194,1186,907
45019,019,45,2021,414514,3278,470,3748,4867,4036
45019,019,45,2022,419350,2438,1155,3593,5019,3836
45019,019,45,2023,424367,2440,1028,3468,4931,3397
45021,021,45,2020,56220,13,2,15,142,179
45021,021,45,2021,56098,12,35,47,669,884
45021,021,45,2022,56121,286,46,332,656,935
45021,021,45,2023,56714,728,51,779,659,843
45023,023,45,2020,32284,49,0,49,76,139
45023,023,45,2021,32148,44,5,49,342,545
45023,023,45,2022,31993,59,15,74,324,541
45023,023,45,2023,32226,399,13,412,334,516
45025,025,45,2020,43256,22,0,22,107,159
45025,025,45,2021,43337,240,24,264,486,689
45025,025,45,2022,43741,467,69,536,507,638
45025,025,45,2023,44031,345,74,419,521,649
45027,027,45,2020,30841,-185,0,-185,80,163
45027,027,45,2021,30961,405,7,412,300,577
45027,027,45,2022,30927,230,18,248,290,569
45027,027,45,2023,31004,307,19,326,287,539
45029,029,45,2020,38537,-21,1,-20,118,176
45029,029,45,2021,38459,133,28,161,433,686
45029,029,45,2022,38580,341,53,394,458,738
45029,029,45,2023,38874,470,60,530,456,693
45031,031,45,2020,62848,-1,1,0,172,249
45031,031,45,2021,62725,189,14,203,760,1129
45031,031,45,2022,62436,66,70,136,731,1117
45031,031,45,2023,62416,189,61,250,726,997
45033,033,45,2020,28277,6,0,6,80,114
45033,033,45,2021,27970,-173,7,-166,389,541
45033,033,45,2022,27747,-129,37,-92,385,507
45033,033,45,2023,27698,20,32,52,376,478
45035,035,45,2020,162043,571,13,584,454,323
45035,035,45,2021,163452,824,147,971,1923,1585
45035,035,45,2022,166050,1932,353,2285,1937,1611
45035,035,45,2023,169833,3021,303,3324,1919,1447
45037,037,45,2020,25671,57,1,58,36,69
45037,037,45,2021,26274,777,25,802,178,346
45037,037,45,2022,26959,709,75,784,197,325
45037,037,45,2023,27607,729,79,808,204,363
45039,039,45,2020,20887,-30,0,-30,50,92
45039,039,45,2021,20695,7,0,7,192,401
45039,039,45,2022,20450,-34,-2,-36,198,396
45039,039,45,2023,20422,154,-2,152,197,377
45041,041,45,2020,136817,-164,2,-162,383,471
45041,041,45,2021,136401,27,38,65,1599,2165
45041,041,45,2022,136740,749,141,890,1598,2076
45041,041,45,2023,137214,594,120,714,1568,1806
45043,043,45,2020,63509,219,0,219,130,219
45043,043,45,2021,63925,1088,13,1101,467,1121
45043,043,45,2022,64669,1226,45,1271,486,1059
45043,043,45,2023,65731,1512,39,1551,480,968
45045,045,45,2020,527249,1281,73,1354,1545,1240
45045,045,45,2021,534648,5855,891,6746,6344,5757
45045,045,45,2022,547845,9981,2144,12125,6609,5835
45045,045,45,2023,558036,6908,1868,8776,6521,5127
45047,047,45,2020,69390,50,2,52,191,220
45047,047,45,2021,69126,-43,39,-4,764,1069
45047,047,45,2022,69223,313,86,399,750,1025
45047,047,45,2023,69460,368,74,442,741,948
45049,049,45,2020,18515,-20,0,-20,43,65
45049,049,45,2021,18244,-186,4,-182,205,294
45049,049,45,2022,18136,-30,32,2,195,296
45049,049,45,2023,18122,49,33,82,195,289
45051,051,45,2020,353765,3333,19,3352,793,1055
45051,051,45,2021,366093,14837,249,15086,3102,5152
45051,051,45,2022,383147,17294,733,18027,3237,5204
45051,051,45,2023,397478,15061,663,15724,3199,4611
45053,053,45,2020,29150,355,2,357,98,69
45053,053,45,2021,30431,1294,42,1336,364,346
45053,053,45,2022,31986,1350,97,1447,401,373
45053,053,45,2023,33544,1429,102,1531,408,385
45055,055,45,2020,65590,222,2,224,164,204
45055,055,45,2021,66205,842,11,853,718,956
45055,055,45,2022,67850,1804,48,1852,740,1001
45055,055,45,2023,69905,2209,44,2253,724,915
45057,057,45,2020,96588,621,3,624,259,263
45057,057,45,2021,100529,4232,30,4262,1065,1179
45057,057,45,2022,104724,3859,164,4023,1136,1163
45057,057,45,2023,108215,3280,153,3433,1248,1190
45059,059,45,2020,67634,158,4,162,160,226
45059,059,45,2021,67835,539,41,580,731,1128
45059,059,45,2022,67951,453,85,538,730,1146
45059,059,45,2023,68873,1143,84,1227,723,1032
45061,061,45,2020,16539,78,0,78,37,97
45061,061,45,2021,16272,-150,25,-125,156,301
45061,061,45,2022,16161,-25,71,46,150,300
45061,061,45,2023,15967,-112,61,-51,149,293
45063,063,45,2020,295047,1050,9,1059,759,742
45063,063,45,2021,300650,5557,161,5718,3295,3316
45063,063,45,2022,305105,3885,487,4372,3389,3292
45063,063,45,2023,309528,3552,421,3973,3379,2905
45065,065,45,2020,9518,19,0,19,9,36
45065,065,45,2021,9764,403,0,403,61,194
45065,065,45,2022,9741,86,0,86,71,178
45065,065,45,2023,9941,300,0,300,75,177
45067,067,45,2020,29086,-52,0,-52,79,124
45067,067,45,2021,28852,-44,0,-44,339,550
45067,067,45,2022,28471,-172,-2,-174,323,521
45067,067,45,2023,28508,214,-2,212,320,497
45069,069,45,2020,26490,-130,0,-130,62,90
45069,069,45,2021,26235,-89,-2,-91,256,437
45069,069,45,2022,26006,-63,-4,-67,267,419
45069,069,45,2023,25704,-135,-3,-138,287,451
45071,071,45,2020,37731,29,0,29,93,121
45071,071,45,2021,37968,397,45,442,399,607
45071,071,45,2022,38315,387,112,499,419,573
45071,071,45,2023,38825,535,97,632,418,540
45073,073,45,2020,78784,234,2,236,167,207
45073,073,45,2021,79318,1048,26,1074,634,1163
45073,073,45,2022,80160,1276,95,1371,633,1201
45073,073,45,2023,81221,1437,85,1522,631,1089
45075,075,45,2020,83954,-136,0,-136,198,328
45075,075,45,2021,82815,-591,19,-572,831,1419
45075,075,45,2022,83101,825,59,884,820,1434
45075,075,45,2023,82820,150,53,203,815,1301
45077,077,45,2020,131684,276,4,280,304,331
45077,077,45,2021,132097,862,92,954,1115,1726
45077,077,45,2022,133470,1682,241,1923,1163,1720
45077,077,45,2023,135495,2176,206,2382,1145,1499
45079,079,45,2020,415671,-720,66,-654,1127,942
45079,079,45,2021,417294,214,461,675,4601,3970
45079,079,45,2022,421526,2581,1179,3760,4603,4004
45079,079,45,2023,425138,1512,1019,2531,4599,3522
45081,081,45,2020,18828,-13,0,-13,50,68
45081,081,45,2021,18822,34,26,60,229,309
45081,081,45,2022,18984,148,60,208,241,287
45081,081,45,2023,19123,117,56,173,242,276
45083,083,45,2020,329379,1412,7,1419,886,880
45083,083,45,2021,335397,6452,212,6664,3790,4316
45083,083,45,2022,345948,9878,725,10603,3865,4311
45083,083,45,2023,356698,10060,645,10705,3840,3772
45085,085,45,2020,105476,-110,9,-101,348,339
45085,085,45,2021,104854,-523,15,-508,1347,1516
45085,085,45,2022,103936,-752,70,-682,1334,1536
45085,085,45,2023,104165,215,66,281,1310,1364
45087,087,45,2020,27181,-21,0,-21,72,115
45087,087,45,2021,27010,38,4,42,261,494
45087,087,45,2022,26739,7,16,23,243,519
45087,087,45,2023,26629,135,15,150,243,504
45089,089,45,2020,30914,-46,0,-46,64,128
45089,089,45,2021,30418,-230,16,-214,279,567
45089,089,45,2022,30113,-48,38,-10,264,545
45089,089,45,2023,29891,0,33,33,263,519
45091,091,45,2020,284028,1950,12,1962,694,598
45091,091,45,2021,289201,4756,205,4961,2896,2650
45091,091,45,2022,294201,4048,396,4444,3118,2574
45091,091,45,2023,298320,2948,329,3277,3376,2521
46003,003,46,2020,2735,-8,0,-8,6,10
46003,003,46,2021,2736,2,2,4,45,50
46003,003,46,2022,2762,21,9,30,40,44
46003,003,46,2023,2782,20,5,25,38,44
46005,005,46,2020,19165,-22,6,-16,75,46
46005,005,46,2021,19181,-197,152,-45,270,210
46005,005,46,2022,19488,-264,480,216,282,189
46005,005,46,2023,19591,-252,257,5,278,179
46007,007,46,2020,3388,4,0,4,14,8
46007,007,46,2021,3389,4,5,9,36,44
46007,007,46,2022,3333,-71,12,-59,42,40
46007,007,46,2023,3305,-41,5,-36,50,43
46009,009,46,2020,6970,-17,0,-17,13,20
46009,009,46,2021,7000,74,1,75,69,117
46009,009,46,2022,7064,90,3,93,74,103
46009,009,46,2023,7065,17,4,21,74,95
46011,011,46,2020,34343,-66,5,-61,90,56
46011,011,46,2021,34696,91,117,208,366,244
46011,011,46,2022,35491,308,334,642,383,222
46011,011,46,2023,35980,123,193,316,385,214
46013,013,46,2020,38225,-76,4,-72,99,100
46013,013,46,2021,38117,-168,59,-109,414,435
46013,013,46,2022,37901,-281,62,-219,401,393
46013,013,46,2023,37733,-277,57,-220,412,363
46015,015,46,2020,5241,5,0,5,10,15
46015,015,46,2021,5243,-27,6,-21,67,48
46015,015,46,2022,5301,40,9,49,61,51
46015,015,46,2023,5311,-12,7,-5,63,48
46017,017,46,2020,1939,-5,0,-5,7,9
46017,017,46,2021,1894,-20,0,-20,30,54
46017,017,46,2022,1854,-48,0,-48,41,34
46017,017,46,2023,1884,33,0,33,38,41
46019,019,46,2020,10293,27,0,27,44,24
46019,019,46,2021,10542,251,-1,250,126,117
46019,019,46,2022,10790,238,-2,236,133,131
46019,019,46,2023,10863,54,-2,52,135,115
46021,021,46,2020,1378,-1,0,-1,5,2
46021,021,46,2021,1376,8,0,8,11,22
46021,021,46,2022,1355,-17,2,-15,17,26
46021,021,46,2023,1340,-11,4,-7,19,25
46023,023,46,2020,9368,-11,0,-11,29,32
46023,023,46,2021,9184,-188,2,-186,142,136
46023,023,46,2022,9232,7,3,10,144,100
46023,023,46,2023,9240,-47,3,-44,143,93
46025,025,46,2020,3853,7,0,7,17,14
46025,025,46,2021,3873,-6,1,-5,62,37
46025,025,46,2022,3923,27,4,31,62,42
46025,025,46,2023,3948,-22,23,1,59,35
46027,027,46,2020,15000,23,0,23,25,20
46027,027,46,2021,15165,115,19,134,134,111
46027,027,46,2022,15301,61,61,122,131,114
46027,027,46,2023,15431,83,23,106,137,113
46029,029,46,2020,28351,3,3,6,79,62
46029,029,46,2021,28484,129,20,149,299,330
46029,029,46,2022,28736,197,19,216,325,284
46029,029,46,2023,28971,136,41,177,326,268
46031,031,46,2020,3895,-16,0,-16,17,10
46031,031,46,2021,3849,-59,0,-59,85,72
46031,031,46,2022,3817,-40,0,-40,74,64
46031,031,46,2023,3782,-45,0,-45,78,68
46033,033,46,2020,8335,32,0,32,19,31
46033,033,46,2021,8639,350,3,353,68,99
46033,033,46,2022,9021,368,10,378,76,97
46033,033,46,2023,9117,107,4,111,77,92
46035,035,46,2020,19956,-20,0,-20,63,37
46035,035,46,2021,19899,-42,6,-36,237,266
46035,035,46,2022,19907,22,11,33,228,242
46035,035,46,2023,19922,-63,79,16,229,230
46037,037,46,2020,5444,-11,0,-11,16,13
46037,037,46,2021,5426,34,4,38,36,95
46037,037,46,2022,5475,74,11,85,45,80
46037,037,46,2023,5451,-1,7,6,46,77
46039,039,46,2020,4295,0,0,0,9,8
46039,039,46,2021,4290,-19,0,-19,59,46
46039,039,46,2022,4361,62,0,62,56,47
46039,039,46,2023,4354,-15,0,-15,56,47
46041,041,46,2020,5225,-27,0,-27,29,19
46041,041,46,2021,5223,-23,0,-23,115,97
46041,041,46,2022,5142,-99,3,-96,109,97
46041,041,46,2023,5208,61,1,62,108,102
46043,043,46,2020,2834,-3,0,-3,13,8
46043,043,46,2021,2811,-13,0,-13,40,51
46043,043,46,2022,2787,-27,1,-26,44,42
46043,043,46,2023,2838,36,8,44,45,38
46045,045,46,2020,3988,-12,0,-12,21,7
46045,045,46,2021,4034,46,3,49,58,62
46045,045,46,2022,4071,25,7,32,59,54
46045,045,46,2023,4057,-24,2,-22,56,48
46047,047,46,2020,6970,22,0,22,10,28
46047,047,46,2021,7213,336,0,336,47,125
46047,047,46,2022,7397,272,-1,271,48,147
46047,047,46,2023,7393,86,-1,85,50,138
46049,049,46,2020,2132,-3,0,-3,12,7
46049,049,46,2021,2124,1,0,1,32,43
46049,049,46,2022,2122,3,0,3,31,35
46049,049,46,2023,2151,31,0,31,31,31
46051,051,46,2020,7538,-22,0,-22,16,16
46051,051,46,2021,7552,19,9,28,95,113
46051,051,46,2022,7486,-69,14,-55,86,99
46051,051,46,2023,7553,25,46,71,94,99
46053,053,46,2020,4003,12,0,12,10,14
46053,053,46,2021,3957,-10,0,-10,48,85
46053,053,46,2022,3999,48,1,49,47,52
46053,053,46,2023,4018,20,7,27,47,54
46055,055,46,2020,1866,-2,0,-2,1,5
46055,055,46,2021,1835,-23,0,-23,19,26
46055,055,46,2022,1834,0,0,0,25,26
46055,055,46,2023,1851,18,0,18,25,26
46057,057,46,2020,6166,-15,0,-15,37,23
46057,057,46,2021,6264,48,6,54,129,86
46057,057,46,2022,6394,14,31,45,142,55
46057,057,46,2023,6451,-50,20,-30,140,53
46059,059,46,2020,3140,-10,0,-10,14,5
46059,059,46,2021,3079,-37,2,-35,36,61
46059,059,46,2022,3112,49,5,54,38,59
46059,059,46,2023,3107,7,3,10,39,55
46061,061,46,2020,3463,0,0,0,8,6
46061,061,46,2021,3510,29,0,29,43,22
46061,061,46,2022,3479,-47,9,-38,41,32
46061,061,46,2023,3471,-22,5,-17,39,30
46063,063,46,2020,1308,0,0,0,3,4
46063,063,46,2021,1325,8,1,9,18,10
46063,063,46,2022,1339,5,2,7,18,10
46063,063,46,2023,1324,-27,1,-26,17,6
46065,065,46,2020,17740,-40,0,-40,63,52
46065,065,46,2021,17760,3,0,3,208,199
46065,065,46,2022,17681,-94,1,-93,218,201
46065,065,46,2023,17624,-85,-3,-88,219,189
46067,067,46,2020,7426,-4,0,-4,19,16
46067,067,46,2021,7377,1,2,3,82,136
46067,067,46,2022,7351,-10,4,-6,96,115
46067,067,46,2023,7394,41,9,50,96,102
46069,069,46,2020,1250,-3,0,-3,3,10
46069,069,46,2021,1230,-17,0,-17,18,22
46069,069,46,2022,1199,-18,0,-18,13,25
46069,069,46,2023,1186,-1,0,-1,13,25
46071,071,46,2020,2799,-12,0,-12,17,10
46071,071,46,2021,2864,25,2,27,87,51
46071,071,46,2022,2832,-56,5,-51,63,46
46071,071,46,2023,2776,-79,2,-77,62,39
46073,073,46,2020,1648,-7,0,-7,1,10
46073,073,46,2021,1645,1,1,2,18,22
46073,073,46,2022,1662,10,2,12,19,14
46073,073,46,2023,1660,-3,1,-2,18,18
46075,075,46,2020,926,6,0,6,2,1
46075,075,46,2021,879,-39,0,-39,8,14
46075,075,46,2022,875,-1,0,-1,9,12
46075,075,46,2023,855,-15,0,-15,8,12
46077,077,46,2020,5199,22,0,22,15,15
46077,077,46,2021,5201,-4,1,-3,73,70
46077,077,46,2022,5279,84,6,90,66,78
46077,077,46,2023,5276,-1,4,3,66,72
46079,079,46,2020,11017,-58,0,-58,37,22
46079,079,46,2021,10864,-154,0,-154,117,116
46079,079,46,2022,10940,91,0,91,109,122
46079,079,46,2023,11031,83,10,93,109,108
46081,081,46,2020,25844,73,2,75,57,57
46081,081,46,2021,26162,400,19,419,204,297
46081,081,46,2022,27240,1059,45,1104,203,294
46081,081,46,2023,28053,857,22,879,203,272
46083,083,46,2020,65648,363,1,364,207,64
46083,083,46,2021,67992,1966,48,2014,767,367
46083,083,46,2022,71024,2313,144,2457,837,355
46083,083,46,2023,73238,1637,63,1700,834,328
46085,085,46,2020,3704,-9,0,-9,6,10
46085,085,46,2021,3763,25,1,26,69,37
46085,085,46,2022,3705,-90,13,-77,65,51
46085,085,46,2023,3705,-27,6,-21,68,45
46087,087,46,2020,5670,-16,0,-16,27,21
46087,087,46,2021,5718,47,1,48,75,76
46087,087,46,2022,5768,45,0,45,83,77
46087,087,46,2023,5809,36,0,36,80,74
46089,089,46,2020,2402,-5,0,-5,5,7
46089,089,46,2021,2416,29,0,29,24,39
46089,089,46,2022,2396,-3,0,-3,22,39
46089,089,46,2023,2334,-44,0,-44,20,37
46091,091,46,2020,4308,-9,0,-9,17,9
46091,091,46,2021,4324,-9,2,-7,71,49
46091,091,46,2022,4363,32,4,36,62,59
46091,091,46,2023,4390,6,13,19,65,56
46093,093,46,2020,29899,26,4,30,62,44
46093,093,46,2021,30289,352,14,366,261,238
46093,093,46,2022,30702,370,13,383,276,263
46093,093,46,2023,30954,212,9,221,272,244
46095,095,46,2020,1920,4,0,4,8,10
46095,095,46,2021,1898,-17,0,-17,28,32
46095,095,46,2022,1873,-19,0,-19,29,34
46095,095,46,2023,1851,-18,0,-18,30,35
46097,097,46,2020,2304,-3,0,-3,10,2
46097,097,46,2021,2311,26,0,26,26,45
46097,097,46,2022,2285,-13,0,-13,26,37
46097,097,46,2023,2280,6,0,6,27,38
46099,099,46,2020,197695,116,33,149,729,448
46099,099,46,2021,199904,793,462,1255,2706,1829
46099,099,46,2022,203845,1669,1128,2797,2812,1730
46099,099,46,2023,206930,1123,649,1772,2804,1512
46101,101,46,2020,6335,-12,0,-12,25,9
46101,101,46,2021,6305,-30,1,-29,78,82
46101,101,46,2022,6382,21,34,55,94,69
46101,101,46,2023,6450,23,20,43,93,68
46102,102,46,2020,13648,-37,0,-37,60,45
46102,102,46,2021,13559,-125,0,-125,255,220
46102,102,46,2022,13508,-94,0,-94,243,196
46102,102,46,2023,13434,-121,0,-121,242,197
46103,103,46,2020,109566,244,7,251,354,259
46103,103,46,2021,111886,2123,82,2205,1440,1261
46103,103,46,2022,114306,1996,74,2070,1455,1219
46103,103,46,2023,115903,1213,35,1248,1450,1108
46105,105,46,2020,2842,-3,0,-3,8,4
46105,105,46,2021,2825,-1,0,-1,36,54
46105,105,46,2022,2809,-4,0,-4,28,40
46105,105,46,2023,2834,31,0,31,34,38
46107,107,46,2020,2473,6,0,6,6,11
46107,107,46,2021,2471,14,0,14,22,36
46107,107,46,2022,2446,-11,0,-11,21,33
46107,107,46,2023,2413,-24,0,-24,23,33
46109,109,46,2020,10250,-25,0,-25,33,27
46109,109,46,2021,10172,-94,2,-92,136,123
46109,109,46,2022,10139,-48,6,-42,135,127
46109,109,46,2023,10206,35,2,37,142,112
46111,111,46,2020,2326,-10,0,-10,7,2
46111,111,46,2021,2373,51,2,53,24,29
46111,111,46,2022,2403,22,7,29,35,33
46111,111,46,2023,2399,-13,4,-9,35,31
46115,115,46,2020,6340,-20,0,-20,21,14
46115,115,46,2021,6261,-55,1,-54,69,94
46115,115,46,2022,6228,-34,2,-32,78,79
46115,115,46,2023,6166,-57,4,-53,75,83
46117,117,46,2020,2971,-5,0,-5,2,6
46117,117,46,2021,3035,54,0,54,31,21
46117,117,46,2022,3017,-16,0,-16,32,32
46117,117,46,2023,3043,28,0,28,30,32
46119,119,46,2020,1451,3,0,3,4,3
46119,119,46,2021,1471,18,1,19,19,17
46119,119,46,2022,1482,-1,15,14,12,15
46119,119,46,2023,1494,6,9,15,12,14
46121,121,46,2020,9323,-27,0,-27,48,23
46121,121,46,2021,9301,-103,16,-87,206,141
46121,121,46,2022,9233,-193,51,-142,198,129
46121,121,46,2023,9199,-140,29,-111,195,119
46123,123,46,2020,5611,-13,0,-13,14,18
46123,123,46,2021,5580,-31,3,-28,69,73
46123,123,46,2022,5579,-6,5,-1,66,62
46123,123,46,2023,5621,35,1,36,66,60
46125,125,46,2020,8675,15,0,15,17,21
46125,125,46,2021,8679,48,6,54,89,139
46125,125,46,2022,8888,174,49,223,94,110
46125,125,46,2023,9027,117,37,154,92,107
46127,127,46,2020,16860,27,0,27,46,33
46127,127,46,2021,16876,-12,14,2,170,169
46127,127,46,2022,17063,152,23,175,158,141
46127,127,46,2023,17183,23,36,59,192,129
46129,129,46,2020,5294,-22,0,-22,13,12
46129,129,46,2021,5260,-30,2,-28,66,75
46129,129,46,2022,5286,31,-2,29,78,77
46129,129,46,2023,5269,-22,-2,-24,76,69
46135,135,46,2020,23286,-27,0,-27,66,65
46135,135,46,2021,23353,56,0,56,247,250
46135,135,46,2022,23412,47,51,98,244,269
46135,135,46,2023,23517,81,25,106,243,245
46137,137,46,2020,2395,-27,0,-27,12,1
46137,137,46,2021,2385,2,0,2,28,42
46137,137,46,2022,2394,1,1,2,42,32
46137,137,46,2023,2322,-79,1,-78,41,35
47001,001,47,2020,77320,224,0,224,206,256
47001,001,47,2021,77615,701,25,726,749,1192
47001,001,47,2022,78929,1671,33,1704,831,1294
47001,001,47,2023,80234,1561,64,1625,830,1154
47003,003,47,2020,50385,89,0,89,174,123
47003,003,47,2021,51184,724,21,745,731,671
47003,003,47,2022,51964,658,73,731,711,677
47003,003,47,2023,53055,863,125,988,713,612
47005,005,47,2020,15855,15,0,15,34,61
47005,005,47,2021,15837,162,0,162,146,327
47005,005,47,2022,15994,333,-1,332,159,341
47005,005,47,2023,16103,267,-1,266,157,317
47007,007,47,2020,14956,40,0,40,35,37
47007,007,47,2021,14837,-68,11,-57,121,177
47007,007,47,2022,14824,20,20,40,133,187
47007,007,47,2023,15060,277,5,282,132,179
47009,009,47,2020,135657,474,0,474,318,410
47009,009,47,2021,137611,2559,35,2594,1238,1831
47009,009,47,2022,139810,2729,33,2762,1304,1941
47009,009,47,2023,141456,2004,47,2051,1304,1708
47011,011,47,2020,108828,236,0,236,271,312
47011,011,47,2021,109755,1245,49,1294,1131,1522
47011,011,47,2022,110539,1074,132,1206,1199,1617
47011,011,47,2023,111579,1062,218,1280,1183,1423
47013,013,47,2020,39301,59,0,59,108,145
47013,013,47,2021,39455,415,5,420,459,731
47013,013,47,2022,39564,452,4,456,426,791
47013,013,47,2023,40223,928,10,938,430,711
47015,015,47,2020,14565,75,0,75,37,49
47015,015,47,2021,14537,-1,2,1,179,217
47015,015,47,2022,14807,289,3,292,185,220
47015,015,47,2023,15063,278,-1,277,183,204
47017,017,47,2020,28434,44,0,44,70,130
47017,017,47,2021,28295,58,1,59,300,519
47017,017,47,2022,28418,334,1,335,271,494
47017,017,47,2023,28860,629,3,632,274,463
47019,019,47,2020,56371,106,0,106,120,207
47019,019,47,2021,56080,146,6,152,452,933
47019,019,47,2022,56485,887,30,917,437,982
47019,019,47,2023,57022,909,45,954,439,858
47021,021,47,2020,41131,77,0,77,105,121
47021,021,47,2021,41498,460,13,473,442,551
47021,021,47,2022,41764,330,30,360,490,578
47021,021,47,2023,42254,514,15,529,494,535
47023,023,47,2020,17375,35,0,35,34,42
47023,023,47,2021,17465,161,5,166,174,254
47023,023,47,2022,17558,178,7,185,178,267
47023,023,47,2023,17606,103,15,118,180,251
47025,025,47,2020,32072,72,0,72,65,108
47025,025,47,2021,32061,196,13,209,299,533
47025,025,47,2022,32357,530,17,547,325,607
47025,025,47,2023,32654,457,42,499,338,542
47027,027,47,2020,7588,23,0,23,16,29
47027,027,47,2021,7586,71,3,74,70,145
47027,027,47,2022,7656,126,9,135,76,140
47027,027,47,2023,7714,99,14,113,76,133
47029,029,47,2020,36045,115,0,115,82,147
47029,029,47,2021,36364,663,1,664,364,695
47029,029,47,2022,36849,818,6,824,373,746
47029,029,47,2023,37404,844,12,856,373,673
47031,031,47,2020,58139,262,1,263,180,178
47031,031,47,2021,58983,947,33,980,715,843
47031,031,47,2022,59779,847,121,968,702,899
47031,031,47,2023,60633,881,73,954,702,802
47033,033,47,2020,13908,2,0,2,43,53
47033,033,47,2021,13990,145,3,148,159,228
47033,033,47,2022,13862,-76,12,-64,156,217
47033,033,47,2023,13982,166,1,167,158,208
47035,035,47,2020,61379,354,0,354,132,218
47035,035,47,2021,62391,1787,-6,1781,483,1175
47035,035,47,2022,63482,1738,15,1753,522,1274
47035,035,47,2023,64760,1863,4,1867,532,1120
47037,037,47,2020,716059,-913,106,-807,2367,1559
47037,037,47,2021,700860,-18513,1050,-17463,9661,6786
47037,037,47,2022,707351,250,2670,2920,10036,6541
47037,037,47,2023,712334,-3581,4293,712,10032,5642
47039,039,47,2020,11433,22,0,22,26,51
47039,039,47,2021,11402,91,0,91,114,238
47039,039,47,2022,11549,253,0,253,108,223
47039,039,47,2023,11656,216,0,216,105,213
47041,041,47,2020,20189,127,0,127,67,73
47041,041,47,2021,20500,368,13,381,253,316
47041,041,47,2022,21002,549,25,574,239,341
47041,041,47,2023,21225,292,16,308,241,328
47043,043,47,2020,54440,146,0,146,148,159
47043,043,47,2021,55174,818,7,825,612,694
47043,043,47,2022,55727,670,16,686,647,784
47043,043,47,2023,56729,1033,24,1057,645,700
47045,045,47,2020,36716,-74,0,-74,109,126
47045,045,47,2021,36609,18,0,18,471,622
47045,045,47,2022,36440,3,-4,-1,495,641
47045,045,47,2023,36498,156,0,156,497,593
47047,047,47,2020,41870,208,0,208,84,121
47047,047,47,2021,42616,910,3,913,442,578
47047,047,47,2022,43338,840,-7,833,446,575
47047,047,47,2023,44175,926,-5,921,450,534
47049,049,47,2020,18533,88,0,88,35,71
47049,049,47,2021,18835,483,0,483,178,342
47049,049,47,2022,19335,649,1,650,209,387
47049,049,47,2023,19696,500,6,506,211,356
47051,051,47,2020,42845,96,0,96,95,120
47051,051,47,2021,43196,595,15,610,430,686
47051,051,47,2022,44119,1069,32,1101,436,664
47051,051,47,2023,44654,635,58,693,438,599
47053,053,47,2020,50444,54,0,54,117,155
47053,053,47,2021,50468,426,10,436,537,963
47053,053,47,2022,50826,633,39,672,623,931
47053,053,47,2023,51045,439,8,447,629,860
47055,055,47,2020,30340,40,0,40,64,112
47055,055,47,2021,30401,275,4,279,303,528
47055,055,47,2022,30540,364,12,376,303,536
47055,055,47,2023,30721,348,17,365,304,492
47057,057,47,2020,23569,64,1,65,54,79
47057,057,47,2021,23800,426,5,431,230,421
47057,057,47,2022,24185,501,0,501,263,404
47057,057,47,2023,24681,606,0,606,266,377
47059,059,47,2020,70344,240,0,240,170,217
47059,059,47,2021,70565,794,14,808,629,1223
47059,059,47,2022,71292,1346,5,1351,641,1306
47059,059,47,2023,72577,1776,12,1788,647,1145
47061,061,47,2020,13543,41,0,41,37,61
47061,061,47,2021,13587,121,0,121,169,247
47061,061,47,2022,13779,269,-2,267,169,255
47061,061,47,2023,13955,245,-2,243,169,239
47063,063,47,2020,64542,78,1,79,168,222
47063,063,47,2021,64360,178,15,193,701,1111
47063,063,47,2022,65167,1077,80,1157,772,1141
47063,063,47,2023,66216,1170,102,1272,773,998
47065,065,47,2020,367251,988,10,998,1054,997
47065,065,47,2021,369005,1476,185,1661,4371,4471
47065,065,47,2022,374602,5053,411,5464,4552,4577
47065,065,47,2023,379864,3942,703,4645,4500,3913
47067,067,47,2020,6627,-18,0,-18,15,30
47067,067,47,2021,6794,214,0,214,68,108
47067,067,47,2022,6846,122,0,122,56,127
47067,067,47,2023,6956,181,0,181,56,127
47069,069,47,2020,25440,-16,0,-16,64,76
47069,069,47,2021,25260,-66,1,-65,280,411
47069,069,47,2022,25511,345,0,345,281,390
47069,069,47,2023,25567,153,-1,152,282,376
47071,071,47,2020,26804,40,0,40,47,108
47071,071,47,2021,26871,310,-1,309,252,497
47071,071,47,2022,27065,447,-3,444,278,537
47071,071,47,2023,27229,372,-3,369,286,491
47073,073,47,2020,56721,57,0,57,118,187
47073,073,47,2021,57202,1030,9,1039,487,1028
47073,073,47,2022,57903,1229,-2,1227,500,1057
47073,073,47,2023,58600,1132,2,1134,500,940
47075,075,47,2020,17826,-37,0,-37,33,34
47075,075,47,2021,17691,-30,3,-27,197,316
47075,075,47,2022,17518,-75,5,-70,193,292
47075,075,47,2023,17328,-112,3,-109,196,279
47077,077,47,2020,27824,27,0,27,64,110
47077,077,47,2021,27906,185,0,185,307,420
47077,077,47,2022,27907,148,-2,146,305,442
47077,077,47,2023,28070,274,-2,272,307,414
47079,079,47,2020,32149,-7,0,-7,68,121
47079,079,47,2021,32246,387,0,387,308,598
47079,079,47,2022,32382,395,-4,391,317,581
47079,079,47,2023,32554,382,-4,378,314,521
47081,081,47,2020,24972,89,0,89,64,88
47081,081,47,2021,25080,226,2,228,274,405
47081,081,47,2022,25481,478,8,486,284,385
47081,081,47,2023,25826,414,16,430,278,362
47083,083,47,2020,8308,31,0,31,14,26
47083,083,47,2021,8298,60,-1,59,86,157
47083,083,47,2022,8247,19,0,19,77,144
47083,083,47,2023,8393,208,0,208,78,138
47085,085,47,2020,18998,16,0,16,55,66
47085,085,47,2021,19178,303,1,304,203,324
47085,085,47,2022,19023,12,1,13,196,360
47085,085,47,2023,19209,320,5,325,198,337
47087,087,47,2020,11633,38,0,38,22,42
47087,087,47,2021,11771,261,1,262,87,203
47087,087,47,2022,12015,314,0,314,103,186
47087,087,47,2023,12363,421,1,422,104,175
47089,089,47,2020,54916,292,0,292,127,167
47089,089,47,2021,55547,950,14,964,519,835
47089,089,47,2022,56660,1400,25,1425,540,917
47089,089,47,2023,57838,1370,58,1428,542,794
47091,091,47,2020,17990,71,0,71,32,56
47091,091,47,2021,18053,207,6,213,157,307
47091,091,47,2022,18046,143,8,151,150,308
47091,091,47,2023,18375,454,19,473,148,293
47093,093,47,2020,480516,1474,9,1483,1302,1226
47093,093,47,2021,485941,5767,208,5975,5127,5731
47093,093,47,2022,495380,9031,486,9517,5414,5901
47093,093,47,2023,500669,4080,818,4898,5444,5082
47095,095,47,2020,6995,-5,0,-5,10,19
47095,095,47,2021,6596,-304,1,-303,62,134
47095,095,47,2022,6500,-19,2,-17,64,141
47095,095,47,2023,6347,-75,2,-73,64,144
47097,097,47,2020,25123,-25,0,-25,80,76
47097,097,47,2021,24878,-159,0,-159,276,369
47097,097,47,2022,24741,-82,1,-81,331,372
47097,097,47,2023,24610,-112,0,-112,332,351
47099,099,47,2020,44181,78,0,78,106,170
47099,099,47,2021,44768,697,0,697,603,710
47099,099,47,2022,45502,825,2,827,594,705
47099,099,47,2023,46114,653,4,657,590,637
47101,101,47,2020,12606,35,0,35,35,47
47101,101,47,2021,12852,338,9,347,119,208
47101,101,47,2022,12912,150,12,162,118,226
47101,101,47,2023,13066,242,13,255,118,219
47103,103,47,2020,35331,47,1,48,83,127
47103,103,47,2021,35435,279,5,284,371,564
47103,103,47,2022,36006,719,10,729,399,563
47103,103,47,2023,36169,235,18,253,421,511
47105,105,47,2020,55129,317,3,320,114,164
47105,105,47,2021,56785,1935,24,1959,568,781
47105,105,47,2022,58244,1659,38,1697,540,854
47105,105,47,2023,60591,2507,68,2575,539,766
47107,107,47,2020,53343,143,1,144,136,205
47107,107,47,2021,53921,870,10,880,593,887
47107,107,47,2022,54695,1087,2,1089,611,964
47107,107,47,2023,55678,1222,16,1238,604,855
47109,109,47,2020,25857,49,0,49,65,116
47109,109,47,2021,25846,145,3,148,289,460
47109,109,47,2022,25993,304,8,312,303,471
47109,109,47,2023,26163,286,17,303,309,442
47111,111,47,2020,25267,51,0,51,68,72
47111,111,47,2021,25673,474,6,480,306,372
47111,111,47,2022,26214,547,25,572,299,348
47111,111,47,2023,26793,589,22,611,296,327
47113,113,47,2020,98832,9,0,9,265,310
47113,113,47,2021,98557,-263,34,-229,1208,1312
47113,113,47,2022,99172,685,97,782,1162,1324
47113,113,47,2023,99193,-85,127,42,1169,1193
47115,115,47,2020,28870,42,0,42,72,87
47115,115,47,2021,28919,204,2,206,298,461
47115,115,47,2022,29050,308,4,312,295,484
47115,115,47,2023,29382,473,5,478,290,437
47117,117,47,2020,34475,130,0,130,102,80
47117,117,47,2021,35059,600,31,631,426,466
47117,117,47,2022,35857,788,30,818,424,474
47117,117,47,2023,36961,1091,30,1121,429,441
47119,119,47,2020,101826,798,0,798,353,225
47119,119,47,2021,104942,3161,11,3172,1273,1198
47119,119,47,2022,107996,2837,-6,2831,1325,1235
47119,119,47,2023,110760,2532,4,2536,1331,1106
47121,121,47,2020,12808,70,0,70,25,37
47121,121,47,2021,13019,315,0,315,110,206
47121,121,47,2022,13258,321,0,321,118,215
47121,121,47,2023,13691,521,0,521,117,206
47123,123,47,2020,46394,192,0,192,122,155
47123,123,47,2021,46649,546,-1,545,470,761
47123,123,47,2022,47680,1274,16,1290,507,835
47123,123,47,2023,48594,1136,4,1140,508,736
47125,125,47,2020,221281,765,5,770,918,396
47125,125,47,2021,227741,4994,-48,4946,3508,1882
47125,125,47,2022,234899,5141,41,5182,3686,1978
47125,125,47,2023,239872,2767,185,2952,3722,1743
47127,127,47,2020,6470,1,0,1,18,17
47127,127,47,2021,6651,217,1,218,60,91
47127,127,47,2022,6716,109,0,109,53,96
47127,127,47,2023,6748,73,-1,72,53,95
47129,129,47,2020,21042,35,0,35,43,68
47129,129,47,2021,21107,168,1,169,176,293
47129,129,47,2022,21207,248,0,248,196,340
47129,129,47,2023,21573,494,0,494,195,319
47131,131,47,2020,30775,-6,0,-6,72,90
47131,131,47,2021,30459,-93,7,-86,320,568
47131,131,47,2022,30374,96,-1,95,355,518
47131,131,47,2023,30411,145,0,145,363,471
47133,133,47,2020,22590,112,0,112,62,85
47133,133,47,2021,22831,416,1,417,252,418
47133,133,47,2022,22993,320,0,320,241,414
47133,133,47,2023,23327,484,0,484,242,394
47135,135,47,2020,8381,2,0,2,20,25
47135,135,47,2021,8493,141,0,141,105,132
47135,135,47,2022,8705,239,5,244,106,148
47135,135,47,2023,8891,221,7,228,103,145
47137,137,47,2020,5000,4,0,4,10,19
47137,137,47,2021,5069,135,0,135,37,99
47137,137,47,2022,5103,80,-1,79,33,79
47137,137,47,2023,5128,71,-1,70,31,77
47139,139,47,2020,17566,50,0,50,38,66
47139,139,47,2021,17714,334,-1,333,156,334
47139,139,47,2022,17778,242,-2,240,169,354
47139,139,47,2023,18033,416,-1,415,166,330
47141,141,47,2020,80071,256,0,256,200,238
47141,141,47,2021,81250,1403,27,1430,867,1092
47141,141,47,2022,82470,1230,93,1323,933,1074
47141,141,47,2023,83844,1193,167,1360,943,931
47143,143,47,2020,32938,74,0,74,91,104
47143,143,47,2021,33189,437,3,440,383,568
47143,143,47,2022,33689,648,5,653,373,566
47143,143,47,2023,33924,369,7,376,372,518
47145,145,47,2020,53517,234,0,234,111,210
47145,145,47,2021,54088,1015,-4,1011,504,918
47145,145,47,2022,55129,1437,-14,1423,509,942
47145,145,47,2023,56096,1311,-7,1304,507,845
47147,147,47,2020,72953,130,0,130,213,208
47147,147,47,2021,74031,1122,47,1169,869,953
47147,147,47,2022,75398,1351,65,1416,897,975
47147,147,47,2023,76776,1299,49,1348,897,870
47149,149,47,2020,343298,1460,15,1475,989,644
47149,149,47,2021,351194,6443,214,6657,4113,2815
47149,149,47,2022,360682,7189,726,7915,4272,2922
47149,149,47,2023,367101,3518,1192,4710,4256,2548
47151,151,47,2020,21876,5,0,5,73,57
47151,151,47,2021,21891,100,0,100,234,332
47151,151,47,2022,21999,232,-2,230,265,389
47151,151,47,2023,22171,264,-2,262,266,358
47153,153,47,2020,15848,35,0,35,32,45
47153,153,47,2021,16448,641,13,654,190,213
47153,153,47,2022,16918,458,28,486,195,232
47153,153,47,2023,17161,214,49,263,196,216
47155,155,47,2020,98562,207,2,209,242,280
47155,155,47,2021,99435,1146,55,1201,1078,1408
47155,155,47,2022,98806,-349,209,-140,1076,1500
47155,155,47,2023,99415,509,333,842,1072,1301
47157,157,47,2020,929763,-1112,40,-1072,3017,2397
47157,157,47,2021,923382,-8319,499,-7820,12538,11225
47157,157,47,2022,916357,-9710,1415,-8295,12460,11117
47157,157,47,2023,910042,-11684,2301,-9383,12539,9509
47159,159,47,2020,19971,57,0,57,46,46
47159,159,47,2021,20169,267,4,271,210,285
47159,159,47,2022,20470,345,2,347,231,290
47159,159,47,2023,20538,106,6,112,231,276
47161,161,47,2020,13706,55,0,55,35,40
47161,161,47,2021,13808,180,1,181,122,200
47161,161,47,2022,13994,266,-4,262,132,215
47161,161,47,2023,14222,305,-3,302,130,205
47163,163,47,2020,158246,298,0,298,369,594
47163,163,47,2021,159212,2174,5,2179,1449,2644
47163,163,47,2022,160862,2807,-1,2806,1497,2741
47163,163,47,2023,162135,2091,31,2122,1501,2347
47165,165,47,2020,197416,1115,2,1117,546,469
47165,165,47,2021,200505,3096,65,3161,2156,2208
47165,165,47,2022,203721,3088,139,3227,2235,2347
47165,165,47,2023,207994,3885,202,4087,2242,2057
47167,167,47,2020,61042,48,0,48,157,159
47167,167,47,2021,61059,68,4,72,666,762
47167,167,47,2022,61650,713,2,715,694,818
47167,167,47,2023,62015,422,9,431,692,757
47169,169,47,2020,11635,24,0,24,28,29
47169,169,47,2021,11605,4,-1,3,116,149
47169,169,47,2022,12077,478,-2,476,115,153
47169,169,47,2023,12271,225,-2,223,115,147
47171,171,47,2020,17886,-9,1,-8,36,70
47171,171,47,2021,17631,-23,13,-10,118,373
47171,171,47,2022,17591,190,0,190,145,381
47171,171,47,2023,17756,391,3,394,141,368
47173,173,47,2020,19845,83,0,83,38,75
47173,173,47,2021,20013,291,0,291,199,319
47173,173,47,2022,20473,566,-2,564,231,358
47173,173,47,2023,20741,369,-2,367,231,333
47175,175,47,2020,6174,18,0,18,9,21
47175,175,47,2021,6293,181,0,181,62,118
47175,175,47,2022,6430,210,-2,208,67,149
47175,175,47,2023,6493,141,-2,139,67,145
47177,177,47,2020,41052,98,1,99,117,115
47177,177,47,2021,41468,548,25,573,471,625
47177,177,47,2022,42001,536,57,593,550,622
47177,177,47,2023,42638,594,60,654,547,567
47179,179,47,2020,133219,324,2,326,296,414
47179,179,47,2021,133460,844,46,890,1208,1923
47179,179,47,2022,136147,3069,116,3185,1263,1930
47179,179,47,2023,138420,2514,200,2714,1260,1702
47181,181,47,2020,16222,-4,0,-4,39,48
47181,181,47,2021,16329,219,-1,218,149,259
47181,181,47,2022,16266,78,-4,74,139,268
47181,181,47,2023,16066,-90,-5,-95,148,252
47183,183,47,2020,32903,11,0,11,72,93
47183,183,47,2021,32883,112,6,118,337,493
47183,183,47,2022,33043,329,3,332,333,507
47183,183,47,2023,33084,155,12,167,340,469
47185,185,47,2020,27444,117,0,117,74,95
47185,185,47,2021,27541,256,-1,255,277,440
47185,185,47,2022,28000,635,-1,634,287,493
47185,185,47,2023,28692,861,0,861,287,453
47187,187,47,2020,249552,1696,6,1702,563,378
47187,187,47,2021,256065,5993,116,6109,2228,1705
47187,187,47,2022,260738,3723,352,4075,2393,1696
47187,187,47,2023,264460,2110,746,2856,2415,1499
47189,189,47,2020,148659,943,1,944,390,360
47189,189,47,2021,152036,3252,98,3350,1668,1562
47189,189,47,2022,158593,5949,185,6134,1721,1588
47189,189,47,2023,163674,4402,356,4758,1719,1387
48001,001,48,2020,57930,23,1,24,135,171
48001,001,48,2021,58302,597,33,630,570,831
48001,001,48,2022,57227,-927,95,-832,580,879
48001,001,48,2023,57736,614,107,721,594,802
48003,003,48,2020,18612,-37,0,-37,66,28
48003,003,48,2021,18411,-330,34,-296,268,161
48003,003,48,2022,18324,-291,76,-215,284,161
48003,003,48,2023,18664,131,69,200,292,152
48005,005,48,2020,86388,-5,0,-5,265,294
48005,005,48,2021,86730,350,-2,348,1145,1201
48005,005,48,2022,87124,497,14,511,1156,1247
48005,005,48,2023,87319,101,13,114,1178,1102
48007,007,48,2020,23932,184,0,184,38,98
48007,007,48,2021,24510,887,-2,885,191,456
48007,007,48,2022,24963,635,-4,631,229,434
48007,007,48,2023,25374,590,-4,586,235,412
48009,009,48,2020,8556,8,0,8,15,23
48009,009,48,2021,8702,156,4,160,74,87
48009,009,48,2022,8849,167,6,173,85,112
48009,009,48,2023,9029,194,7,201,90,109
48011,011,48,2020,1852,9,0,9,3,7
48011,011,48,2021,1840,5,0,5,22,39
48011,011,48,2022,1857,26,0,26,21,31
48011,011,48,2023,1832,-19,0,-19,23,30
48013,013,48,2020,49128,93,0,93,171,121
48013,013,48,2021,49817,709,1,710,617,638
48013,013,48,2022,50736,931,-20,911,612,625
48013,013,48,2023,51784,996,-17,979,624,551
48015,015,48,2020,30132,-32,0,-32,91,96
48015,015,48,2021,30431,296,8,304,341,348
48015,015,48,2022,31070,607,10,617,378,362
48015,015,48,2023,31677,559,3,562,390,343
48017,017,48,2020,6866,-53,0,-53,30,10
48017,017,48,2021,6803,-104,15,-89,115,87
48017,017,48,2022,6803,-102,71,-31,109,80
48017,017,48,2023,6672,-243,77,-166,113,76
48019,019,48,2020,20998,193,0,193,40,64
48019,019,48,2021,21528,743,6,749,155,341
48019,019,48,2022,22120,679,19,698,191,328
48019,019,48,2023,22637,620,20,640,192,314
48021,021,48,2020,98057,811,1,812,283,201
48021,021,48,2021,102276,4030,30,4060,1203,889
48021,021,48,2022,106395,3522,67,3589,1312,944
48021,021,48,2023,110778,3854,73,3927,1321,852
48023,023,48,2020,3463,0,0,0,9,14
48023,023,48,2021,3458,34,2,36,35,74
48023,023,48,2022,3462,37,12,49,34,81
48023,023,48,2023,3463,32,14,46,34,79
48025,025,48,2020,31038,-24,0,-24,85,84
48025,025,48,2021,30836,-200,4,-196,329,352
48025,025,48,2022,30992,224,12,236,311,398
48025,025,48,2023,30850,-95,11,-84,313,374
48027,027,48,2020,372258,696,16,712,1483,680
48027,027,48,2021,380399,5302,73,5375,5977,3188
48027,027,48,2022,387454,3414,605,4019,6380,3301
48027,027,48,2023,393193,1337,712,2049,6539,2880
48029,029,48,2020,2015501,3147,117,3264,6018,3560
48029,029,48,2021,2030981,6161,1787,7948,25121,18933
48029,029,48,2022,2060191,16115,5258,21373,26265,18298
48029,029,48,2023,2087679,10831,5705,16536,26765,15947
48031,031,48,2020,11449,98,0,98,15,28
48031,031,48,2021,11882,528,0,528,90,159
48031,031,48,2022,12411,570,-2,568,87,157
48031,031,48,2023,13048,706,0,706,87,155
48033,033,48,2020,642,14,0,14,1,1
48033,033,48,2021,618,-17,0,-17,4,10
48033,033,48,2022,580,-34,0,-34,5,8
48033,033,48,2023,572,-6,0,-6,5,7
48035,035,48,2020,18252,31,0,31,63,75
48035,035,48,2021,18499,421,8,429,154,318
48035,035,48,2022,18707,288,17,305,197,304
48035,035,48,2023,18996,373,17,390,196,294
48037,037,48,2020,92923,-6,1,-5,284,284
48037,037,48,2021,92282,-422,47,-375,1052,1348
48037,037,48,2022,91712,-355,82,-273,1074,1356
48037,037,48,2023,91687,-7,85,78,1101,1208
48039,039,48,2020,373493,1036,15,1051,1052,701
48039,039,48,2021,379121,3801,315,4116,4583,3191
48039,039,48,2022,388234,6761,837,7598,4781,3392
48039,039,48,2023,398938,7888,955,8843,4834,2959
48041,041,48,2020,234505,216,20,236,654,335
48041,041,48,2021,237612,1372,384,1756,2631,1431
48041,041,48,2022,241931,2097,887,2984,2819,1405
48041,041,48,2023,244703,184,966,1150,2885,1276
48043,043,48,2020,9560,27,0,27,12,20
48043,043,48,2021,9473,-72,20,-52,75,114
48043,043,48,2022,9344,-145,39,-106,85,110
48043,043,48,2023,9513,148,40,188,90,109
48045,045,48,2020,1419,-13,0,-13,6,7
48045,045,48,2021,1400,-6,0,-6,8,20
48045,045,48,2022,1439,44,0,44,10,16
48045,045,48,2023,1445,12,0,12,10,16
48047,047,48,2020,7048,-38,0,-38,26,15
48047,047,48,2021,6969,-57,20,-37,77,120
48047,047,48,2022,6902,-103,35,-68,98,101
48047,047,48,2023,6848,-91,38,-53,101,98
48049,049,48,2020,38043,-11,0,-11,95,140
48049,049,48,2021,38135,383,3,386,402,701
48049,049,48,2022,38443,477,37,514,455,648
48049,049,48,2023,38709,345,38,383,468,588
48051,051,48,2020,17682,29,1,30,59,52
48051,051,48,2021,18109,517,14,531,198,283
48051,051,48,2022,18690,573,69,642,209,298
48051,051,48,2023,19475,783,71,854,216,283
48053,053,48,2020,49483,427,0,427,119,146
48053,053,48,2021,51146,1892,0,1892,491,629
48053,053,48,2022,52567,1513,1,1514,519,688
48053,053,48,2023,53991,1508,3,1511,531,620
48055,055,48,2020,45945,60,1,61,129,135
48055,055,48,2021,46940,839,19,858,637,487
48055,055,48,2022,47849,678,81,759,642,488
48055,055,48,2023,49859,1735,86,1821,646,458
48057,057,48,2020,20064,-58,0,-58,75,55
48057,057,48,2021,19782,-240,21,-219,232,283
48057,057,48,2022,19682,-86,36,-50,234,271
48057,057,48,2023,19696,-1,38,37,238,260
48059,059,48,2020,13747,70,0,70,27,49
48059,059,48,2021,14098,475,0,475,129,234
48059,059,48,2022,14247,238,3,241,139,232
48059,059,48,2023,14374,198,3,201,143,215
48061,061,48,2020,421480,-329,26,-303,1473,799
48061,061,48,2021,422636,-583,290,-293,5605,4462
48061,061,48,2022,424911,-624,847,223,5906,3680
48061,061,48,2023,426710,-1860,833,-1027,6022,3228
48063,063,48,2020,12428,-19,0,-19,31,51
48063,063,48,2021,12602,213,10,223,181,225
48063,063,48,2022,12721,127,23,150,204,233
48063,063,48,2023,13000,270,26,296,209,226
48065,065,48,2020,5792,4,0,4,8,21
48065,065,48,2021,5714,-29,0,-29,48,94
48065,065,48,2022,5816,119,0,119,64,85
48065,065,48,2023,5878,77,1,78,69,82
48067,067,48,2020,28442,13,0,13,77,104
48067,067,48,2021,28573,386,-1,385,328,584
48067,067,48,2022,28538,197,-5,192,356,581
48067,067,48,2023,28659,311,-4,307,365,548
48069,069,48,2020,7334,-33,0,-33,18,22
48069,069,48,2021,7366,-8,15,7,118,94
48069,069,48,2022,7287,-121,23,-98,113,99
48069,069,48,2023,7227,-107,24,-83,115,94
48071,071,48,2020,47019,465,0,465,116,97
48071,071,48,2021,48727,1585,27,1612,548,397
48071,071,48,2022,51309,2244,79,2323,601,419
48071,071,48,2023,53876,2273,89,2362,611,394
48073,073,48,2020,50493,54,0,54,165,150
48073,073,48,2021,51150,728,2,730,727,791
48073,073,48,2022,51432,410,2,412,678,803
48073,073,48,2023,52217,814,5,819,682,715
48075,075,48,2020,6661,-8,0,-8,12,11
48075,075,48,2021,6787,163,-1,162,62,91
48075,075,48,2022,6841,66,10,76,65,84
48075,075,48,2023,6788,-47,9,-38,66,81
48077,077,48,2020,10257,42,0,42,31,32
48077,077,48,2021,10311,123,4,127,88,164
48077,077,48,2022,10499,219,9,228,111,152
48077,077,48,2023,10738,264,10,274,115,148
48079,079,48,2020,2561,10,0,10,10,6
48079,079,48,2021,2480,-71,3,-68,43,53
48079,079,48,2022,2522,23,18,41,49,47
48079,079,48,2023,2509,-37,17,-20,51,43
48081,081,48,2020,3300,12,0,12,14,9
48081,081,48,2021,3304,50,0,50,24,71
48081,081,48,2022,3322,51,0,51,36,69
48081,081,48,2023,3352,59,0,59,39,65
48083,083,48,2020,7688,8,0,8,23,30
48083,083,48,2021,7722,173,0,173,68,200
48083,083,48,2022,7822,218,-2,216,89,213
48083,083,48,2023,7842,133,-2,131,94,204
48085,085,48,2020,1075736,8062,150,8212,2786,1301
48085,085,48,2021,1114661,31721,2863,34584,11542,6214
48085,085,48,2022,1158995,29755,7203,36958,12548,6022
48085,085,48,2023,1195359,20749,8137,28886,12840,5299
48087,087,48,2020,2640,-9,0,-9,7,7
48087,087,48,2021,2607,-17,0,-17,26,45
48087,087,48,2022,2585,-13,-1,-14,34,42
48087,087,48,2023,2563,-16,-1,-17,36,41
48089,089,48,2020,20563,31,0,31,35,67
48089,089,48,2021,20642,97,28,125,268,323
48089,089,48,2022,20832,204,47,251,286,345
48089,089,48,2023,21117,271,48,319,294,327
48091,091,48,2020,163659,2377,3,2380,389,355
48091,091,48,2021,174977,12003,10,12013,1722,1778
48091,091,48,2022,184749,9237,42,9279,1807,1751
48091,091,48,2023,193928,8891,45,8936,1822,1550
48093,093,48,2020,13630,48,0,48,38,44
48093,093,48,2021,13805,275,0,275,150,243
48093,093,48,2022,13921,135,16,151,182,221
48093,093,48,2023,14050,135,13,148,186,206
48095,095,48,2020,3318,16,0,16,11,9
48095,095,48,2021,3348,34,8,42,23,35
48095,095,48,2022,3367,12,19,31,25,34
48095,095,48,2023,3297,-82,20,-62,25,33
48097,097,48,2020,41748,69,0,69,110,104
48097,097,48,2021,42398,688,13,701,496,535
48097,097,48,2022,43048,581,20,601,555,523
48097,097,48,2023,43782,609,22,631,580,475
48099,099,48,2020,83130,-63,2,-61,229,146
48099,099,48,2021,84389,1020,-16,1004,939,683
48099,099,48,2022,84205,-631,121,-510,1026,707
48099,099,48,2023,84878,100,156,256,1058,641
48101,101,48,2020,1365,-6,0,-6,2,9
48101,101,48,2021,1355,11,0,11,6,28
48101,101,48,2022,1317,-27,0,-27,10,21
48101,101,48,2023,1294,-11,0,-11,10,21
48103,103,48,2020,4675,-5,0,-5,11,9
48103,103,48,2021,4636,-43,0,-43,57,53
48103,103,48,2022,4551,-105,-2,-107,66,48
48103,103,48,2023,4574,6,-2,4,67,48
48105,105,48,2020,3093,7,0,7,6,16
48105,105,48,2021,3013,-61,-1,-62,42,60
48105,105,48,2022,2960,-52,-4,-56,56,56
48105,105,48,2023,2858,-98,-4,-102,56,55
48107,107,48,2020,5098,-29,0,-29,18,18
48107,107,48,2021,5085,15,2,17,66,98
48107,107,48,2022,4992,-68,9,-59,67,100
48107,107,48,2023,4917,-55,11,-44,67,98
48109,109,48,2020,2186,1,0,1,5,8
48109,109,48,2021,2182,2,0,2,33,38
48109,109,48,2022,2163,-20,1,-19,31,31
48109,109,48,2023,2196,32,1,33,31,31
48111,111,48,2020,7127,-23,0,-23,43,14
48111,111,48,2021,7175,-76,40,-36,165,82
48111,111,48,2022,7235,-162,105,-57,187,78
48111,111,48,2023,7237,-209,98,-111,191,77
48113,113,48,2020,2610112,-5975,299,-5676,8665,4852
48113,113,48,2021,2588235,-41955,6681,-35274,35140,21180
48113,113,48,2022,2601993,-18985,17651,-1334,36356,19895
48113,113,48,2023,2606358,-34330,19273,-15057,36886,17336
48115,115,48,2020,12474,-17,0,-17,55,26
48115,115,48,2021,12367,-57,2,-55,158,216
48115,115,48,2022,12176,-211,11,-200,179,167
48115,115,48,2023,12004,-206,10,-196,185,159
48117,117,48,2020,18526,-91,0,-91,87,44
48117,117,48,2021,18379,-283,18,-265,335,212
48117,117,48,2022,18399,-122,49,-73,319,220
48117,117,48,2023,18347,-223,52,-171,328,209
48119,119,48,2020,5228,0,0,0,14,18
48119,119,48,2021,5344,150,0,150,68,97
48119,119,48,2022,5413,94,1,95,64,91
48119,119,48,2023,5520,127,1,128,65,85
48121,121,48,2020,914398,7024,65,7089,2468,1113
48121,121,48,2021,943883,24156,1298,25454,10070,5349
48121,121,48,2022,977760,23657,3404,27061,11137,5171
48121,121,48,2023,1007703,19262,3828,23090,11361,4558
48123,123,48,2020,19833,22,0,22,55,65
48123,123,48,2021,19949,189,-1,188,242,318
48123,123,48,2022,19754,-119,4,-115,211,292
48123,123,48,2023,19929,236,4,240,216,280
48125,125,48,2020,1758,-9,0,-9,3,4
48125,125,48,2021,1734,-2,1,-1,18,43
48125,125,48,2022,1736,8,3,11,20,30
48125,125,48,2023,1711,-18,3,-15,20,29
48127,127,48,2020,8579,-42,0,-42,38,28
48127,127,48,2021,8479,-101,-1,-102,142,139
48127,127,48,2022,8360,-102,-2,-104,138,157
48127,127,48,2023,8257,-94,-2,-96,143,150
48129,129,48,2020,3279,17,0,17,8,6
48129,129,48,2021,3361,121,0,121,33,65
48129,129,48,2022,3289,-51,5,-46,34,63
48129,129,48,2023,3214,-55,5,-50,36,61
48131,131,48,2020,9810,-14,0,-14,24,28
48131,131,48,2021,9998,229,3,232,128,158
48131,131,48,2022,9706,-282,0,-282,145,173
48131,131,48,2023,9604,-80,0,-80,147,169
48133,133,48,2020,17766,55,0,55,53,63
48133,133,48,2021,17826,180,11,191,201,338
48133,133,48,2022,17893,200,23,223,222,381
48133,133,48,2023,18037,254,25,279,225,359
48135,135,48,2020,165490,-91,7,-84,667,327
48135,135,48,2021,160758,-5778,331,-5447,2699,1701
48135,135,48,2022,161057,-2007,945,-1062,2923,1593
48135,135,48,2023,164494,891,959,1850,2987,1399
48137,137,48,2020,1420,0,0,0,4,6
48137,137,48,2021,1429,24,0,24,22,36
48137,137,48,2022,1428,10,0,10,20,31
48137,137,48,2023,1393,-24,0,-24,20,31
48139,139,48,2020,194317,1840,1,1841,558,399
48139,139,48,2021,203187,8527,61,8588,2446,1811
48139,139,48,2022,212323,7799,168,7967,2677,1801
48139,139,48,2023,222829,9247,171,9418,2721,1594
48141,141,48,2020,866606,-488,1,-487,2686,1545
48141,141,48,2021,867499,-2164,373,-1791,10714,8627
48141,141,48,2022,867239,-5711,1621,-4090,10982,7059
48141,141,48,2023,869880,-3840,1683,-2157,11089,6332
48143,143,48,2020,42719,157,0,157,105,87
48143,143,48,2021,43381,643,16,659,446,443
48143,143,48,2022,43837,393,20,413,496,459
48143,143,48,2023,44195,261,20,281,501,423
48145,145,48,2020,16960,-3,0,-3,43,52
48145,145,48,2021,17113,198,3,201,172,221
48145,145,48,2022,16956,-106,17,-89,173,246
48145,145,48,2023,17286,366,18,384,179,231
48147,147,48,2020,35801,144,0,144,102,102
48147,147,48,2021,36723,1161,7,1168,375,573
48147,147,48,2022,37075,576,6,582,357,598
48147,147,48,2023,37571,668,5,673,365,543
48149,149,48,2020,24471,82,0,82,54,96
48149,149,48,2021,24690,367,12,379,245,398
48149,149,48,2022,24934,345,23,368,259,389
48149,149,48,2023,25474,622,25,647,259,360
48151,151,48,2020,3678,2,0,2,12,9
48151,151,48,2021,3675,45,0,45,29,77
48151,151,48,2022,3626,-12,4,-8,28,66
48151,151,48,2023,3612,16,4,20,28,62
48153,153,48,2020,5370,-19,0,-19,14,22
48153,153,48,2021,5292,-31,1,-30,63,112
48153,153,48,2022,5239,-14,-2,-16,58,94
48153,153,48,2023,5090,-115,-2,-117,58,89
48155,155,48,2020,1088,-4,0,-4,1,4
48155,155,48,2021,1056,-11,0,-11,13,33
48155,155,48,2022,1063,22,0,22,9,25
48155,155,48,2023,1079,33,0,33,9,25
48157,157,48,2020,829109,5171,167,5338,2185,1045
48157,157,48,2021,860305,25603,2476,28079,8803,4918
48157,157,48,2022,888919,17796,6016,23812,9368,4761
48157,157,48,2023,916778,15757,6834,22591,9567,4178
48159,159,48,2020,10369,24,0,24,25,33
48159,159,48,2021,10497,145,3,148,125,145
48159,159,48,2022,10665,166,18,184,103,129
48159,159,48,2023,10735,72,20,92,104,127
48161,161,48,2020,19440,28,0,28,36,67
48161,161,48,2021,19788,449,6,455,187,280
48161,161,48,2022,20032,256,15,271,231,256
48161,161,48,2023,20441,401,14,415,239,242
48163,163,48,2020,18412,3,0,3,51,35
48163,163,48,2021,17543,-909,114,-795,216,221
48163,163,48,2022,17716,-9,184,175,228,221
48163,163,48,2023,17987,47,197,244,231,206
48165,165,48,2020,21699,21,1,22,108,38
48165,165,48,2021,21878,-139,35,-104,452,176
48165,165,48,2022,22140,-80,57,-23,467,178
48165,165,48,2023,22523,10,55,65,482,166
48167,167,48,2020,351590,749,2,751,918,823
48167,167,48,2021,355560,3377,183,3560,3903,3588
48167,167,48,2022,357387,1150,448,1598,4003,3605
48167,167,48,2023,361744,2988,505,3493,4053,3171
48169,169,48,2020,5817,-2,0,-2,14,14
48169,169,48,2021,6269,484,28,512,44,71
48169,169,48,2022,4498,-2002,58,-1944,53,64
48169,169,48,2023,4517,-26,57,31,53,64
48171,171,48,2020,26748,50,0,50,66,93
48171,171,48,2021,27293,714,33,747,239,411
48171,171,48,2022,27501,265,119,384,240,413
48171,171,48,2023,27733,263,109,372,246,384
48173,173,48,2020,1115,-1,0,-1,7,4
48173,173,48,2021,1136,19,5,24,11,12
48173,173,48,2022,1139,1,1,2,13,12
48173,173,48,2023,1141,-2,1,-1,14,11
48175,175,48,2020,7020,7,0,7,14,16
48175,175,48,2021,7133,155,0,155,50,88
48175,175,48,2022,7120,25,-2,23,68,99
48175,175,48,2023,7144,54,-1,53,68,99
48177,177,48,2020,19681,1,0,1,86,68
48177,177,48,2021,19636,-51,10,-41,261,279
48177,177,48,2022,19816,157,15,172,287,272
48177,177,48,2023,19930,63,14,77,292,256
48179,179,48,2020,21199,-42,0,-42,67,59
48179,179,48,2021,21128,-53,19,-34,268,317
48179,179,48,2022,20980,-76,45,-31,243,351
48179,179,48,2023,20916,-14,41,27,244,336
48181,181,48,2020,136099,562,0,562,405,396
48181,181,48,2021,139563,3899,32,3931,1648,1976
48181,181,48,2022,143198,3508,114,3622,1812,1936
48181,181,48,2023,146907,3441,132,3573,1846,1706
48183,183,48,2020,124251,-38,1,-37,388,375
48183,183,48,2021,124130,-113,64,-49,1625,1780
48183,183,48,2022,125559,1340,168,1508,1726,1803
48183,183,48,2023,126243,357,164,521,1744,1585
48185,185,48,2020,29440,184,0,184,69,100
48185,185,48,2021,30145,701,3,704,385,367
48185,185,48,2022,31170,968,-1,967,406,398
48185,185,48,2023,32384,1172,-1,1171,415,370
48187,187,48,2020,173697,865,0,865,445,303
48187,187,48,2021,177301,3328,27,3355,1853,1546
48187,187,48,2022,182702,4932,30,4962,1889,1603
48187,187,48,2023,188454,5213,42,5255,1920,1409
48189,189,48,2020,32465,-95,0,-95,107,69
48189,189,48,2021,32208,-243,23,-220,411,462
48189,189,48,2022,31966,-315,73,-242,407,397
48189,189,48,2023,31761,-314,72,-242,407,372
48191,191,48,2020,2795,-10,0,-10,1,10
48191,191,48,2021,2842,76,6,82,27,60
48191,191,48,2022,2818,-19,18,-1,31,52
48191,191,48,2023,2818,0,19,19,31,49
48193,193,48,2020,8248,34,0,34,14,19
48193,193,48,2021,8230,41,8,49,86,153
48193,193,48,2022,8313,126,21,147,90,157
48193,193,48,2023,8619,335,21,356,94,143
48195,195,48,2020,5252,-28,0,-28,23,12
48195,195,48,2021,5120,-132,7,-125,60,61
48195,195,48,2022,5111,-11,-3,-14,68,62
48195,195,48,2023,5071,-44,-3,-47,68,61
48197,197,48,2020,3558,23,0,23,8,18
48197,197,48,2021,3546,0,5,5,48,66
48197,197,48,2022,3525,-28,8,-20,46,46
48197,197,48,2023,3490,-46,8,-38,46,44
48199,199,48,2020,56350,114,0,114,160,169
48199,199,48,2021,57133,782,14,796,704,719
48199,199,48,2022,57840,768,25,793,717,799
48199,199,48,2023,58261,392,25,417,732,720
48201,201,48,2020,4734792,-5693,527,-5166,15208,7772
48201,201,48,2021,4735517,-40661,13921,-26740,62286,36149
48201,201,48,2022,4781337,-19354,37751,18397,64522,35057
48201,201,48,2023,4835125,-22792,41665,18873,65450,30755
48203,203,48,2020,68801,-17,0,-17,165,194
48203,203,48,2021,69527,749,22,771,801,853
48203,203,48,2022,70038,560,19,579,855,915
48203,203,48,2023,70895,801,25,826,883,849
48205,205,48,2020,5349,-28,0,-28,14,10
48205,205,48,2021,5393,28,2,30,61,47
48205,205,48,2022,5228,-208,6,-202,73,46
48205,205,48,2023,5145,-117,6,-111,74,45
48207,207,48,2020,5433,25,0,25,12,14
48207,207,48,2021,5375,6,2,8,41,110
48207,207,48,2022,5376,55,11,66,46,111
48207,207,48,2023,5385,61,11,72,47,110
48209,209,48,2020,243968,2772,7,2779,686,307
48209,209,48,2021,255955,11006,171,11177,2829,1537
48209,209,48,2022,269103,10729,408,11137,3024,1625
48209,209,48,2023,280486,9286,456,9742,3072,1448
48211,211,48,2020,3365,-12,0,-12,6,11
48211,211,48,2021,3324,-48,1,-47,30,17
48211,211,48,2022,3225,-118,-1,-119,36,24
48211,211,48,2023,3189,-48,-1,-49,37,23
48213,213,48,2020,82403,368,0,368,212,299
48213,213,48,2021,83653,1833,-2,1831,959,1488
48213,213,48,2022,84490,1379,11,1390,952,1550
48213,213,48,2023,86158,2040,15,2055,964,1349
48215,215,48,2020,872856,-198,-17,-215,3107,1113
48215,215,48,2021,879865,427,590,1017,13023,7755
48215,215,48,2022,888286,-394,1811,1417,13556,6163
48215,215,48,2023,898471,139,1695,1834,13671,5383
48217,217,48,2020,35964,136,0,136,77,112
48217,217,48,2021,36378,633,12,645,409,628
48217,217,48,2022,37266,1019,36,1055,452,666
48217,217,48,2023,38101,942,37,979,468,612
48219,219,48,2020,21504,-37,0,-37,65,63
48219,219,48,2021,21265,-211,15,-196,289,325
48219,219,48,2022,21278,17,23,40,282,299
48219,219,48,2023,21460,161,20,181,284,283
48221,221,48,2020,62057,555,0,555,150,188
48221,221,48,2021,64293,2734,-4,2730,627,991
48221,221,48,2022,66394,2276,15,2291,682,982
48221,221,48,2023,67774,1547,18,1565,691,871
48223,223,48,2020,36827,22,0,22,111,105
48223,223,48,2021,37210,499,24,523,432,570
48223,223,48,2022,37793,568,56,624,471,525
48223,223,48,2023,38172,329,58,387,480,486
48225,225,48,2020,22062,29,0,29,52,92
48225,225,48,2021,21962,59,2,61,208,380
48225,225,48,2022,21943,112,15,127,256,393
48225,225,48,2023,22066,205,16,221,269,367
48227,227,48,2020,34816,-65,0,-65,104,98
48227,227,48,2021,34365,-419,36,-383,389,464
48227,227,48,2022,30732,-3913,69,-3844,362,463
48227,227,48,2023,30554,-201,70,-131,376,427
48229,229,48,2020,3196,-1,0,-1,8,13
48229,229,48,2021,3275,30,51,81,34,38
48229,229,48,2022,3416,42,104,146,32,38
48229,229,48,2023,3451,-67,109,42,32,39
48231,231,48,2020,100254,315,1,316,279,296
48231,231,48,2021,103591,3371,59,3430,1243,1216
48231,231,48,2022,108438,4477,115,4592,1349,1289
48231,231,48,2023,113347,4530,133,4663,1397,1133
48233,233,48,2020,20569,-48,0,-48,65,59
48233,233,48,2021,20438,-45,0,-45,233,329
48233,233,48,2022,20222,-91,-6,-97,235,351
48233,233,48,2023,20033,-81,-6,-87,237,339
48235,235,48,2020,1510,0,0,0,1,3
48235,235,48,2021,1534,29,0,29,21,26
48235,235,48,2022,1534,3,0,3,21,24
48235,235,48,2023,1549,17,0,17,21,23
48237,237,48,2020,8487,28,0,28,19,34
48237,237,48,2021,8550,65,7,72,87,100
48237,237,48,2022,8764,216,8,224,91,109
48237,237,48,2023,8875,115,9,124,93,105
48239,239,48,2020,14997,5,0,5,38,40
48239,239,48,2021,15118,74,3,77,224,187
48239,239,48,2022,15183,-7,10,3,239,171
48239,239,48,2023,15221,-55,10,-45,243,161
48241,241,48,2020,32919,-31,0,-31,87,120
48241,241,48,2021,32552,-148,8,-140,363,589
48241,241,48,2022,32495,128,25,153,409,608
48241,241,48,2023,32694,294,32,326,418,544
48243,243,48,2020,1984,-9,0,-9,4,8
48243,243,48,2021,1959,-8,-1,-9,12,28
48243,243,48,2022,1906,-35,-2,-37,12,28
48243,243,48,2023,1856,-35,-2,-37,12,26
48245,245,48,2020,256133,-444,0,-444,748,716
48245,245,48,2021,253727,-2696,224,-2472,3190,3141
48245,245,48,2022,251601,-2796,579,-2217,3211,3136
48245,245,48,2023,251496,-1291,627,-664,3260,2714
48247,247,48,2020,4846,6,0,6,13,9
48247,247,48,2021,4790,-48,1,-47,71,81
48247,247,48,2022,4774,-25,0,-25,80,71
48247,247,48,2023,4720,-65,0,-65,80,67
48249,249,48,2020,38879,-54,0,-54,132,96
48249,249,48,2021,38893,40,3,43,510,567
48249,249,48,2022,38729,-65,5,-60,499,588
48249,249,48,2023,38662,-55,8,-47,506,527
48251,251,48,2020,180964,865,0,865,491,378
48251,251,48,2021,187511,6616,38,6654,2202,2055
48251,251,48,2022,195496,7165,115,7280,2426,2001
48251,251,48,2023,202906,6591,121,6712,2454,1737
48253,253,48,2020,19682,39,0,39,40,55
48253,253,48,2021,19811,268,4,272,148,288
48253,253,48,2022,20271,522,5,527,158,259
48253,253,48,2023,20381,190,6,196,163,248
48255,255,48,2020,14760,54,0,54,40,41
48255,255,48,2021,14732,-66,49,-17,166,187
48255,255,48,2022,14945,129,106,235,156,178
48255,255,48,2023,15018,-31,115,84,158,170
48257,257,48,2020,147140,1797,1,1798,467,288
48257,257,48,2021,158313,10962,52,11014,2124,1421
48257,257,48,2022,172611,12616,166,12782,2359,1458
48257,257,48,2023,185690,11819,179,11998,2412,1287
48259,259,48,2020,44539,305,1,306,89,110
48259,259,48,2021,46861,2478,29,2507,408,477
48259,259,48,2022,49019,2018,68,2086,447,453
48259,259,48,2023,50537,1429,71,1500,455,425
48261,261,48,2020,348,-2,0,-2,1,0
48261,261,48,2021,339,-7,0,-7,1,3
48261,261,48,2022,354,14,0,14,2,2
48261,261,48,2023,343,-10,0,-10,2,2
48263,263,48,2020,763,10,0,10,0,1
48263,263,48,2021,748,-3,0,-3,11,23
48263,263,48,2022,744,8,0,8,9,20
48263,263,48,2023,734,1,0,1,9,20
48265,265,48,2020,52693,203,1,204,107,191
48265,265,48,2021,53175,865,18,883,488,872
48265,265,48,2022,53784,907,27,934,501,861
48265,265,48,2023,53915,363,33,396,509,775
48267,267,48,2020,4293,11,0,11,15,14
48267,267,48,2021,4348,86,0,86,40,68
48267,267,48,2022,4420,95,1,96,35,63
48267,267,48,2023,4442,46,0,46,39,63
48269,269,48,2020,267,4,0,4,1,0
48269,269,48,2021,256,-13,0,-13,2,1
48269,269,48,2022,234,-25,0,-25,2,0
48269,269,48,2023,217,-19,0,-19,2,0
48271,271,48,2020,3126,-1,0,-1,2,7
48271,271,48,2021,3122,12,5,17,33,54
48271,271,48,2022,3131,24,14,38,25,54
48271,271,48,2023,3148,30,14,44,28,55
48273,273,48,2020,30986,-78,1,-77,86,61
48273,273,48,2021,30625,-354,14,-340,361,380
48273,273,48,2022,30376,-340,60,-280,359,334
48273,273,48,2023,30069,-418,63,-355,364,319
48275,275,48,2020,3347,2,0,2,11,21
48275,275,48,2021,3318,-9,3,-6,46,71
48275,275,48,2022,3284,-4,2,-2,41,72
48275,275,48,2023,3302,45,3,48,40,68
48277,277,48,2020,50131,61,0,61,145,165
48277,277,48,2021,50349,360,10,370,676,843
48277,277,48,2022,50515,247,60,307,693,817
48277,277,48,2023,51127,590,60,650,708,739
48279,279,48,2020,13011,-44,0,-44,42,32
48279,279,48,2021,12909,-85,4,-81,198,225
48279,279,48,2022,12786,-155,39,-116,168,176
48279,279,48,2023,12711,-109,35,-74,169,171
48281,281,48,2020,21705,102,0,102,39,62
48281,281,48,2021,22224,631,5,636,225,321
48281,281,48,2022,22790,641,14,655,213,329
48281,281,48,2023,23262,564,16,580,213,321
48283,283,48,2020,6663,-10,0,-10,22,16
48283,283,48,2021,6708,37,19,56,80,93
48283,283,48,2022,6556,-185,34,-151,76,86
48283,283,48,2023,6537,-49,36,-13,77,83
48285,285,48,2020,20354,27,0,27,55,73
48285,285,48,2021,20538,244,4,248,250,309
48285,285,48,2022,20653,167,3,170,248,296
48285,285,48,2023,20571,-54,1,-53,252,281
48287,287,48,2020,17506,12,0,12,62,55
48287,287,48,2021,17679,210,0,210,184,223
48287,287,48,2022,17971,301,-3,298,195,212
48287,287,48,2023,18240,267,-3,264,204,198
48289,289,48,2020,15732,33,0,33,35,52
48289,289,48,2021,16009,345,2,347,206,266
48289,289,48,2022,16220,284,8,292,183,274
48289,289,48,2023,16538,381,9,390,189,259
48291,291,48,2020,92479,770,1,771,293,187
48291,291,48,2021,97488,4904,27,4931,1302,1039
48291,291,48,2022,102462,4570,52,4622,1389,1152
48291,291,48,2023,108272,5395,52,5447,1415,1015
48293,293,48,2020,22144,2,0,2,59,71
48293,293,48,2021,22060,72,0,72,248,412
48293,293,48,2022,22164,231,16,247,254,400
48293,293,48,2023,22250,175,16,191,260,366
48295,295,48,2020,3031,-21,0,-21,5,4
48295,295,48,2021,2895,-121,3,-118,30,42
48295,295,48,2022,2846,-61,10,-51,38,40
48295,295,48,2023,2906,48,11,59,40,39
48297,297,48,2020,11349,12,0,12,34,33
48297,297,48,2021,11386,90,7,97,113,171
48297,297,48,2022,11541,173,41,214,94,159
48297,297,48,2023,11584,57,45,102,94,153
48299,299,48,2020,21290,101,0,101,33,79
48299,299,48,2021,22056,1026,5,1031,208,414
48299,299,48,2022,22623,687,37,724,221,410
48299,299,48,2023,22875,360,37,397,229,375
48301,301,48,2020,65,2,0,2,0,0
48301,301,48,2021,54,-6,0,-6,0,3
48301,301,48,2022,44,-6,0,-6,0,4
48301,301,48,2023,43,1,0,1,0,2
48303,303,48,2020,311578,628,17,645,981,747
48303,303,48,2021,314642,2156,342,2498,3900,3464
48303,303,48,2022,317761,1624,832,2456,4074,3284
48303,303,48,2023,320940,988,931,1919,4122,2879
48305,305,48,2020,5609,17,0,17,18,18
48305,305,48,2021,5645,58,1,59,74,97
48305,305,48,2022,5738,91,2,93,84,86
48305,305,48,2023,5761,25,2,27,84,87
48307,307,48,2020,7588,-32,0,-32,12,20
48307,307,48,2021,7522,15,0,15,75,160
48307,307,48,2022,7468,45,-1,44,72,169
48307,307,48,2023,7452,70,-1,69,72,156
48309,309,48,2020,261193,367,2,369,773,604
48309,309,48,2021,263721,2099,99,2198,3190,2947
48309,309,48,2022,266162,1545,355,1900,3518,2891
48309,309,48,2023,268583,924,378,1302,3619,2517
48311,311,48,2020,597,0,0,0,3,4
48311,311,48,2021,592,7,0,7,7,18
48311,311,48,2022,569,-15,0,-15,4,14
48311,311,48,2023,568,10,0,10,5,14
48313,313,48,2020,13461,-3,0,-3,37,40
48313,313,48,2021,13512,13,21,34,184,175
48313,313,48,2022,13641,89,38,127,186,177
48313,313,48,2023,13742,42,37,79,190,169
48315,315,48,2020,9752,61,0,61,21,49
48315,315,48,2021,9620,-23,1,-22,88,200
48315,315,48,2022,9550,54,3,57,90,214
48315,315,48,2023,9571,133,3,136,93,208
48317,317,48,2020,5252,8,0,8,21,16
48317,317,48,2021,5214,-62,3,-59,82,59
48317,317,48,2022,5228,-9,4,-5,75,56
48317,317,48,2023,5216,-41,4,-37,79,53
48319,319,48,2020,3968,19,0,19,7,9
48319,319,48,2021,3929,-9,0,-9,37,67
48319,319,48,2022,3978,81,0,81,33,67
48319,319,48,2023,3931,-17,0,-17,34,63
48321,321,48,2020,36287,-15,2,-13,135,97
48321,321,48,2021,36339,-6,52,46,483,505
48321,321,48,2022,36122,-441,146,-295,545,469
48321,321,48,2023,36359,-28,150,122,557,442
48323,323,48,2020,57875,-137,1,-136,244,116
48323,323,48,2021,57683,-415,55,-360,932,781
48323,323,48,2022,57628,-537,132,-405,955,604
48323,323,48,2023,57762,-442,120,-322,978,527
48325,325,48,2020,50952,193,0,193,121,107
48325,325,48,2021,52328,1402,9,1411,590,577
48325,325,48,2022,53657,1258,11,1269,619,589
48325,325,48,2023,54797,1029,11,1040,628,524
48327,327,48,2020,1960,8,0,8,4,14
48327,327,48,2021,1968,31,0,31,12,35
48327,327,48,2022,1979,30,1,31,18,38
48327,327,48,2023,1958,-2,1,-1,18,38
48329,329,48,2020,170362,-139,6,-133,728,275
48329,329,48,2021,168257,-3652,249,-3403,2827,1409
48329,329,48,2022,172019,1532,664,2196,2936,1381
48329,329,48,2023,177108,2584,727,3311,3029,1244
48331,331,48,2020,24774,11,0,11,77,68
48331,331,48,2021,25212,522,0,522,287,356
48331,331,48,2022,25622,508,6,514,294,415
48331,331,48,2023,25951,416,6,422,302,393
48333,333,48,2020,4446,3,0,3,12,21
48333,333,48,2021,4489,100,2,102,30,87
48333,333,48,2022,4498,52,5,57,44,92
48333,333,48,2023,4548,91,5,96,44,89
48335,335,48,2020,9009,10,0,10,22,16
48335,335,48,2021,9042,61,8,69,67,108
48335,335,48,2022,8938,-77,11,-66,72,110
48335,335,48,2023,9075,158,11,169,72,103
48337,337,48,2020,19999,63,0,63,47,78
48337,337,48,2021,20437,637,5,642,218,400
48337,337,48,2022,21079,762,7,769,204,373
48337,337,48,2023,21598,651,9,660,210,349
48339,339,48,2020,625291,4410,36,4446,1833,1198
48339,339,48,2021,650755,22887,759,23646,7641,4958
48339,339,48,2022,679554,22770,2159,24929,8381,5248
48339,339,48,2023,711354,25501,2365,27866,8570,4559
48341,341,48,2020,21264,-125,0,-125,77,39
48341,341,48,2021,21136,-371,56,-315,398,203
48341,341,48,2022,21094,-470,185,-285,421,190
48341,341,48,2023,21190,-350,191,-159,441,189
48343,343,48,2020,11976,18,0,18,26,41
48343,343,48,2021,12007,113,8,121,130,223
48343,343,48,2022,12052,135,20,155,121,230
48343,343,48,2023,12066,87,22,109,123,218
48345,345,48,2020,1061,-1,0,-1,5,4
48345,345,48,2021,1071,24,0,24,14,25
48345,345,48,2022,1034,-20,0,-20,13,31
48345,345,48,2023,1020,4,0,4,13,30
48347,347,48,2020,64616,-55,0,-55,196,184
48347,347,48,2021,64778,40,11,51,848,785
48347,347,48,2022,64994,129,40,169,875,791
48347,347,48,2023,65375,171,42,213,888,722
48349,349,48,2020,52838,198,0,198,145,125
48349,349,48,2021,53637,816,26,842,696,729
48349,349,48,2022,54687,941,26,967,751,690
48349,349,48,2023,55635,789,25,814,757,619
48351,351,48,2020,12158,-33,0,-33,26,52
48351,351,48,2021,12212,163,0,163,115,221
48351,351,48,2022,12041,-47,0,-47,109,230
48351,351,48,2023,12039,98,0,98,116,217
48353,353,48,2020,14721,-12,0,-12,50,55
48353,353,48,2021,14605,-110,20,-90,198,228
48353,353,48,2022,14460,-132,28,-104,179,216
48353,353,48,2023,14306,-148,26,-122,178,209
48355,355,48,2020,353398,-156,3,-153,1041,769
48355,355,48,2021,353292,-840,219,-621,4365,4090
48355,355,48,2022,351590,-2590,467,-2123,4431,3979
48355,355,48,2023,352289,-932,518,-414,4500,3406
48357,357,48,2020,9955,-63,0,-63,28,19
48357,357,48,2021,9768,-232,28,-204,133,107
48357,357,48,2022,9692,-266,132,-134,139,89
48357,357,48,2023,9704,-169,126,-43,145,88
48359,359,48,2020,1763,2,0,2,7,4
48359,359,48,2021,1734,-39,1,-38,30,19
48359,359,48,2022,1761,9,13,22,24,19
48359,359,48,2023,1783,4,13,17,25,19
48361,361,48,2020,84754,-45,0,-45,249,274
48361,361,48,2021,84666,16,18,34,1046,1221
48361,361,48,2022,85048,499,46,545,1103,1221
48361,361,48,2023,85722,568,57,625,1132,1075
48363,363,48,2020,28452,72,0,72,80,115
48363,363,48,2021,28742,377,3,380,351,440
48363,363,48,2022,29322,650,8,658,355,459
48363,363,48,2023,29747,482,9,491,360,426
48365,365,48,2020,22499,28,0,28,77,106
48365,365,48,2021,22556,191,2,193,227,370
48365,365,48,2022,22742,279,0,279,272,363
48365,365,48,2023,22838,160,0,160,281,344
48367,367,48,2020,149552,1381,2,1383,385,331
48367,367,48,2021,157088,7625,55,7680,1683,1486
48367,367,48,2022,165938,8106,121,8227,1847,1599
48367,367,48,2023,173494,6960,128,7088,1868,1386
48369,369,48,2020,9854,-31,0,-31,46,30
48369,369,48,2021,9784,-134,19,-115,153,105
48369,369,48,2022,9649,-239,47,-192,154,104
48369,369,48,2023,9617,-142,48,-94,164,103
48371,371,48,2020,15187,-32,0,-32,52,33
48371,371,48,2021,15117,-76,20,-56,180,203
48371,371,48,2022,14711,-463,34,-429,184,178
48371,371,48,2023,14623,-141,32,-109,189,169
48373,373,48,2020,50503,538,0,538,104,203
48373,373,48,2021,51877,1833,7,1840,537,900
48373,373,48,2022,53256,1635,6,1641,566,956
48373,373,48,2023,54186,1185,7,1192,579,844
48375,375,48,2020,118275,-310,2,-308,395,335
48375,375,48,2021,116461,-1829,192,-1637,1500,1651
48375,375,48,2022,114911,-2136,420,-1716,1650,1569
48375,375,48,2023,114647,-994,444,-550,1692,1402
48377,377,48,2020,6108,-29,0,-29,14,6
48377,377,48,2021,6113,-17,10,-7,85,77
48377,377,48,2022,5954,-235,53,-182,90,74
48377,377,48,2023,5795,-226,49,-177,90,70
48379,379,48,2020,12175,46,0,46,27,46
48379,379,48,2021,12463,377,3,380,115,192
48379,379,48,2022,12836,445,5,450,111,207
48379,379,48,2023,12986,230,6,236,111,198
48381,381,48,2020,141347,468,0,468,406,288
48381,381,48,2021,144055,2552,63,2615,1650,1524
48381,381,48,2022,146244,1688,151,1839,1805,1471
48381,381,48,2023,148255,1284,173,1457,1852,1300
48383,383,48,2020,3380,-16,0,-16,18,4
48383,383,48,2021,3222,-157,4,-153,45,41
48383,383,48,2022,3121,-129,12,-117,45,32
48383,383,48,2023,3141,-9,13,4,47,32
48385,385,48,2020,2751,-4,0,-4,9,12
48385,385,48,2021,2817,114,0,114,26,68
48385,385,48,2022,2832,44,0,44,31,63
48385,385,48,2023,2854,51,0,51,31,61
48387,387,48,2020,11561,-3,0,-3,37,64
48387,387,48,2021,11561,122,3,125,107,235
48387,387,48,2022,11605,126,13,139,138,231
48387,387,48,2023,11678,144,13,157,140,225
48389,389,48,2020,14768,-6,0,-6,56,29
48389,389,48,2021,12981,-1675,16,-1659,172,160
48389,389,48,2022,11692,-1479,43,-1436,182,160
48389,389,48,2023,11770,0,44,44,187,151
48391,391,48,2020,6748,10,0,10,19,27
48391,391,48,2021,6704,11,0,11,56,115
48391,391,48,2022,6638,-3,0,-3,54,113
48391,391,48,2023,6666,84,0,84,54,110
48393,393,48,2020,822,-3,0,-3,0,1
48393,393,48,2021,801,-18,0,-18,13,15
48393,393,48,2022,812,5,0,5,14,7
48393,393,48,2023,840,21,0,21,14,7
48395,395,48,2020,16766,8,0,8,55,53
48395,395,48,2021,16946,230,-2,228,223,270
48395,395,48,2022,17130,254,-4,250,204,268
48395,395,48,2023,17267,187,-3,184,211,260
48397,397,48,2020,109158,1299,2,1301,270,165
48397,397,48,2021,116612,7380,66,7446,1210,848
48397,397,48,2022,123342,5896,139,6035,1336,868
48397,397,48,2023,131307,7267,156,7423,1367,781
48399,399,48,2020,9919,37,0,37,24,41
48399,399,48,2021,9892,36,2,38,106,175
48399,399,48,2022,9884,59,5,64,122,190
48399,399,48,2023,9868,44,5,49,122,187
48401,401,48,2020,52252,7,0,7,164,150
48401,401,48,2021,52695,640,32,672,530,763
48401,401,48,2022,52524,52,38,90,525,765
48401,401,48,2023,53079,676,41,717,534,694
48403,403,48,2020,9892,22,0,22,26,49
48403,403,48,2021,10013,240,1,241,106,216
48403,403,48,2022,10041,160,5,165,108,255
48403,403,48,2023,10106,190,5,195,108,237
48405,405,48,2020,7921,29,0,29,14,39
48405,405,48,2021,7905,83,1,84,93,193
48405,405,48,2022,7860,63,-2,61,86,192
48405,405,48,2023,7833,68,-2,66,90,182
48407,407,48,2020,27533,140,0,140,77,73
48407,407,48,2021,27811,469,-1,468,273,449
48407,407,48,2022,28340,682,2,684,300,486
48407,407,48,2023,28936,737,3,740,307,449
48409,409,48,2020,68841,12,0,12,206,156
48409,409,48,2021,69767,801,20,821,911,815
48409,409,48,2022,70087,169,130,299,925,877
48409,409,48,2023,70660,250,145,395,936,760
48411,411,48,2020,5727,10,0,10,6,14
48411,411,48,2021,5829,168,-1,167,40,98
48411,411,48,2022,5880,86,5,91,50,91
48411,411,48,2023,5845,-7,3,-4,54,85
48413,413,48,2020,2439,-8,0,-8,6,7
48413,413,48,2021,2438,-4,0,-4,34,30
48413,413,48,2022,2359,-88,0,-88,39,33
48413,413,48,2023,2391,26,0,26,39,33
48415,415,48,2020,16942,-2,0,-2,46,40
48415,415,48,2021,16837,-106,10,-96,231,247
48415,415,48,2022,16269,-633,39,-594,200,224
48415,415,48,2023,16212,-91,42,-49,201,211
48417,417,48,2020,3110,8,0,8,7,13
48417,417,48,2021,3191,101,0,101,35,50
48417,417,48,2022,3212,29,1,30,33,42
48417,417,48,2023,3229,24,1,25,33,41
48419,419,48,2020,23924,-78,0,-78,82,94
48419,419,48,2021,23984,68,1,69,329,351
48419,419,48,2022,24061,111,-13,98,375,387
48419,419,48,2023,24179,99,-13,86,398,367
48421,421,48,2020,2789,-3,0,-3,15,4
48421,421,48,2021,2789,-16,4,-12,43,33
48421,421,48,2022,2778,-21,1,-20,42,33
48421,421,48,2023,2678,-115,1,-114,45,31
48423,423,48,2020,234199,604,2,606,712,624
48423,423,48,2021,237182,2943,88,3031,2871,2929
48423,423,48,2022,241995,4356,248,4604,3040,2936
48423,423,48,2023,245209,2426,278,2704,3049,2544
48425,425,48,2020,9205,13,0,13,9,24
48425,425,48,2021,9477,320,1,321,88,127
48425,425,48,2022,9797,313,17,330,102,122
48425,425,48,2023,9888,83,20,103,103,116
48427,427,48,2020,65867,-165,0,-165,212,102
48427,427,48,2021,65858,-293,-15,-308,1079,812
48427,427,48,2022,65653,-696,23,-673,1084,621
48427,427,48,2023,65934,-278,13,-265,1100,559
48429,429,48,2020,9093,-7,0,-7,29,28
48429,429,48,2021,9433,423,0,423,94,154
48429,429,48,2022,9377,11,-5,6,88,145
48429,429,48,2023,9343,23,-4,19,89,141
48431,431,48,2020,1382,11,0,11,4,3
48431,431,48,2021,1380,-7,0,-7,24,19
48431,431,48,2022,1426,28,0,28,33,16
48431,431,48,2023,1397,-46,0,-46,33,16
48433,433,48,2020,1243,3,0,3,1,5
48433,433,48,2021,1211,-18,0,-18,12,26
48433,433,48,2022,1218,22,0,22,10,24
48433,433,48,2023,1218,13,0,13,10,21
48435,435,48,2020,3356,-12,0,-12,7,11
48435,435,48,2021,3291,-57,6,-51,39,50
48435,435,48,2022,3232,-70,19,-51,37,47
48435,435,48,2023,3221,-23,21,-2,37,47
48437,437,48,2020,6946,-18,0,-18,21,29
48437,437,48,2021,7007,74,14,88,77,103
48437,437,48,2022,6959,-66,37,-29,82,98
48437,437,48,2023,6955,-29,36,7,83,94
48439,439,48,2020,2115840,1659,203,1862,6339,3793
48439,439,48,2021,2129695,529,2985,3514,26443,17921
48439,439,48,2022,2155646,8266,8003,16269,27696,17187
48439,439,48,2023,2182947,5354,8805,14159,28006,14996
48441,441,48,2020,143454,96,2,98,433,327
48441,441,48,2021,143922,247,138,385,1868,1856
48441,441,48,2022,145147,643,464,1107,1976,1812
48441,441,48,2023,146836,733,527,1260,2015,1590
48443,443,48,2020,750,-10,0,-10,2,1
48443,443,48,2021,721,-16,0,-16,7,19
48443,443,48,2022,688,-17,0,-17,5,21
48443,443,48,2023,687,14,0,14,5,20
48445,445,48,2020,11793,-46,0,-46,37,27
48445,445,48,2021,11714,-84,11,-73,171,181
48445,445,48,2022,11444,-355,39,-316,177,148
48445,445,48,2023,11547,32,38,70,178,146
48447,447,48,2020,1451,6,0,6,6,2
48447,447,48,2021,1503,59,1,60,19,24
48447,447,48,2022,1539,42,1,43,14,23
48447,447,48,2023,1526,-5,2,-3,13,23
48449,449,48,2020,31291,2,0,2,109,73
48449,449,48,2021,31260,-126,29,-97,422,372
48449,449,48,2022,31237,-180,67,-113,459,358
48449,449,48,2023,31357,-86,61,-25,479,336
48451,451,48,2020,120195,39,14,53,364,271
48451,451,48,2021,119231,-930,32,-898,1446,1537
48451,451,48,2022,118913,-474,121,-353,1507,1440
48451,451,48,2023,119057,-241,136,-105,1516,1267
48453,453,48,2020,1296613,4560,144,4704,3627,1740
48453,453,48,2021,1308868,1327,2599,3926,15111,7378
48453,453,48,2022,1327550,2605,7261,9866,16018,7195
48453,453,48,2023,1334961,-10479,8068,-2411,16289,6312
48455,455,48,2020,13634,77,0,77,29,67
48455,455,48,2021,13832,360,2,362,126,274
48455,455,48,2022,13993,328,6,334,142,328
48455,455,48,2023,14228,390,6,396,147,306
48457,457,48,2020,19810,48,0,48,32,66
48457,457,48,2021,19898,257,0,257,210,379
48457,457,48,2022,20411,665,14,679,209,414
48457,457,48,2023,20382,124,13,137,210,375
48459,459,48,2020,41046,135,0,135,136,119
48459,459,48,2021,41835,948,8,956,483,625
48459,459,48,2022,42454,738,16,754,494,657
48459,459,48,2023,43281,917,18,935,496,600
48461,461,48,2020,3299,-7,0,-7,8,6
48461,461,48,2021,3233,-54,1,-53,32,44
48461,461,48,2022,3146,-86,1,-85,26,32
48461,461,48,2023,3109,-34,1,-33,27,31
48463,463,48,2020,24571,-33,2,-31,94,71
48463,463,48,2021,24803,174,41,215,358,351
48463,463,48,2022,24890,-30,80,50,401,349
48463,463,48,2023,24960,-90,76,-14,407,324
48465,465,48,2020,47605,-76,1,-75,190,103
48465,465,48,2021,47533,-264,42,-222,736,605
48465,465,48,2022,47617,-312,96,-216,806,496
48465,465,48,2023,47720,-376,107,-269,829,457
48467,467,48,2020,59758,247,0,247,151,174
48467,467,48,2021,61253,1880,14,1894,585,917
48467,467,48,2022,62888,1895,12,1907,650,985
48467,467,48,2023,64000,1329,10,1339,655,875
48469,469,48,2020,91311,-82,0,-82,282,233
48469,469,48,2021,90896,-508,7,-501,1167,1114
48469,469,48,2022,91074,35,39,74,1260,1104
48469,469,48,2023,91664,244,49,293,1299,1004
48471,471,48,2020,76553,124,3,127,155,159
48471,471,48,2021,78348,1839,93,1932,645,717
48471,471,48,2022,79678,1156,187,1343,675,712
48471,471,48,2023,81268,1335,204,1539,697,654
48473,473,48,2020,57285,492,0,492,180,102
48473,473,48,2021,59419,2014,36,2050,642,484
48473,473,48,2022,61852,2019,80,2099,747,509
48473,473,48,2023,63553,1338,83,1421,761,482
48475,475,48,2020,11674,-4,0,-4,61,26
48475,475,48,2021,11081,-572,3,-569,149,140
48475,475,48,2022,10948,-181,1,-180,168,123
48475,475,48,2023,10966,-37,1,-36,173,119
48477,477,48,2020,35804,51,0,51,76,132
48477,477,48,2021,35947,224,24,248,379,496
48477,477,48,2022,36368,528,22,550,368,517
48477,477,48,2023,37007,712,26,738,381,479
48479,479,48,2020,267363,-461,32,-429,1020,379
48479,479,48,2021,267400,-2155,319,-1836,4144,2349
48479,479,48,2022,267619,-3100,833,-2267,4363,1925
48479,479,48,2023,269148,-2054,795,-1259,4420,1664
48481,481,48,2020,41564,-34,0,-34,141,122
48481,481,48,2021,41652,112,26,138,504,580
48481,481,48,2022,41740,108,41,149,537,575
48481,481,48,2023,41739,-67,42,-25,555,534
48483,483,48,2020,4977,-12,0,-12,10,8
48483,483,48,2021,4886,-41,5,-36,43,98
48483,483,48,2022,4787,-81,11,-70,60,93
48483,483,48,2023,4804,31,13,44,64,91
48485,485,48,2020,129620,172,22,194,357,322
48485,485,48,2021,130073,551,54,605,1595,1822
48485,485,48,2022,130220,85,199,284,1698,1756
48485,485,48,2023,130180,-480,234,-246,1742,1539
48487,487,48,2020,12842,-32,0,-32,36,47
48487,487,48,2021,12703,-94,7,-87,157,211
48487,487,48,2022,12535,-160,10,-150,179,198
48487,487,48,2023,12522,-16,10,-6,184,191
48489,489,48,2020,20148,-17,0,-17,46,52
48489,489,48,2021,20292,152,5,157,235,254
48489,489,48,2022,20254,-50,12,-38,243,233
48489,489,48,2023,20037,-258,10,-248,245,212
48491,491,48,2020,615552,6350,37,6387,1625,927
48491,491,48,2021,644595,26263,758,27021,7135,3926
48491,491,48,2022,672273,20520,2118,22638,7909,3971
48491,491,48,2023,697191,17943,2390,20333,8043,3494
48493,493,48,2020,50052,275,0,275,133,97
48493,493,48,2021,51307,1282,18,1300,530,541
48493,493,48,2022,52754,1401,54,1455,587,640
48493,493,48,2023,54183,1370,57,1427,592,582
48495,495,48,2020,7754,-38,0,-38,17,14
48495,495,48,2021,7382,-386,14,-372,114,92
48495,495,48,2022,7300,-136,14,-122,125,89
48495,495,48,2023,7414,60,14,74,127,85
48497,497,48,2020,68947,305,0,305,195,172
48497,497,48,2021,71871,3093,23,3116,772,836
48497,497,48,2022,74897,2813,31,2844,903,834
48497,497,48,2023,78097,3008,31,3039,915,743
48499,499,48,2020,45037,288,1,289,92,165
48499,499,48,2021,46076,1543,26,1569,372,831
48499,499,48,2022,46930,1210,82,1292,410,902
48499,499,48,2023,47921,1295,90,1385,416,806
48501,501,48,2020,7675,-27,0,-27,27,17
48501,501,48,2021,7563,-168,22,-146,134,94
48501,501,48,2022,7484,-210,77,-133,129,80
48501,501,48,2023,7468,-144,73,-71,132,80
48503,503,48,2020,17849,9,0,9,42,73
48503,503,48,2021,17943,206,7,213,209,330
48503,503,48,2022,18012,156,7,163,232,323
48503,503,48,2023,18124,175,8,183,237,306
48505,505,48,2020,13875,-31,0,-31,47,29
48505,505,48,2021,13875,-58,5,-53,193,144
48505,505,48,2022,13838,-123,20,-103,205,141
48505,505,48,2023,13736,-188,20,-168,209,141
48507,507,48,2020,9661,-10,0,-10,38,36
48507,507,48,2021,9473,-164,1,-163,149,169
48507,507,48,2022,9384,-106,4,-102,162,150
48507,507,48,2023,9312,-97,3,-94,169,148
49001,001,49,2020,7083,-1,0,-1,23,10
49001,001,49,2021,7213,103,6,109,92,72
49001,001,49,2022,7317,84,4,88,104,86
49001,001,49,2023,7233,-123,10,-113,106,77
49003,003,49,2020,57946,176,0,176,226,128
49003,003,49,2021,59685,1480,4,1484,778,484
49003,003,49,2022,61523,1461,19,1480,836,515
49003,003,49,2023,62684,773,36,809,831,480
49005,005,49,2020,133631,22,-1,21,543,137
49005,005,49,2021,137458,2404,73,2477,2063,695
49005,005,49,2022,140145,1184,175,1359,2108,772
49005,005,49,2023,142393,515,333,848,2122,729
49007,007,49,2020,20487,64,0,64,62,55
49007,007,49,2021,20360,-94,1,-93,231,278
49007,007,49,2022,20540,254,-1,253,225,299
49007,007,49,2023,20609,135,2,137,226,291
49009,009,49,2020,952,18,0,18,1,1
49009,009,49,2021,982,22,0,22,15,6
49009,009,49,2022,1015,31,0,31,8,7
49009,009,49,2023,992,-27,0,-27,10,7
49011,011,49,2020,363771,161,8,169,1295,535
49011,011,49,2021,367504,813,101,914,4799,2262
49011,011,49,2022,369887,-139,261,122,4800,2353
49011,011,49,2023,373207,132,511,643,4769,2122
49013,013,49,2020,19620,-43,0,-43,91,33
49013,013,49,2021,19792,82,0,82,248,170
49013,013,49,2022,20142,249,0,249,283,187
49013,013,49,2023,20477,232,1,233,281,177
49015,015,49,2020,9847,17,0,17,25,23
49015,015,49,2021,9965,119,4,123,107,114
49015,015,49,2022,10093,131,7,138,120,129
49015,015,49,2023,10144,41,11,52,124,126
49017,017,49,2020,5103,6,0,6,21,11
49017,017,49,2021,5126,41,0,41,56,75
49017,017,49,2022,5258,135,0,135,58,62
49017,017,49,2023,5314,60,0,60,58,61
49019,019,49,2020,9674,5,0,5,24,19
49019,019,49,2021,9671,-34,5,-29,102,79
49019,019,49,2022,9771,71,15,86,96,86
49019,019,49,2023,9706,-104,26,-78,98,85
49021,021,49,2020,57713,302,0,302,226,87
49021,021,49,2021,60520,2551,15,2566,749,405
49021,021,49,2022,62508,1470,82,1552,832,446
49021,021,49,2023,64211,1136,161,1297,823,419
49023,023,49,2020,11819,7,0,7,45,13
49023,023,49,2021,12205,266,1,267,212,87
49023,023,49,2022,12586,259,2,261,206,86
49023,023,49,2023,13023,326,3,329,201,89
49025,025,49,2020,7693,15,0,15,26,13
49025,025,49,2021,7985,312,0,312,84,90
49025,025,49,2022,8203,215,-1,214,95,106
49025,025,49,2023,8425,231,1,232,93,101
49027,027,49,2020,13060,43,0,43,53,22
49027,027,49,2021,13192,78,2,80,188,141
49027,027,49,2022,13343,116,2,118,182,145
49027,027,49,2023,13437,40,6,46,180,133
49029,029,49,2020,12382,72,0,72,32,17
49029,029,49,2021,12662,216,0,216,139,76
49029,029,49,2022,12837,108,3,111,141,67
49029,029,49,2023,13000,90,6,96,139,70
49031,031,49,2020,1440,-1,0,-1,3,5
49031,031,49,2021,1492,52,0,52,19,17
49031,031,49,2022,1493,9,0,9,17,24
49031,031,49,2023,1550,64,0,64,18,24
49033,033,49,2020,2505,-8,0,-8,6,6
49033,033,49,2021,2600,79,0,79,35,15
49033,033,49,2022,2649,34,-1,33,31,16
49033,033,49,2023,2670,11,-1,10,28,18
49035,035,49,2020,1186983,-870,100,-770,3838,1829
49035,035,49,2021,1186312,-9358,1229,-8129,14930,7958
49035,035,49,2022,1186569,-9001,3248,-5753,14970,8380
49035,035,49,2023,1185813,-14070,5951,-8119,14841,7436
49037,037,49,2020,14521,4,0,4,46,46
49037,037,49,2021,14498,-57,0,-57,181,155
49037,037,49,2022,14406,-127,9,-118,181,157
49037,037,49,2023,14358,-96,17,-79,185,156
49039,039,49,2020,28526,51,0,51,87,58
49039,039,49,2021,29124,486,8,494,371,262
49039,039,49,2022,29691,452,12,464,387,288
49039,039,49,2023,30277,431,46,477,382,270
49041,041,49,2020,21554,16,0,16,71,48
49041,041,49,2021,21894,302,0,302,284,245
49041,041,49,2022,22043,111,-4,107,289,236
49041,041,49,2023,22344,248,-3,245,284,226
49043,043,49,2020,42489,48,0,48,109,48
49043,043,49,2021,43179,427,26,453,413,183
49043,043,49,2022,43045,-407,59,-348,425,210
49043,043,49,2023,42759,-613,115,-498,418,210
49045,045,49,2020,73355,500,0,500,268,101
49045,045,49,2021,76775,2927,20,2947,1051,467
49045,045,49,2022,79955,2516,17,2533,1085,520
49045,045,49,2023,82051,1464,56,1520,1070,491
49047,047,49,2020,35672,-30,0,-30,144,63
49047,047,49,2021,36229,336,12,348,535,338
49047,047,49,2022,37104,669,22,691,490,327
49047,047,49,2023,37747,413,50,463,497,318
49049,049,49,2020,663595,1738,13,1751,3049,699
49049,049,49,2021,685973,13442,492,13934,11866,3169
49049,049,49,2022,702692,6690,1323,8013,12138,3451
49049,049,49,2023,719174,5130,2381,7511,11955,3065
49051,051,49,2020,35055,228,0,228,97,40
49051,051,49,2021,36246,1010,22,1032,383,191
49051,051,49,2022,36597,115,59,174,381,186
49051,051,49,2023,37144,214,137,351,383,187
49053,053,49,2020,182015,1791,0,1791,533,416
49053,053,49,2021,191513,9484,16,9500,2251,1800
49053,053,49,2022,197730,5553,62,5615,2326,1970
49053,053,49,2023,202452,4023,173,4196,2298,1762
49055,055,49,2020,2503,15,0,15,12,6
49055,055,49,2021,2560,59,-1,58,41,41
49055,055,49,2022,2634,73,-1,72,32,33
49055,055,49,2023,2614,-17,-1,-18,32,33
49057,057,49,2020,262988,290,0,290,906,495
49057,057,49,2021,266569,2116,18,2134,3480,2118
49057,057,49,2022,269460,1487,89,1576,3525,2226
49057,057,49,2023,271926,679,257,936,3513,2006
50001,001,50,2020,37355,-18,0,-18,79,77
50001,001,50,2021,37408,91,32,123,271,369
50001,001,50,2022,37555,164,83,247,309,385
50001,001,50,2023,37720,153,96,249,289,373
50003,003,50,2020,37301,-8,0,-8,76,112
50003,003,50,2021,37431,305,33,338,272,493
50003,003,50,2022,37343,166,66,232,273,573
50003,003,50,2023,37183,47,77,124,263,545
50005,005,50,2020,30182,-18,0,-18,46,84
50005,005,50,2021,30457,344,7,351,251,328
50005,005,50,2022,30587,278,7,285,260,409
50005,005,50,2023,30610,175,6,181,239,397
50007,007,50,2020,168395,-29,19,-10,349,332
50007,007,50,2021,169338,416,267,683,1393,1258
50007,007,50,2022,169357,-581,633,52,1417,1378
50007,007,50,2023,169481,-789,872,83,1334,1297
50009,009,50,2020,5920,4,0,4,16,22
50009,009,50,2021,5970,73,0,73,55,75
50009,009,50,2022,5997,59,0,59,58,91
50009,009,50,2023,6010,46,0,46,56,89
50011,011,50,2020,50046,43,1,44,141,105
50011,011,50,2021,50430,316,11,327,504,462
50011,011,50,2022,50719,258,12,270,550,512
50011,011,50,2023,50994,202,20,222,524,473
50013,013,50,2020,7276,-10,0,-10,16,22
50013,013,50,2021,7428,164,1,165,68,76
50013,013,50,2022,7490,96,1,97,64,100
50013,013,50,2023,7467,13,3,16,62,101
50015,015,50,2020,25924,-30,0,-30,57,55
50015,015,50,2021,26149,231,7,238,225,243
50015,015,50,2022,26103,-37,45,8,217,256
50015,015,50,2023,26060,-67,65,-2,208,251
50017,017,50,2020,29295,22,0,22,50,67
50017,017,50,2021,29630,390,9,399,238,296
50017,017,50,2022,29880,279,15,294,274,316
50017,017,50,2023,29943,102,19,121,248,307
50019,019,50,2020,27403,5,0,5,64,73
50019,019,50,2021,27591,317,0,317,235,365
50019,019,50,2022,27562,219,-4,215,213,452
50019,019,50,2023,27516,187,-4,183,208,437
50021,021,50,2020,60484,-27,0,-27,114,189
50021,021,50,2021,60728,513,-1,512,479,762
50021,021,50,2022,60353,26,1,27,469,838
50021,021,50,2023,60271,261,3,264,444,790
50023,023,50,2020,59757,-13,0,-13,111,160
50023,023,50,2021,60033,413,11,424,446,606
50023,023,50,2022,60115,241,35,276,472,638
50023,023,50,2023,60142,157,39,196,443,609
50025,025,50,2020,45860,-18,0,-18,68,112
50025,025,50,2021,46150,472,5,477,295,486
50025,025,50,2022,45899,-29,18,-11,352,563
50025,025,50,2023,45966,229,32,261,336,529
50027,027,50,2020,57738,31,1,32,116,155
50027,027,50,2021,58350,797,33,830,421,628
50027,027,50,2022,58150,-13,97,84,457,705
50027,027,50,2023,58101,128,84,212,418,678
51001,001,51,2020,33392,1,5,6,89,128
51001,001,51,2021,33410,113,49,162,341,499
51001,001,51,2022,33223,-82,119,37,358,558
51001,001,51,2023,33239,121,68,189,359,532
51003,003,51,2020,112510,118,1,119,202,237
51003,003,51,2021,113882,1089,213,1302,1034,987
51003,003,51,2022,114845,413,562,975,1044,984
51003,003,51,2023,115676,299,405,704,1047,916
51005,005,51,2020,15180,-10,0,-10,43,62
51005,005,51,2021,14988,-11,0,-11,107,297
51005,005,51,2022,14715,-31,1,-30,80,318
51005,005,51,2023,14595,102,1,103,79,301
51007,007,51,2020,13267,4,0,4,42,41
51007,007,51,2021,13306,110,1,111,130,206
51007,007,51,2022,13368,166,7,173,121,228
51007,007,51,2023,13480,203,6,209,123,219
51009,009,51,2020,31312,28,0,28,61,93
51009,009,51,2021,31385,165,14,179,311,433
51009,009,51,2022,31472,245,40,285,285,486
51009,009,51,2023,31396,99,14,113,275,464
51011,011,51,2020,16154,36,0,36,42,41
51011,011,51,2021,16398,222,7,229,202,186
51011,011,51,2022,16703,302,5,307,195,203
51011,011,51,2023,16864,163,1,164,190,194
51013,013,51,2020,238814,-323,50,-273,699,360
51013,013,51,2021,233436,-7298,959,-6339,2401,1103
51013,013,51,2022,233678,-3675,2397,-1278,2526,1018
51013,013,51,2023,234162,-2979,1838,-1141,2601,974
51015,015,51,2020,77574,183,0,183,110,209
51015,015,51,2021,77764,522,30,552,501,894
51015,015,51,2022,77939,583,47,630,520,962
51015,015,51,2023,78247,641,33,674,521,886
51017,017,51,2020,4185,-7,0,-7,9,19
51017,017,51,2021,4090,-57,2,-55,39,77
51017,017,51,2022,4061,3,1,4,44,77
51017,017,51,2023,4051,22,1,23,43,75
51019,019,51,2020,79559,156,0,156,147,217
51019,019,51,2021,80242,1087,21,1108,624,1045
51019,019,51,2022,80741,880,48,928,657,1072
51019,019,51,2023,81525,1085,35,1120,644,970
51021,021,51,2020,6256,-3,0,-3,7,21
51021,021,51,2021,6177,-25,0,-25,37,95
51021,021,51,2022,6138,29,0,29,36,102
51021,021,51,2023,6179,113,0,113,32,102
51023,023,51,2020,33643,75,0,75,60,90
51023,023,51,2021,33998,519,9,528,239,406
51023,023,51,2022,34100,315,12,327,263,483
51023,023,51,2023,34125,214,9,223,263,456
51025,025,51,2020,15822,-7,0,-7,31,52
51025,025,51,2021,15959,253,3,256,143,256
51025,025,51,2022,15831,23,12,35,121,276
51025,025,51,2023,15749,59,9,68,118,267
51027,027,51,2020,20245,-59,0,-59,46,79
51027,027,51,2021,19876,-163,5,-158,151,365
51027,027,51,2022,19383,-289,11,-278,180,401
51027,027,51,2023,19087,-104,5,-99,181,379
51029,029,51,2020,16828,22,0,22,27,55
51029,029,51,2021,16950,206,1,207,136,220
51029,029,51,2022,16988,127,2,129,134,225
51029,029,51,2023,16978,77,0,77,133,222
51031,031,51,2020,55639,-6,1,-5,101,166
51031,031,51,2021,55344,36,21,57,359,752
51031,031,51,2022,55065,82,48,130,391,769
51031,031,51,2023,55270,525,17,542,375,712
51033,033,51,2020,30921,27,0,27,90,82
51033,033,51,2021,31405,501,8,509,338,351
51033,033,51,2022,31940,511,34,545,353,382
51033,033,51,2023,32640,692,26,718,354,371
51035,035,51,2020,29148,47,1,48,61,120
51035,035,51,2021,29098,156,25,181,238,479
51035,035,51,2022,29118,279,23,302,260,539
51035,035,51,2023,29239,344,10,354,269,502
51036,036,51,2020,6746,-17,0,-17,19,26
51036,036,51,2021,6608,-49,0,-49,28,118
51036,036,51,2022,6568,42,0,42,37,117
51036,036,51,2023,6610,120,0,120,37,114
51037,037,51,2020,11542,4,0,4,46,44
51037,037,51,2021,11499,20,2,22,149,222
51037,037,51,2022,11400,0,1,1,147,240
51037,037,51,2023,11336,28,-2,26,146,235
51041,041,51,2020,365311,962,19,981,984,786
51041,041,51,2021,370931,4447,355,4802,3941,3196
51041,041,51,2022,378290,5446,1031,6477,4138,3270
51041,041,51,2023,383876,3635,767,4402,4144,2935
51043,043,51,2020,14814,20,0,20,36,33
51043,043,51,2021,14940,175,1,176,142,194
51043,043,51,2022,15331,408,3,411,158,184
51043,043,51,2023,15466,154,3,157,159,181
51045,045,51,2020,4875,-2,0,-2,7,21
51045,045,51,2021,4886,29,0,29,45,64
51045,045,51,2022,4858,-3,0,-3,46,72
51045,045,51,2023,4843,13,0,13,45,73
51047,047,51,2020,52768,167,2,169,173,126
51047,047,51,2021,53772,786,54,840,670,505
51047,047,51,2022,54290,287,147,434,667,566
51047,047,51,2023,54973,438,113,551,664,529
51049,049,51,2020,9666,-2,0,-2,19,31
51049,049,51,2021,9703,72,4,76,76,117
51049,049,51,2022,9751,86,13,99,83,132
51049,049,51,2023,9878,167,9,176,84,131
51051,051,51,2020,14074,-28,0,-28,26,51
51051,051,51,2021,13860,-102,2,-100,112,230
51051,051,51,2022,13733,-4,5,1,109,230
51051,051,51,2023,13640,4,4,8,120,220
51053,053,51,2020,27891,-4,0,-4,37,88
51053,053,51,2021,27997,237,9,246,201,348
51053,053,51,2022,28099,265,23,288,182,372
51053,053,51,2023,28343,409,18,427,182,364
51057,057,51,2020,10598,10,0,10,23,36
51057,057,51,2021,10571,15,1,16,118,165
51057,057,51,2022,10630,123,5,128,112,187
51057,057,51,2023,10598,35,3,38,113,183
51059,059,51,2020,1148627,-3198,325,-2873,3141,1862
51059,059,51,2021,1142203,-16888,4262,-12626,12357,5910
51059,059,51,2022,1139309,-21564,11254,-10310,12580,5721
51059,059,51,2023,1141878,-13405,8536,-4869,12496,5120
51061,061,51,2020,73006,-6,0,-6,190,160
51061,061,51,2021,74055,928,26,954,700,615
51061,061,51,2022,74677,550,98,648,745,715
51061,061,51,2023,75165,350,68,418,742,662
51063,063,51,2020,15470,5,0,5,36,49
51063,063,51,2021,15510,132,5,137,126,227
51063,063,51,2022,15623,198,14,212,112,214
51063,063,51,2023,15679,150,10,160,111,213
51065,065,51,2020,27294,40,0,40,63,65
51065,065,51,2021,27797,529,5,534,266,284
51065,065,51,2022,28117,352,4,356,260,297
51065,065,51,2023,28462,371,1,372,259,285
51067,067,51,2020,54482,61,0,61,119,168
51067,067,51,2021,55017,797,15,812,483,749
51067,067,51,2022,55079,302,51,353,510,793
51067,067,51,2023,55549,669,31,700,509,739
51069,069,51,2020,91870,408,1,409,245,195
51069,069,51,2021,93959,2075,72,2147,926,940
51069,069,51,2022,94808,827,165,992,902,1010
51069,069,51,2023,95994,1113,96,1209,902,918
51071,071,51,2020,16786,24,0,24,35,65
51071,071,51,2021,16572,-63,0,-63,150,307
51071,071,51,2022,16432,22,-1,21,152,303
51071,071,51,2023,16457,167,-1,166,150,289
51073,073,51,2020,38722,26,0,26,83,114
51073,073,51,2021,39174,588,2,590,370,504
51073,073,51,2022,39550,505,2,507,376,503
51073,073,51,2023,40057,614,1,615,369,474
51075,075,51,2020,24855,161,0,161,35,55
51075,075,51,2021,25529,779,3,782,193,270
51075,075,51,2022,26162,682,6,688,211,282
51075,075,51,2023,27197,1097,4,1101,211,272
51077,077,51,2020,15281,-2,0,-2,17,72
51077,077,51,2021,15344,199,7,206,121,262
51077,077,51,2022,15325,149,4,153,118,288
51077,077,51,2023,15285,110,1,111,119,267
51079,079,51,2020,20607,50,0,50,48,47
51079,079,51,2021,21004,374,3,377,239,211
51079,079,51,2022,21015,12,13,25,237,243
51079,079,51,2023,21301,270,7,277,237,230
51081,081,51,2020,11386,6,0,6,30,46
51081,081,51,2021,11413,84,2,86,99,159
51081,081,51,2022,11204,-147,0,-147,93,159
51081,081,51,2023,11133,-9,-1,-10,96,158
51083,083,51,2020,33926,-45,0,-45,85,136
51083,083,51,2021,33777,68,4,72,348,592
51083,083,51,2022,33620,148,7,155,333,627
51083,083,51,2023,33432,70,2,72,332,592
51085,085,51,2020,110202,198,1,199,264,270
51085,085,51,2021,111783,1804,39,1843,969,1219
51085,085,51,2022,112860,1249,55,1304,1066,1253
51085,085,51,2023,114148,1346,33,1379,1066,1145
51087,087,51,2020,334905,-171,48,-123,886,878
51087,087,51,2021,334422,-1464,798,-666,3568,3540
51087,087,51,2022,334553,-1865,1838,-27,3683,3444
51087,087,51,2023,334760,-1760,1386,-374,3690,3111
51089,089,51,2020,50851,-14,0,-14,92,188
51089,089,51,2021,50262,-40,9,-31,357,951
51089,089,51,2022,49795,157,3,160,378,982
51089,089,51,2023,49702,431,-1,430,393,908
51091,091,51,2020,2240,12,0,12,7,10
51091,091,51,2021,2239,13,0,13,9,22
51091,091,51,2022,2296,72,-1,71,17,33
51091,091,51,2023,2339,61,-1,60,18,33
51093,093,51,2020,38707,95,2,97,84,90
51093,093,51,2021,39391,750,35,785,388,479
51093,093,51,2022,40135,731,78,809,409,482
51093,093,51,2023,40711,564,65,629,408,459
51095,095,51,2020,78487,218,0,218,220,202
51095,095,51,2021,79991,1626,62,1688,757,899
51095,095,51,2022,81483,1294,172,1466,827,824
51095,095,51,2023,82654,1003,133,1136,822,774
51097,097,51,2020,6588,-6,0,-6,11,24
51097,097,51,2021,6669,142,0,142,56,110
51097,097,51,2022,6714,102,0,102,47,104
51097,097,51,2023,6720,60,0,60,47,102
51099,099,51,2020,26826,76,0,76,79,57
51099,099,51,2021,27541,638,7,645,302,218
51099,099,51,2022,27918,234,32,266,319,201
51099,099,51,2023,28568,511,21,532,321,204
51101,101,51,2020,17918,118,0,118,51,54
51101,101,51,2021,18243,280,7,287,227,188
51101,101,51,2022,18529,241,11,252,246,223
51101,101,51,2023,19030,470,9,479,245,221
51103,103,51,2020,10903,36,0,36,8,60
51103,103,51,2021,10935,200,3,203,76,240
51103,103,51,2022,10806,40,5,45,73,245
51103,103,51,2023,10859,205,4,209,73,228
51105,105,51,2020,22108,-42,0,-42,55,78
51105,105,51,2021,22005,111,2,113,194,423
51105,105,51,2022,21847,96,5,101,168,412
51105,105,51,2023,21745,106,3,109,173,385
51107,107,51,2020,422705,885,66,951,1183,511
51107,107,51,2021,428764,1710,999,2709,4814,1758
51107,107,51,2022,432792,-1770,2586,816,5001,1759
51107,107,51,2023,436347,-1762,1962,200,4924,1620
51109,109,51,2020,37796,205,1,206,105,95
51109,109,51,2021,39016,1276,24,1300,418,442
51109,109,51,2022,40030,978,74,1052,419,499
51109,109,51,2023,41037,1018,44,1062,416,472
51111,111,51,2020,11947,17,1,18,34,44
51111,111,51,2021,12001,89,15,104,121,174
51111,111,51,2022,12002,49,23,72,114,179
51111,111,51,2023,12038,75,18,93,115,171
51113,113,51,2020,13861,33,0,33,21,33
51113,113,51,2021,13957,115,7,122,134,163
51113,113,51,2022,14008,71,35,106,127,175
51113,113,51,2023,14128,139,26,165,128,172
51115,115,51,2020,8518,19,0,19,13,44
51115,115,51,2021,8543,118,0,118,59,150
51115,115,51,2022,8450,25,0,25,62,178
51115,115,51,2023,8514,174,0,174,63,171
51117,117,51,2020,30283,38,2,40,66,139
51117,117,51,2021,30333,251,33,284,286,523
51117,117,51,2022,30527,373,79,452,298,563
51117,117,51,2023,30648,295,64,359,301,540
51119,119,51,2020,10614,27,0,27,12,46
51119,119,51,2021,10779,274,8,282,90,196
51119,119,51,2022,10952,249,40,289,90,215
51119,119,51,2023,10924,56,32,88,90,206
51121,121,51,2020,99574,-179,17,-162,182,167
51121,121,51,2021,98788,-924,259,-665,649,785
51121,121,51,2022,98826,-529,750,221,641,805
51121,121,51,2023,98666,-623,584,-39,634,763
51125,125,51,2020,14740,-16,0,-16,33,51
51125,125,51,2021,14838,149,8,157,152,212
51125,125,51,2022,14747,-70,29,-41,167,209
51125,125,51,2023,14705,-22,22,0,166,207
51127,127,51,2020,23123,186,0,186,56,45
51127,127,51,2021,23963,883,1,884,241,245
51127,127,51,2022,24952,930,4,934,255,248
51127,127,51,2023,26134,1172,1,1173,253,245
51131,131,51,2020,12213,-12,0,-12,22,78
51131,131,51,2021,12068,-40,5,-35,101,215
51131,131,51,2022,11978,-12,32,20,113,216
51131,131,51,2023,12021,117,24,141,114,212
51133,133,51,2020,11841,41,0,41,16,49
51133,133,51,2021,12052,370,-1,369,86,223
51133,133,51,2022,12278,365,-2,363,84,248
51133,133,51,2023,12391,261,-2,259,85,232
51135,135,51,2020,15647,6,0,6,38,49
51135,135,51,2021,15574,23,1,24,149,251
51135,135,51,2022,15555,72,16,88,170,267
51135,135,51,2023,15566,86,11,97,169,253
51137,137,51,2020,36397,210,2,212,103,90
51137,137,51,2021,37220,897,9,906,431,485
51137,137,51,2022,38055,830,23,853,441,475
51137,137,51,2023,38574,526,9,535,438,455
51139,139,51,2020,23691,19,0,19,54,98
51139,139,51,2021,23825,253,9,262,216,347
51139,139,51,2022,23777,83,24,107,214,361
51139,139,51,2023,23741,67,18,85,213,335
51141,141,51,2020,17591,7,0,7,33,59
51141,141,51,2021,17650,276,0,276,147,361
51141,141,51,2022,17601,164,-1,163,157,366
51141,141,51,2023,17509,94,-1,93,160,345
51143,143,51,2020,60367,-60,0,-60,115,190
51143,143,51,2021,60038,79,3,82,443,893
51143,143,51,2022,59824,281,7,288,420,895
51143,143,51,2023,59571,158,-1,157,406,812
51145,145,51,2020,30450,128,0,128,53,69
51145,145,51,2021,31230,809,1,810,290,297
51145,145,51,2022,31585,363,27,390,285,318
51145,145,51,2023,32105,521,20,541,285,304
51147,147,51,2020,21906,46,0,46,74,67
51147,147,51,2021,21962,74,22,96,208,259
51147,147,51,2022,21899,-28,40,12,211,274
51147,147,51,2023,22049,175,33,208,207,266
51149,149,51,2020,43073,26,5,31,81,68
51149,149,51,2021,42962,-126,-19,-145,358,348
51149,149,51,2022,43021,2,78,80,371,371
51149,149,51,2023,42871,-211,54,-157,369,363
51153,153,51,2020,482834,-388,92,-296,1530,730
51153,153,51,2021,485352,-2588,1384,-1204,6137,2627
51153,153,51,2022,487012,-5710,3508,-2202,6269,2548
51153,153,51,2023,489640,-3991,2658,-1333,6230,2324
51155,155,51,2020,33807,46,0,46,76,115
51155,155,51,2021,33816,261,4,265,297,560
51155,155,51,2022,33683,144,11,155,298,578
51155,155,51,2023,33655,206,5,211,296,536
51157,157,51,2020,7320,-19,0,-19,11,19
51157,157,51,2021,7431,149,6,155,38,77
51157,157,51,2022,7453,77,8,85,34,97
51157,157,51,2023,7414,24,-3,21,35,94
51159,159,51,2020,8919,11,1,12,17,31
51159,159,51,2021,9077,168,11,179,105,122
51159,159,51,2022,9126,57,36,93,93,131
51159,159,51,2023,9184,80,15,95,93,128
51161,161,51,2020,96923,75,1,76,163,275
51161,161,51,2021,96671,192,59,251,711,1285
51161,161,51,2022,96756,555,149,704,707,1278
51161,161,51,2023,97026,612,110,722,700,1145
51163,163,51,2020,22650,25,0,25,33,62
51163,163,51,2021,22638,215,0,215,106,334
51163,163,51,2022,22568,183,2,185,100,349
51163,163,51,2023,22358,18,3,21,98,327
51165,165,51,2020,83774,30,2,32,210,249
51165,165,51,2021,84518,683,94,777,863,931
51165,165,51,2022,85414,792,222,1014,921,1019
51165,165,51,2023,86568,1012,155,1167,917,923
51167,167,51,2020,25757,6,0,6,43,82
51167,167,51,2021,25572,-1,1,0,241,440
51167,167,51,2022,25437,78,3,81,267,467
51167,167,51,2023,25477,209,3,212,265,436
51169,169,51,2020,21589,45,0,45,39,66
51169,169,51,2021,21476,120,1,121,166,410
51169,169,51,2022,21480,227,0,227,182,399
51169,169,51,2023,21433,155,0,155,178,377
51171,171,51,2020,44265,110,1,111,130,166
51171,171,51,2021,44842,677,39,716,508,638
51171,171,51,2022,44936,178,103,281,474,644
51171,171,51,2023,45228,328,81,409,472,588
51173,173,51,2020,29787,32,0,32,58,113
51173,173,51,2021,29608,77,10,87,283,566
51173,173,51,2022,29408,120,21,141,280,606
51173,173,51,2023,29216,74,13,87,280,559
51175,175,51,2020,17953,-20,0,-20,29,56
51175,175,51,2021,18024,216,0,216,103,248
51175,175,51,2022,17899,38,-1,37,109,261
51175,175,51,2023,17975,227,-1,226,108,257
51177,177,51,2020,140604,417,0,417,374,300
51177,177,51,2021,144003,2993,93,3086,1505,1131
51177,177,51,2022,146828,2145,317,2462,1578,1203
51177,177,51,2023,149588,2102,224,2326,1569,1112
51179,179,51,2020,157765,556,-8,548,451,213
51179,179,51,2021,161568,2854,175,3029,1722,947
51179,179,51,2022,163169,343,553,896,1782,1004
51179,179,51,2023,165428,1029,431,1460,1772,945
51181,181,51,2020,6551,0,0,0,19,27
51181,181,51,2021,6533,2,0,2,65,87
51181,181,51,2022,6527,31,-1,30,68,104
51181,181,51,2023,6593,105,-1,104,68,106
51183,183,51,2020,10787,-21,0,-21,25,45
51183,183,51,2021,10815,85,0,85,87,144
51183,183,51,2022,10640,-82,0,-82,86,178
51183,183,51,2023,10757,212,0,212,85,178
51185,185,51,2020,40407,18,0,18,97,152
51185,185,51,2021,39950,-1,9,8,300,794
51185,185,51,2022,39563,146,21,167,263,789
51185,185,51,2023,39120,31,16,47,242,731
51187,187,51,2020,40792,40,0,40,111,93
51187,187,51,2021,40965,136,32,168,427,447
51187,187,51,2022,41404,400,110,510,457,534
51187,187,51,2023,41843,414,82,496,451,506
51191,191,51,2020,53895,8,0,8,114,177
51191,191,51,2021,53735,233,3,236,465,890
51191,191,51,2022,53855,536,18,554,454,885
51191,191,51,2023,54050,548,6,554,453,806
51193,193,51,2020,18511,63,0,63,39,63
51193,193,51,2021,18772,352,1,353,177,260
51193,193,51,2022,18765,82,6,88,169,260
51193,193,51,2023,19013,340,-5,335,170,258
51195,195,51,2020,36064,-20,0,-20,84,124
51195,195,51,2021,35681,-110,10,-100,319,620
51195,195,51,2022,35327,-22,6,-16,348,664
51195,195,51,2023,35174,105,-1,104,353,608
51197,197,51,2020,28324,41,0,41,77,90
51197,197,51,2021,28201,105,1,106,257,499
51197,197,51,2022,28115,150,2,152,281,509
51197,197,51,2023,28104,178,0,178,282,471
51199,199,51,2020,70232,120,4,124,154,122
51199,199,51,2021,71104,837,43,880,584,610
51199,199,51,2022,71164,-10,114,104,608,630
51199,199,51,2023,70952,-308,79,-229,604,588
51510,510,51,2020,159139,-740,37,-703,610,245
51510,510,51,2021,155105,-5953,751,-5202,2291,853
51510,510,51,2022,155045,-3113,1841,-1272,2249,959
51510,510,51,2023,155230,-2570,1428,-1142,2284,902
51520,520,51,2020,17299,94,0,94,53,61
51520,520,51,2021,17065,-76,0,-76,158,324
51520,520,51,2022,16940,19,-3,16,182,313
51520,520,51,2023,16807,-8,-6,-14,185,302
51530,530,51,2020,6622,-17,0,-17,20,21
51530,530,51,2021,6622,1,1,2,95,100
51530,530,51,2022,6569,-11,-6,-17,80,112
51530,530,51,2023,6566,33,-6,27,79,109
51540,540,51,2020,46469,-152,3,-149,133,68
51540,540,51,2021,45746,-1063,124,-939,585,334
51540,540,51,2022,45272,-972,262,-710,576,375
51540,540,51,2023,44983,-694,192,-502,575,365
51550,550,51,2020,249781,156,2,158,684,529
51550,550,51,2021,251763,1029,182,1211,2916,2323
51550,550,51,2022,252459,-252,478,226,2990,2402
51550,550,51,2023,253886,235,379,614,2985,2166
51570,570,51,2020,18189,28,0,28,67,79
51570,570,51,2021,18225,52,4,56,264,292
51570,570,51,2022,18278,103,11,114,271,323
51570,570,51,2023,18393,147,7,154,271,308
51580,580,51,2020,5745,0,0,0,18,21
51580,580,51,2021,5716,1,0,1,88,122
51580,580,51,2022,5633,-35,4,-31,73,122
51580,580,51,2023,5545,-43,4,-39,73,122
51590,590,51,2020,42579,12,0,12,132,168
51590,590,51,2021,42285,89,21,110,465,896
51590,590,51,2022,42017,143,47,190,464,910
51590,590,51,2023,41837,212,29,241,435,854
51595,595,51,2020,5707,-32,0,-32,16,38
51595,595,51,2021,5638,-19,0,-19,69,118
51595,595,51,2022,5533,-77,3,-74,70,104
51595,595,51,2023,5463,-36,2,-34,67,103
51600,600,51,2020,24177,-65,4,-61,157,63
51600,600,51,2021,24353,-286,143,-143,587,276
51600,600,51,2022,24752,-283,380,97,600,308
51600,600,51,2023,25144,-189,286,97,595,300
51610,610,51,2020,14681,2,0,2,53,34
51610,610,51,2021,14516,-215,23,-192,154,121
51610,610,51,2022,14489,-88,63,-25,170,175
51610,610,51,2023,14685,140,50,190,173,166
51620,620,51,2020,8146,-11,0,-11,22,40
51620,620,51,2021,8152,6,0,6,169,174
51620,620,51,2022,8274,144,0,144,159,183
51620,620,51,2023,8339,87,0,87,157,179
51630,630,51,2020,27991,3,2,5,73,69
51630,630,51,2021,28437,229,94,323,395,274
51630,630,51,2022,28648,-95,289,194,350,314
51630,630,51,2023,28928,16,221,237,348,305
51640,640,51,2020,6715,-3,0,-3,25,32
51640,640,51,2021,6653,-16,-1,-17,108,157
51640,640,51,2022,6702,108,-3,105,118,176
51640,640,51,2023,6717,68,-3,65,120,169
51650,650,51,2020,137280,10,0,10,377,306
51650,650,51,2021,137760,324,80,404,1630,1648
51650,650,51,2022,137858,-54,234,180,1647,1646
51650,650,51,2023,137098,-1071,180,-891,1637,1504
51660,660,51,2020,51706,-183,4,-179,181,102
51660,660,51,2021,51497,-633,173,-460,581,337
51660,660,51,2022,51150,-1163,564,-599,599,371
51660,660,51,2023,51082,-736,425,-311,595,355
51670,670,51,2020,23009,-47,1,-46,88,67
51670,670,51,2021,23073,153,5,158,300,402
51670,670,51,2022,22790,-166,15,-151,312,429
51670,670,51,2023,22752,54,8,62,317,418
51678,678,51,2020,7324,0,0,0,24,22
51678,678,51,2021,7455,93,13,106,111,86
51678,678,51,2022,7506,-20,27,7,122,75
51678,678,51,2023,7528,-50,21,-29,121,69
51680,680,51,2020,78979,-149,0,-149,303,199
51680,680,51,2021,79114,-218,71,-147,1223,997
51680,680,51,2022,79228,-207,170,-37,1192,982
51680,680,51,2023,79535,-44,127,83,1149,922
51683,683,51,2020,42692,-154,6,-148,160,99
51683,683,51,2021,42764,-502,177,-325,697,312
51683,683,51,2022,42673,-990,556,-434,695,370
51683,683,51,2023,42696,-697,394,-303,693,365
51685,685,51,2020,17162,-59,3,-56,9,10
51685,685,51,2021,17089,-137,65,-72,54,57
51685,685,51,2022,16693,-558,156,-402,69,85
51685,685,51,2023,16361,-415,100,-315,70,85
51690,690,51,2020,13474,-12,1,-11,57,57
51690,690,51,2021,13534,102,27,129,260,335
51690,690,51,2022,13697,153,54,207,264,306
51690,690,51,2023,13763,61,43,104,260,298
51700,700,51,2020,186047,-467,5,-462,653,412
51700,700,51,2021,184691,-2226,231,-1995,2586,1962
51700,700,51,2022,183980,-1763,541,-1222,2519,1949
51700,700,51,2023,183118,-1977,387,-1590,2504,1768
51710,710,51,2020,237789,-564,3,-561,799,531
51710,710,51,2021,234862,-3896,314,-3582,3087,2416
51710,710,51,2022,232558,-3857,900,-2957,3114,2446
51710,710,51,2023,230930,-3214,727,-2487,3102,2208
51720,720,51,2020,3681,-2,0,-2,9,23
51720,720,51,2021,3632,-10,0,-10,35,75
51720,720,51,2022,3589,16,0,16,39,97
51720,720,51,2023,3492,-44,0,-44,41,93
51730,730,51,2020,33396,-57,3,-54,140,160
51730,730,51,2021,33411,-92,11,-81,737,660
51730,730,51,2022,33462,-63,79,16,730,675
51730,730,51,2023,33309,-286,47,-239,730,640
51735,735,51,2020,12473,18,0,18,28,29
51735,735,51,2021,12628,169,2,171,130,146
51735,735,51,2022,12624,4,5,9,132,138
51735,735,51,2023,12635,11,2,13,132,132
51740,740,51,2020,97955,30,5,35,293,306
51740,740,51,2021,97652,-472,59,-413,1375,1332
51740,740,51,2022,96954,-701,79,-622,1333,1347
51740,740,51,2023,96793,-316,63,-253,1329,1229
51750,750,51,2020,16119,21,0,21,41,19
51750,750,51,2021,16527,415,2,417,151,149
51750,750,51,2022,16719,165,22,187,141,140
51750,750,51,2023,16971,231,20,251,141,140
51760,760,51,2020,226936,67,21,88,765,469
51760,760,51,2021,227140,-899,482,-417,2874,2352
51760,760,51,2022,228367,-374,1208,834,2973,2529
51760,760,51,2023,229247,-717,910,193,2971,2241
51770,770,51,2020,99891,-135,5,-130,333,356
51770,770,51,2021,98700,-1129,133,-996,1308,1510
51770,770,51,2022,97657,-1087,352,-735,1267,1549
51770,770,51,2023,97171,-576,271,-305,1266,1433
51775,775,51,2020,25403,63,0,63,84,95
51775,775,51,2021,25416,87,21,108,288,400
51775,775,51,2022,25700,292,74,366,326,402
51775,775,51,2023,25600,-88,57,-31,321,391
51790,790,51,2020,25812,70,0,70,87,93
51790,790,51,2021,25689,-132,36,-96,359,397
51790,790,51,2022,25940,219,97,316,362,426
51790,790,51,2023,25915,-53,72,19,364,404
51800,800,51,2020,94750,401,1,402,256,264
51800,800,51,2021,96337,1444,41,1485,1151,1034
51800,800,51,2022,98426,1857,120,1977,1129,1067
51800,800,51,2023,100659,2013,88,2101,1125,992
51810,810,51,2020,459684,-426,14,-412,1360,859
51810,810,51,2021,458569,-3104,389,-2715,5293,3862
51810,810,51,2022,455069,-6028,1153,-4875,5369,4057
51810,810,51,2023,453649,-4026,881,-3145,5353,3635
51820,820,51,2020,22279,71,0,71,77,60
51820,820,51,2021,22606,265,7,272,361,300
51820,820,51,2022,22799,135,19,154,356,319
51820,820,51,2023,23182,325,13,338,356,312
51830,830,51,2020,15471,69,1,70,14,24
51830,830,51,2021,15609,201,35,236,44,145
51830,830,51,2022,15685,180,67,247,61,232
51830,830,51,2023,15847,273,48,321,63,222
51840,840,51,2020,28013,-114,0,-114,80,72
51840,840,51,2021,28092,22,56,78,343,362
51840,840,51,2022,27861,-313,102,-211,338,347
51840,840,51,2023,27617,-310,62,-248,335,331
53001,001,53,2020,20607,-59,3,-56,83,29
53001,001,53,2021,20647,-228,48,-180,369,145
53001,001,53,2022,20898,2,70,72,348,160
53001,001,53,2023,20820,-279,14,-265,349,160
53003,003,53,2020,22324,55,0,55,53,69
53003,003,53,2021,22469,215,5,220,216,296
53003,003,53,2022,22536,133,7,140,234,306
53003,003,53,2023,22549,97,5,102,221,309
53005,005,53,2020,207419,309,6,315,638,444
53005,005,53,2021,210599,2269,191,2460,2490,1801
53005,005,53,2022,212829,1198,580,1778,2542,2008
53005,005,53,2023,215219,1435,376,1811,2477,1900
53007,007,53,2020,79238,114,1,115,206,177
53007,007,53,2021,79778,493,24,517,781,774
53007,007,53,2022,80038,158,224,382,795,879
53007,007,53,2023,79997,-72,89,17,791,850
53009,009,53,2020,77367,324,0,324,168,258
53009,009,53,2021,78466,1658,41,1699,607,1142
53009,009,53,2022,77684,-57,86,29,554,1313
53009,009,53,2023,77616,573,54,627,546,1243
53011,011,53,2020,505338,1728,14,1742,1354,1041
53011,011,53,2021,512583,5678,448,6126,5373,4287
53011,011,53,2022,516737,2272,1022,3294,5659,4723
53011,011,53,2023,521150,2572,766,3338,5536,4500
53013,013,53,2020,3949,8,0,8,4,14
53013,013,53,2021,4016,100,1,101,37,67
53013,013,53,2022,4026,43,3,46,33,71
53013,013,53,2023,4053,59,1,60,34,66
53015,015,53,2020,111014,287,2,289,296,297
53015,015,53,2021,111685,813,39,852,1207,1422
53015,015,53,2022,112064,563,107,670,1230,1509
53015,015,53,2023,112864,937,55,992,1218,1412
53017,017,53,2020,43029,31,0,31,139,83
53017,017,53,2021,43837,615,73,688,467,341
53017,017,53,2022,44223,74,209,283,512,395
53017,017,53,2023,44798,360,83,443,508,377
53019,019,53,2020,7198,28,0,28,14,22
53019,019,53,2021,7290,128,1,129,65,98
53019,019,53,2022,7468,221,10,231,68,135
53019,019,53,2023,7497,85,6,91,63,124
53021,021,53,2020,97150,121,6,127,377,133
53021,021,53,2021,98102,-201,178,-23,1423,521
53021,021,53,2022,98582,-869,466,-403,1461,566
53021,021,53,2023,99034,-631,188,-443,1441,551
53023,023,53,2020,2294,7,0,7,5,2
53023,023,53,2021,2344,64,1,65,22,33
53023,023,53,2022,2357,16,0,16,29,33
53023,023,53,2023,2363,12,0,12,27,32
53025,025,53,2020,99441,101,5,106,360,179
53025,025,53,2021,100427,345,79,424,1366,863
53025,025,53,2022,101580,205,527,732,1399,926
53025,025,53,2023,102678,404,203,607,1365,882
53027,027,53,2020,75855,324,0,324,171,253
53027,027,53,2021,76838,1334,11,1345,686,1019
53027,027,53,2022,77041,655,39,694,685,1186
53027,027,53,2023,77290,696,28,724,675,1152
53029,029,53,2020,86998,173,3,176,182,197
53029,029,53,2021,87566,666,21,687,767,879
53029,029,53,2022,86682,-755,71,-684,778,931
53029,029,53,2023,86267,-347,83,-264,761,897
53031,031,53,2020,33061,179,0,179,30,95
53031,031,53,2021,33553,807,20,827,138,436
53031,031,53,2022,33570,262,44,306,162,451
53031,031,53,2023,33714,396,23,419,162,436
53033,033,53,2020,2274282,1311,419,1730,5984,3563
53033,033,53,2021,2252980,-37684,8663,-29021,23216,14728
53033,033,53,2022,2265311,-16162,22676,6514,23217,15801
53033,033,53,2023,2271380,-20431,18815,-1616,22890,15088
53035,035,53,2020,275823,26,-3,23,664,554
53035,035,53,2021,276589,289,98,387,2753,2483
53035,035,53,2022,277813,766,428,1194,2827,2695
53035,035,53,2023,277658,-716,324,-392,2809,2551
53037,037,53,2020,44599,293,0,293,91,73
53037,037,53,2021,44645,11,18,29,361,362
53037,037,53,2022,45122,442,18,460,401,398
53037,037,53,2023,45508,375,9,384,397,394
53039,039,53,2020,22814,82,1,83,57,49
53039,039,53,2021,23167,402,31,433,195,264
53039,039,53,2022,23303,87,114,201,209,277
53039,039,53,2023,23589,321,50,371,186,273
53041,041,53,2020,82553,445,1,446,224,229
53041,041,53,2021,84569,2226,32,2258,886,1049
53041,041,53,2022,85357,942,53,995,941,1168
53041,041,53,2023,86154,962,34,996,926,1126
53043,043,53,2020,10928,50,0,50,31,28
53043,043,53,2021,11284,401,1,402,109,136
53043,043,53,2022,11613,353,2,355,103,145
53043,043,53,2023,11738,170,2,172,98,145
53045,045,53,2020,66034,387,0,387,156,190
53045,045,53,2021,67246,1351,67,1418,614,781
53045,045,53,2022,68171,938,188,1126,623,871
53045,045,53,2023,68389,266,155,421,619,826
53047,047,53,2020,42139,54,3,57,93,99
53047,047,53,2021,42772,619,67,686,456,501
53047,047,53,2022,43460,334,461,795,463,575
53047,047,53,2023,43712,176,230,406,421,577
53049,049,53,2020,23495,178,2,180,47,78
53049,049,53,2021,23993,704,25,729,168,366
53049,049,53,2022,24095,290,59,349,158,421
53049,049,53,2023,24200,334,29,363,150,407
53051,051,53,2020,13502,131,0,131,26,42
53051,051,53,2021,13891,506,2,508,105,201
53051,051,53,2022,14138,352,0,352,121,239
53051,051,53,2023,14361,344,0,344,114,233
53053,053,53,2020,923589,1157,44,1201,2793,1765
53053,053,53,2021,927402,-1037,867,-170,11028,7794
53053,053,53,2022,926479,-5318,2316,-3002,11050,8552
53053,053,53,2023,928696,-2396,1846,-550,10933,8162
53055,055,53,2020,17826,54,0,54,24,32
53055,055,53,2021,18618,877,8,885,117,162
53055,055,53,2022,18672,71,28,99,105,147
53055,055,53,2023,18566,-76,21,-55,103,151
53057,057,53,2020,129902,374,7,381,334,325
53057,057,53,2021,131005,990,124,1114,1389,1419
53057,057,53,2022,131322,185,313,498,1409,1525
53057,057,53,2023,131417,23,136,159,1389,1446
53059,059,53,2020,12041,6,0,6,24,24
53059,059,53,2021,12209,181,6,187,93,109
53059,059,53,2022,12455,242,7,249,96,108
53059,059,53,2023,12640,198,2,200,88,103
53061,061,53,2020,829933,799,102,901,2409,1551
53061,061,53,2021,836097,919,1488,2407,9463,6235
53061,061,53,2022,840452,-2196,4098,1902,9821,6798
53061,061,53,2023,844761,-2282,3349,1067,9749,6475
53063,063,53,2020,541175,1503,7,1510,1514,1194
53063,063,53,2021,545510,3582,275,3857,5779,5532
53063,063,53,2022,549740,3654,618,4272,5878,5892
53063,063,53,2023,551455,1033,511,1544,5710,5565
53065,065,53,2020,46591,185,0,185,87,124
53065,065,53,2021,47619,1156,3,1159,440,533
53065,065,53,2022,48283,822,8,830,454,646
53065,065,53,2023,48837,735,6,741,440,624
53067,067,53,2020,295998,1050,6,1056,772,597
53067,067,53,2021,298196,1455,199,1654,3074,2684
53067,067,53,2022,298639,168,418,586,3083,3070
53067,067,53,2023,299003,-63,337,274,3043,2943
53069,069,53,2020,4448,31,0,31,9,12
53069,069,53,2021,4586,176,1,177,23,53
53069,069,53,2022,4688,135,0,135,30,67
53069,069,53,2023,4765,116,0,116,31,68
53071,071,53,2020,62623,46,2,48,130,151
53071,071,53,2021,62211,-433,75,-358,603,650
53071,071,53,2022,61853,-324,156,-168,559,745
53071,071,53,2023,61568,-197,85,-112,553,728
53073,073,53,2020,227449,514,7,521,522,460
53073,073,53,2021,226701,-999,208,-791,1989,2027
53073,073,53,2022,230598,3302,533,3835,2004,2164
53073,073,53,2023,231919,1034,379,1413,1969,2076
53075,075,53,2020,47807,-189,3,-186,103,58
53075,075,53,2021,43224,-4372,162,-4210,367,356
53075,075,53,2022,47579,3598,354,3952,400,364
53075,075,53,2023,48012,84,309,393,390,349
53077,077,53,2020,256733,-328,32,-296,931,682
53077,077,53,2021,256719,-1494,395,-1099,3360,2375
53077,077,53,2022,257019,-1494,1009,-485,3433,2588
53077,077,53,2023,256643,-1583,316,-1267,3341,2462
54001,001,54,2020,15467,11,0,11,45,58
54001,001,54,2021,15449,76,6,82,143,250
54001,001,54,2022,15391,88,6,94,137,278
54001,001,54,2023,15378,97,3,100,137,250
54003,003,54,2020,122699,640,3,643,367,350
54003,003,54,2021,126180,3508,52,3560,1493,1445
54003,003,54,2022,129379,3071,111,3182,1478,1583
54003,003,54,2023,132440,2820,47,2867,1518,1323
54005,005,54,2020,21744,-33,0,-33,57,89
54005,005,54,2021,21353,-219,0,-219,206,374
54005,005,54,2022,20907,-224,2,-222,190,417
54005,005,54,2023,20576,-158,1,-157,189,366
54007,007,54,2020,12398,-24,0,-24,16,44
54007,007,54,2021,12296,-30,2,-28,105,186
54007,007,54,2022,12170,-5,0,-5,102,214
54007,007,54,2023,12162,84,0,84,102,194
54009,009,54,2020,22476,-19,0,-19,32,87
54009,009,54,2021,22068,-121,0,-121,142,439
54009,009,54,2022,21694,-114,26,-88,156,438
54009,009,54,2023,21373,-108,14,-94,159,383
54011,011,54,2020,94240,-53,0,-53,251,336
54011,011,54,2021,93408,-338,32,-306,920,1500
54011,011,54,2022,92485,-218,81,-137,893,1629
54011,011,54,2023,92082,24,38,62,887,1350
54013,013,54,2020,6199,-16,0,-16,13,24
54013,013,54,2021,6173,15,-1,14,56,97
54013,013,54,2022,6069,-28,-2,-30,60,129
54013,013,54,2023,5959,-43,-3,-46,60,124
54015,015,54,2020,8005,-28,0,-28,18,30
54015,015,54,2021,7905,-52,0,-52,92,140
54015,015,54,2022,7840,-1,0,-1,96,155
54015,015,54,2023,7783,-1,0,-1,96,153
54017,017,54,2020,7786,-8,0,-8,13,26
54017,017,54,2021,7738,-14,0,-14,57,93
54017,017,54,2022,7712,15,-2,13,64,97
54017,017,54,2023,7680,-4,-2,-6,65,91
54019,019,54,2020,40428,-27,0,-27,107,140
54019,019,54,2021,40036,-55,3,-52,361,727
54019,019,54,2022,39388,-207,8,-199,378,820
54019,019,54,2023,39072,16,4,20,378,714
54021,021,54,2020,7396,-12,0,-12,13,22
54021,021,54,2021,7392,29,3,32,52,92
54021,021,54,2022,7330,-20,5,-15,49,94
54021,021,54,2023,7254,-38,4,-34,49,91
54023,023,54,2020,10990,14,0,14,31,33
54023,023,54,2021,10992,81,5,86,97,185
54023,023,54,2022,10938,36,13,49,92,189
54023,023,54,2023,10921,60,8,68,92,175
54025,025,54,2020,32892,-21,0,-21,72,137
54025,025,54,2021,32687,43,11,54,307,583
54025,025,54,2022,32375,43,25,68,306,665
54025,025,54,2023,32149,30,16,46,303,573
54027,027,54,2020,23101,14,0,14,47,59
54027,027,54,2021,23360,396,-1,395,236,361
54027,027,54,2022,23457,219,-3,216,240,359
54027,027,54,2023,23649,261,-3,258,251,317
54029,029,54,2020,29038,-10,0,-10,45,98
54029,029,54,2021,28595,-118,3,-115,228,570
54029,029,54,2022,28254,-30,11,-19,235,544
54029,029,54,2023,28145,134,3,137,245,489
54031,031,54,2020,14239,-50,1,-49,35,41
54031,031,54,2021,14143,-35,8,-27,143,218
54031,031,54,2022,14168,99,5,104,128,209
54031,031,54,2023,14251,139,4,143,128,187
54033,033,54,2020,65838,-49,0,-49,174,213
54033,033,54,2021,65402,-204,6,-198,657,925
54033,033,54,2022,64752,-212,31,-181,671,1117
54033,033,54,2023,64639,138,19,157,672,943
54035,035,54,2020,27723,-29,0,-29,68,113
54035,035,54,2021,27781,127,20,147,299,405
54035,035,54,2022,27667,76,21,97,269,462
54035,035,54,2023,27593,58,16,74,267,416
54037,037,54,2020,57785,35,0,35,161,137
54037,037,54,2021,58541,727,60,787,569,597
54037,037,54,2022,59001,426,127,553,526,617
54037,037,54,2023,59787,712,84,796,538,551
54039,039,54,2020,180233,-309,10,-299,411,632
54039,039,54,2021,178073,-921,95,-826,1662,3076
54039,039,54,2022,175864,-958,278,-680,1729,3180
54039,039,54,2023,174805,-422,223,-199,1726,2590
54041,041,54,2020,17020,3,0,3,42,60
54041,041,54,2021,16874,-18,0,-18,160,298
54041,041,54,2022,16674,15,0,15,154,360
54041,041,54,2023,16500,-9,0,-9,154,319
54043,043,54,2020,20363,-65,0,-65,56,80
54043,043,54,2021,20188,-46,7,-39,180,328
54043,043,54,2022,19851,-135,7,-128,193,395
54043,043,54,2023,19701,11,4,15,193,357
54045,045,54,2020,32514,-17,0,-17,79,126
54045,045,54,2021,31846,-268,-1,-269,281,685
54045,045,54,2022,31206,-212,-2,-214,309,733
54045,045,54,2023,30827,-59,-2,-61,312,631
54047,047,54,2020,18935,-109,0,-109,38,97
54047,047,54,2021,18406,-294,6,-288,165,399
54047,047,54,2022,17806,-355,22,-333,158,436
54047,047,54,2023,17439,-153,15,-138,160,390
54049,049,54,2020,56240,10,0,10,151,153
54049,049,54,2021,56053,49,6,55,525,806
54049,049,54,2022,55784,108,6,114,530,895
54049,049,54,2023,55807,255,0,255,526,756
54051,051,54,2020,30494,-66,0,-66,74,93
54051,051,54,2021,30164,-116,9,-107,270,508
54051,051,54,2022,29667,-234,12,-222,262,532
54051,051,54,2023,29405,-66,6,-60,263,465
54053,053,54,2020,25403,-22,0,-22,60,89
54053,053,54,2021,25266,26,2,28,268,448
54053,053,54,2022,24911,-98,2,-96,253,502
54053,053,54,2023,24765,26,1,27,273,448
54055,055,54,2020,59519,-52,2,-50,156,245
54055,055,54,2021,59156,121,14,135,589,1127
54055,055,54,2022,58612,47,38,85,614,1207
54055,055,54,2023,58057,-190,20,-170,615,1000
54057,057,54,2020,26889,-7,0,-7,54,94
54057,057,54,2021,26897,141,-2,139,269,413
54057,057,54,2022,26902,208,-7,201,257,442
54057,057,54,2023,26867,73,-7,66,293,394
54059,059,54,2020,23488,-64,0,-64,77,95
54059,059,54,2021,23052,-247,0,-247,237,426
54059,059,54,2022,22445,-346,-3,-349,243,509
54059,059,54,2023,22023,-230,-3,-233,259,448
54061,061,54,2020,105912,-30,15,-15,230,174
54061,061,54,2021,106521,147,255,402,961,837
54061,061,54,2022,106978,-236,642,406,983,857
54061,061,54,2023,107718,106,389,495,980,737
54063,063,54,2020,12384,-3,0,-3,40,32
54063,063,54,2021,12388,97,6,103,120,221
54063,063,54,2022,12322,29,10,39,134,234
54063,063,54,2023,12382,138,6,144,133,217
54065,065,54,2020,17087,31,0,31,37,49
54065,065,54,2021,17300,327,-1,326,133,238
54065,065,54,2022,17435,270,0,270,145,295
54065,065,54,2023,17649,334,-2,332,150,265
54067,067,54,2020,24558,-19,0,-19,56,88
54067,067,54,2021,24429,-6,16,10,233,384
54067,067,54,2022,24309,72,37,109,223,444
54067,067,54,2023,24169,7,21,28,223,391
54069,069,54,2020,42341,-49,1,-48,94,147
54069,069,54,2021,41846,-154,12,-142,375,750
54069,069,54,2022,41463,-56,40,-16,384,734
54069,069,54,2023,41194,-44,29,-15,382,637
54071,071,54,2020,6132,-3,0,-3,17,29
54071,071,54,2021,6093,27,0,27,52,119
54071,071,54,2022,6067,27,3,30,63,116
54071,071,54,2023,6029,3,2,5,63,106
54073,073,54,2020,7650,10,0,10,16,28
54073,073,54,2021,7604,-8,0,-8,72,115
54073,073,54,2022,7570,28,0,28,71,128
54073,073,54,2023,7428,-100,0,-100,74,116
54075,075,54,2020,7860,-3,0,-3,19,26
54075,075,54,2021,7882,72,0,72,77,129
54075,075,54,2022,7797,-5,0,-5,64,141
54075,075,54,2023,7765,38,0,38,64,134
54077,077,54,2020,34188,-19,0,-19,77,92
54077,077,54,2021,34304,249,10,259,273,428
54077,077,54,2022,34222,104,34,138,300,495
54077,077,54,2023,34099,-20,29,9,302,433
54079,079,54,2020,57444,20,1,21,119,153
54079,079,54,2021,57359,95,24,119,531,761
54079,079,54,2022,57063,-104,52,-52,537,760
54079,079,54,2023,56962,-3,28,25,537,664
54081,081,54,2020,74394,-91,0,-91,175,280
54081,081,54,2021,73779,-39,15,-24,672,1306
54081,081,54,2022,72801,-220,54,-166,656,1437
54081,081,54,2023,72356,65,30,95,655,1197
54083,083,54,2020,27892,-31,0,-31,68,83
54083,083,54,2021,27898,130,4,134,273,415
54083,083,54,2022,27552,-107,0,-107,265,492
54083,083,54,2023,27350,-25,0,-25,265,441
54085,085,54,2020,8423,-11,0,-11,19,31
54085,085,54,2021,8410,23,2,25,86,130
54085,085,54,2022,8230,-117,3,-114,81,151
54085,085,54,2023,8167,-12,2,-10,84,137
54087,087,54,2020,13987,-21,0,-21,28,49
54087,087,54,2021,13932,-7,2,-5,130,189
54087,087,54,2022,13833,15,3,18,126,235
54087,087,54,2023,13743,4,1,5,125,220
54089,089,54,2020,11939,-4,0,-4,24,51
54089,089,54,2021,11865,78,-1,77,89,244
54089,089,54,2022,11702,16,-1,15,94,265
54089,089,54,2023,11581,34,-1,33,94,248
54091,091,54,2020,16691,20,0,20,26,64
54091,091,54,2021,16528,-93,0,-93,171,248
54091,091,54,2022,16410,11,-1,10,156,273
54091,091,54,2023,16388,80,-1,79,151,253
54093,093,54,2020,6747,2,0,2,12,27
54093,093,54,2021,6693,2,0,2,54,116
54093,093,54,2022,6620,-9,1,-8,59,120
54093,093,54,2023,6604,39,0,39,60,114
54095,095,54,2020,8291,-10,0,-10,16,18
54095,095,54,2021,8205,-45,1,-44,84,128
54095,095,54,2022,8090,-34,-1,-35,73,146
54095,095,54,2023,7919,-108,-1,-109,76,139
54097,097,54,2020,23814,-7,0,-7,59,59
54097,097,54,2021,23803,92,0,92,221,337
54097,097,54,2022,23705,41,5,46,233,360
54097,097,54,2023,23529,-95,3,-92,233,318
54099,099,54,2020,38873,-53,3,-50,89,153
54099,099,54,2021,38564,-76,24,-52,367,647
54099,099,54,2022,37980,-245,35,-210,362,731
54099,099,54,2023,37686,-55,21,-34,363,624
54101,101,54,2020,8356,-17,0,-17,19,25
54101,101,54,2021,8271,-25,0,-25,79,144
54101,101,54,2022,8141,-54,0,-54,78,154
54101,101,54,2023,8045,-26,0,-26,77,147
54103,103,54,2020,14405,-28,0,-28,35,53
54103,103,54,2021,14202,-88,0,-88,146,266
54103,103,54,2022,13994,-38,14,-24,149,330
54103,103,54,2023,13890,33,9,42,149,293
54105,105,54,2020,5188,-14,0,-14,17,12
54105,105,54,2021,5066,-105,0,-105,59,70
54105,105,54,2022,5092,60,0,60,55,87
54105,105,54,2023,5000,-64,0,-64,56,85
54107,107,54,2020,84142,-93,0,-93,190,255
54107,107,54,2021,83804,57,13,70,828,1302
54107,107,54,2022,83388,145,47,192,834,1387
54107,107,54,2023,83052,-68,29,-39,853,1152
54109,109,54,2020,21322,-27,0,-27,51,92
54109,109,54,2021,21029,-115,0,-115,201,388
54109,109,54,2022,20572,-233,-3,-236,203,427
54109,109,54,2023,20277,-123,-3,-126,204,373
55001,001,55,2020,20677,87,0,87,36,80
55001,001,55,2021,20837,329,2,331,109,268
55001,001,55,2022,21252,577,4,581,125,329
55001,001,55,2023,21449,384,7,391,122,316
55003,003,55,2020,16022,-14,0,-14,39,41
55003,003,55,2021,16048,81,2,83,137,203
55003,003,55,2022,16040,40,4,44,161,209
55003,003,55,2023,16079,70,8,78,161,200
55005,005,55,2020,46737,-8,2,-6,128,121
55005,005,55,2021,46709,119,30,149,422,619
55005,005,55,2022,46715,170,60,230,447,652
55005,005,55,2023,46833,186,95,281,444,605
55007,007,55,2020,16237,44,0,44,21,41
55007,007,55,2021,16322,175,1,176,98,183
55007,007,55,2022,16659,397,1,398,112,192
55007,007,55,2023,16769,184,2,186,115,190
55009,009,55,2020,268951,-55,7,-48,741,556
55009,009,55,2021,268899,-868,140,-728,2962,2427
55009,009,55,2022,270068,446,314,760,3014,2479
55009,009,55,2023,271417,49,546,595,3004,2262
55011,011,55,2020,13309,10,0,10,30,32
55011,011,55,2021,13325,2,0,2,138,132
55011,011,55,2022,13390,92,1,93,126,149
55011,011,55,2023,13419,49,1,50,125,143
55013,013,55,2020,16577,77,0,77,29,43
55013,013,55,2021,16755,296,0,296,101,206
55013,013,55,2022,16988,355,4,359,94,232
55013,013,55,2023,17092,228,7,235,94,227
55015,015,55,2020,52485,1,0,1,112,90
55015,015,55,2021,52583,22,4,26,453,420
55015,015,55,2022,52712,87,25,112,467,419
55015,015,55,2023,53199,390,43,433,457,399
55017,017,55,2020,66341,-7,0,-7,171,146
55017,017,55,2021,66590,273,3,276,647,714
55017,017,55,2022,66753,235,8,243,655,708
55017,017,55,2023,66970,207,15,222,651,657
55019,019,55,2020,34672,-65,0,-65,147,72
55019,019,55,2021,34762,-118,7,-111,583,395
55019,019,55,2022,34732,-219,21,-198,579,403
55019,019,55,2023,34774,-191,55,-136,566,387
55021,021,55,2020,58533,27,0,27,143,149
55021,021,55,2021,58445,-79,10,-69,573,629
55021,021,55,2022,58228,-131,22,-109,575,659
55021,021,55,2023,58091,-121,34,-87,568,620
55023,023,55,2020,16085,-11,0,-11,35,53
55023,023,55,2021,16097,35,1,36,157,190
55023,023,55,2022,16015,-33,4,-29,160,206
55023,023,55,2023,15944,-38,5,-33,161,198
55025,025,55,2020,562615,347,60,407,1483,965
55025,025,55,2021,561542,-3823,908,-2915,5534,3879
55025,025,55,2022,567758,2540,2066,4606,5613,3949
55025,025,55,2023,575347,2092,3456,5548,5580,3579
55027,027,55,2020,89353,-16,0,-16,193,239
55027,027,55,2021,88689,-293,30,-263,744,1175
55027,027,55,2022,88374,72,67,139,760,1156
55027,027,55,2023,88231,48,115,163,756,1064
55029,029,55,2020,30117,94,0,94,49,84
55029,029,55,2021,30425,490,7,497,207,384
55029,029,55,2022,30551,292,19,311,217,402
55029,029,55,2023,30562,142,36,178,212,379
55031,031,55,2020,44351,76,0,76,90,112
55031,031,55,2021,44055,-196,23,-173,401,542
55031,031,55,2022,44226,253,26,279,413,519
55031,031,55,2023,44264,81,42,123,414,501
55033,033,55,2020,45440,-27,0,-27,99,71
55033,033,55,2021,44518,-933,12,-921,441,392
55033,033,55,2022,45622,990,27,1017,444,431
55033,033,55,2023,45794,76,60,136,444,408
55035,035,55,2020,105897,61,4,65,292,212
55035,035,55,2021,106017,-75,31,-44,1092,995
55035,035,55,2022,106786,668,61,729,1078,1034
55035,035,55,2023,107903,885,123,1008,1059,958
55037,037,55,2020,4565,9,0,9,9,13
55037,037,55,2021,4593,77,0,77,31,77
55037,037,55,2022,4706,145,0,145,26,66
55037,037,55,2023,4682,13,0,13,29,66
55039,039,55,2020,104169,0,2,2,252,273
55039,039,55,2021,104116,85,24,109,974,1205
55039,039,55,2022,103812,-156,125,-31,1011,1235
55039,039,55,2023,103948,55,212,267,1005,1136
55041,041,55,2020,9169,-10,0,-10,25,25
55041,041,55,2021,9257,122,0,122,102,133
55041,041,55,2022,9332,140,1,141,89,157
55041,041,55,2023,9325,54,3,57,88,152
55043,043,55,2020,51985,-3,0,-3,166,135
55043,043,55,2021,51296,-651,4,-647,538,561
55043,043,55,2022,51315,58,19,77,575,600
55043,043,55,2023,51409,65,40,105,560,572
55045,045,55,2020,37035,-48,0,-48,93,100
55045,045,55,2021,37066,31,9,40,365,400
55045,045,55,2022,36885,-124,14,-110,352,413
55045,045,55,2023,36951,84,30,114,351,397
55047,047,55,2020,19017,12,0,12,45,60
55047,047,55,2021,19249,313,2,315,188,267
55047,047,55,2022,19208,57,8,65,204,299
55047,047,55,2023,19344,213,11,224,203,286
55049,049,55,2020,23719,-9,0,-9,61,57
55049,049,55,2021,23807,54,4,58,239,224
55049,049,55,2022,23958,96,18,114,267,221
55049,049,55,2023,23956,-73,24,-49,258,211
55051,051,55,2020,6139,22,0,22,14,26
55051,051,55,2021,6172,117,0,117,32,113
55051,051,55,2022,6199,96,1,97,42,113
55051,051,55,2023,6228,98,1,99,40,108
55053,053,55,2020,21096,-25,0,-25,46,72
55053,053,55,2021,20915,-151,2,-149,216,250
55053,053,55,2022,20893,-3,6,3,225,238
55053,053,55,2023,20855,-37,22,-15,213,237
55055,055,55,2020,86208,-16,0,-16,216,181
55055,055,55,2021,85782,-349,2,-347,774,883
55055,055,55,2022,85725,61,60,121,796,926
55055,055,55,2023,85743,-9,94,85,789,858
55057,057,55,2020,26775,79,0,79,52,70
55057,057,55,2021,26763,44,4,48,226,306
55057,057,55,2022,26775,178,9,187,223,395
55057,057,55,2023,26594,-45,17,-28,221,372
55059,059,55,2020,169195,-51,5,-46,442,406
55059,059,55,2021,168414,-901,66,-835,1711,1728
55059,059,55,2022,167637,-801,156,-645,1693,1787
55059,059,55,2023,167488,-525,313,-212,1681,1627
55061,061,55,2020,20563,-15,0,-15,57,53
55061,061,55,2021,20589,50,3,53,192,232
55061,061,55,2022,20653,80,10,90,201,216
55061,061,55,2023,20690,28,18,46,197,205
55063,063,55,2020,120921,59,0,59,302,262
55063,063,55,2021,119331,-1478,1,-1477,1111,1192
55063,063,55,2022,120252,948,44,992,1112,1185
55063,063,55,2023,120486,135,86,221,1113,1103
55065,065,55,2020,16618,-15,0,-15,58,35
55065,065,55,2021,16830,109,5,114,265,175
55065,065,55,2022,16906,-21,23,2,252,169
55065,065,55,2023,16945,-82,38,-44,248,166
55067,067,55,2020,19463,-6,0,-6,40,66
55067,067,55,2021,19479,145,0,145,180,312
55067,067,55,2022,19502,165,6,171,175,319
55067,067,55,2023,19404,25,9,34,175,306
55069,069,55,2020,28426,16,0,16,60,71
55069,069,55,2021,28457,197,6,203,264,442
55069,069,55,2022,28355,93,14,107,259,456
55069,069,55,2023,28405,211,21,232,253,436
55071,071,55,2020,81387,30,0,30,186,206
55071,071,55,2021,81506,309,32,341,741,1017
55071,071,55,2022,81198,-88,82,-6,732,991
55071,071,55,2023,81331,184,143,327,726,917
55073,073,55,2020,138078,-68,0,-68,362,278
55073,073,55,2021,137755,-399,31,-368,1401,1428
55073,073,55,2022,137955,199,152,351,1427,1495
55073,073,55,2023,138612,338,258,596,1437,1366
55075,075,55,2020,41889,68,0,68,98,155
55075,075,55,2021,41858,206,4,210,360,618
55075,075,55,2022,41966,379,12,391,357,642
55075,075,55,2023,42106,352,26,378,359,597
55077,077,55,2020,15590,25,0,25,28,54
55077,077,55,2021,15784,307,1,308,129,235
55077,077,55,2022,15777,112,7,119,130,259
55077,077,55,2023,15838,175,11,186,127,250
55078,078,55,2020,4257,-4,0,-4,21,11
55078,078,55,2021,4297,32,0,32,71,66
55078,078,55,2022,4206,-90,0,-90,67,68
55078,078,55,2023,4226,26,0,26,64,69
55079,079,55,2020,938550,-1645,119,-1526,3054,2654
55079,079,55,2021,924276,-16933,988,-15945,11957,9811
55079,079,55,2022,918078,-10100,2418,-7682,11703,9975
55079,079,55,2023,916205,-8408,4154,-4254,11327,8928
55081,081,55,2020,46300,-22,0,-22,141,96
55081,081,55,2021,46083,-231,13,-218,514,530
55081,081,55,2022,45894,-214,25,-189,586,573
55081,081,55,2023,46151,178,45,223,575,537
55083,083,55,2020,39077,108,0,108,95,87
55083,083,55,2021,39421,440,0,440,339,437
55083,083,55,2022,39696,375,0,375,339,432
55083,083,55,2023,39775,155,5,160,333,416
55085,085,55,2020,37869,94,0,94,69,132
55085,085,55,2021,38249,711,4,715,261,572
55085,085,55,2022,38193,230,7,237,267,555
55085,085,55,2023,38226,274,12,286,265,521
55087,087,55,2020,190966,32,0,32,542,375
55087,087,55,2021,191320,-111,54,-57,2051,1747
55087,087,55,2022,192269,494,189,683,2129,1740
55087,087,55,2023,193234,126,320,446,2109,1593
55089,089,55,2020,91629,107,1,108,202,217
55089,089,55,2021,92600,989,57,1046,827,920
55089,089,55,2022,93021,492,101,593,826,944
55089,089,55,2023,93460,340,178,518,814,883
55091,091,55,2020,7341,16,0,16,17,12
55091,091,55,2021,7374,25,2,27,77,75
55091,091,55,2022,7378,8,7,15,75,83
55091,091,55,2023,7441,58,12,70,76,82
55093,093,55,2020,42229,-22,0,-22,89,57
55093,093,55,2021,41606,-581,7,-574,377,388
55093,093,55,2022,42552,870,17,887,401,388
55093,093,55,2023,43026,408,37,445,395,366
55095,095,55,2020,45039,57,0,57,102,107
55095,095,55,2021,45466,570,5,575,382,530
55095,095,55,2022,45546,280,8,288,403,602
55095,095,55,2023,45762,373,12,385,401,567
55097,097,55,2020,70405,0,2,2,152,141
55097,097,55,2021,69433,-932,38,-894,608,649
55097,097,55,2022,70634,1158,121,1279,603,750
55097,097,55,2023,71024,292,198,490,599,696
55099,099,55,2020,14025,-5,0,-5,24,43
55099,099,55,2021,14048,136,2,138,86,201
55099,099,55,2022,14159,224,9,233,93,221
55099,099,55,2023,14102,48,12,60,93,210
55101,101,55,2020,197568,-169,1,-168,513,551
55101,101,55,2021,196505,-1093,89,-1004,2148,2285
55101,101,55,2022,195961,-520,224,-296,2179,2336
55101,101,55,2023,196613,250,396,646,2132,2127
55103,103,55,2020,17283,-11,0,-11,43,62
55103,103,55,2021,17199,-57,3,-54,169,209
55103,103,55,2022,17128,-10,11,1,176,236
55103,103,55,2023,17197,108,17,125,175,231
55105,105,55,2020,163758,-34,0,-34,464,421
55105,105,55,2021,164115,273,33,306,1803,1866
55105,105,55,2022,163841,-137,47,-90,1767,1847
55105,105,55,2023,164278,241,134,375,1765,1703
55107,107,55,2020,14175,-5,0,-5,35,43
55107,107,55,2021,14085,-7,2,-5,119,211
55107,107,55,2022,14099,132,5,137,120,243
55107,107,55,2023,14143,152,9,161,120,237
55109,109,55,2020,93872,230,0,230,245,149
55109,109,55,2021,94998,953,7,960,953,816
55109,109,55,2022,95967,780,26,806,1037,845
55109,109,55,2023,96763,522,48,570,1019,787
55111,111,55,2020,65784,-12,1,-11,180,162
55111,111,55,2021,65702,-78,23,-55,656,733
55111,111,55,2022,65770,65,120,185,702,782
55111,111,55,2023,65920,0,183,183,701,733
55113,113,55,2020,18118,79,0,79,35,61
55113,113,55,2021,18226,255,0,255,124,263
55113,113,55,2022,18521,414,3,417,136,286
55113,113,55,2023,18552,161,7,168,136,275
55115,115,55,2020,40855,4,0,4,112,139
55115,115,55,2021,40829,64,0,64,408,514
55115,115,55,2022,40987,244,11,255,433,519
55115,115,55,2023,41109,171,16,187,431,495
55117,117,55,2020,118053,-21,0,-21,307,295
55117,117,55,2021,117687,-283,58,-225,1104,1307
55117,117,55,2022,117661,52,164,216,1125,1305
55117,117,55,2023,117752,-94,293,199,1111,1218
55119,119,55,2020,19932,-6,0,-6,64,39
55119,119,55,2021,19938,-22,4,-18,213,201
55119,119,55,2022,19941,12,13,25,221,232
55119,119,55,2023,20058,103,18,121,216,221
55121,121,55,2020,30818,0,0,0,121,70
55121,121,55,2021,30723,-190,5,-185,405,329
55121,121,55,2022,30891,82,37,119,383,315
55121,121,55,2023,30899,-130,58,-72,382,304
55123,123,55,2020,30696,-22,0,-22,91,88
55123,123,55,2021,30917,157,4,161,422,380
55123,123,55,2022,31063,99,11,110,424,371
55123,123,55,2023,31170,33,23,56,408,357
55125,125,55,2020,23097,109,0,109,41,84
55125,125,55,2021,23508,632,-1,631,146,335
55125,125,55,2022,23742,426,-2,424,159,374
55125,125,55,2023,23885,341,-1,340,160,358
55127,127,55,2020,105323,76,0,76,225,241
55127,127,55,2021,105296,188,4,192,861,1154
55127,127,55,2022,105664,603,50,653,910,1147
55127,127,55,2023,105822,190,109,299,913,1054
55129,129,55,2020,16616,24,0,24,28,55
55129,129,55,2021,16748,301,2,303,112,272
55129,129,55,2022,16871,280,2,282,124,291
55129,129,55,2023,16930,209,4,213,124,277
55131,131,55,2020,136801,37,0,37,273,304
55131,131,55,2021,137253,559,25,584,1210,1427
55131,131,55,2022,137756,720,46,766,1282,1455
55131,131,55,2023,138168,410,73,483,1264,1325
55133,133,55,2020,407496,359,10,369,981,933
55133,133,55,2021,409108,1571,260,1831,3742,4237
55133,133,55,2022,410273,1526,454,1980,3823,4347
55133,133,55,2023,412591,1785,783,2568,3717,3936
55135,135,55,2020,51798,24,0,24,138,193
55135,135,55,2021,51986,522,1,523,435,783
55135,135,55,2022,51510,-136,4,-132,468,789
55135,135,55,2023,51388,148,10,158,462,739
55137,137,55,2020,24550,22,0,22,62,60
55137,137,55,2021,24760,387,1,388,179,350
55137,137,55,2022,24927,320,5,325,179,347
55137,137,55,2023,24934,148,9,157,180,329
55139,139,55,2020,171815,-36,1,-35,445,390
55139,139,55,2021,170580,-1270,79,-1191,1719,1798
55139,139,55,2022,170688,108,215,323,1678,1797
55139,139,55,2023,171735,659,362,1021,1673,1649
55141,141,55,2020,74199,-26,0,-26,193,194
55141,141,55,2021,74005,59,9,68,718,1036
55141,141,55,2022,73778,160,57,217,696,1096
55141,141,55,2023,73939,391,90,481,693,1008
56001,001,56,2020,37112,-12,6,-6,87,53
56001,001,56,2021,37854,644,56,700,307,252
56001,001,56,2022,38178,136,165,301,311,279
56001,001,56,2023,38257,-220,231,11,307,237
56003,003,56,2020,11484,-29,0,-29,21,31
56003,003,56,2021,11643,213,0,213,117,167
56003,003,56,2022,11879,275,3,278,124,174
56003,003,56,2023,12018,157,4,161,132,155
56005,005,56,2020,47147,14,0,14,150,67
56005,005,56,2021,46543,-850,10,-840,619,353
56005,005,56,2022,47059,324,7,331,581,380
56005,005,56,2023,47498,205,1,206,567,335
56007,007,56,2020,14509,-34,0,-34,38,31
56007,007,56,2021,14714,201,3,204,162,158
56007,007,56,2022,14538,-176,11,-165,156,167
56007,007,56,2023,14334,-209,16,-193,144,154
56009,009,56,2020,13746,-22,0,-22,44,29
56009,009,56,2021,13662,-65,4,-61,130,157
56009,009,56,2022,13765,120,4,124,144,162
56009,009,56,2023,13809,62,1,63,127,145
56011,011,56,2020,7178,-1,1,0,19,17
56011,011,56,2021,7308,119,10,129,114,110
56011,011,56,2022,7419,102,3,105,89,85
56011,011,56,2023,7592,174,-3,171,87,84
56013,013,56,2020,39202,-24,0,-24,105,122
56013,013,56,2021,39416,313,0,313,449,555
56013,013,56,2022,39566,281,0,281,466,607
56013,013,56,2023,39815,319,4,323,442,514
56015,015,56,2020,12515,12,0,12,38,41
56015,015,56,2021,12568,113,4,117,123,189
56015,015,56,2022,12636,142,1,143,119,192
56015,015,56,2023,12642,71,2,73,110,176
56017,017,56,2020,4621,14,0,14,10,23
56017,017,56,2021,4595,17,0,17,42,87
56017,017,56,2022,4623,78,0,78,34,88
56017,017,56,2023,4661,89,0,89,34,84
56019,019,56,2020,8467,15,0,15,19,18
56019,019,56,2021,8624,199,-2,197,80,112
56019,019,56,2022,8719,126,-8,118,78,111
56019,019,56,2023,8759,75,-8,67,76,102
56021,021,56,2020,100730,143,5,148,286,231
56021,021,56,2021,100827,-9,-5,-14,1113,1071
56021,021,56,2022,100781,144,2,146,1131,1289
56021,021,56,2023,100984,121,15,136,1121,1054
56023,023,56,2020,19658,68,0,68,62,53
56023,023,56,2021,20173,475,-1,474,226,167
56023,023,56,2022,20671,437,-1,436,225,174
56023,023,56,2023,20880,154,-1,153,209,152
56025,025,56,2020,80299,268,0,268,239,174
56025,025,56,2021,79635,-594,0,-594,861,952
56025,025,56,2022,79523,75,-2,73,840,977
56025,025,56,2023,79941,381,0,381,827,792
56027,027,56,2020,2454,-17,0,-17,9,7
56027,027,56,2021,2416,-27,0,-27,25,36
56027,027,56,2022,2348,-58,0,-58,22,36
56027,027,56,2023,2354,19,0,19,21,33
56029,029,56,2020,29669,53,0,53,59,71
56029,029,56,2021,30141,560,18,578,296,390
56029,029,56,2022,30505,464,46,510,273,429
56029,029,56,2023,30735,312,7,319,266,352
56031,031,56,2020,8631,36,0,36,24,29
56031,031,56,2021,8677,96,0,96,79,129
56031,031,56,2022,8652,52,12,64,75,163
56031,031,56,2023,8546,-45,15,-30,70,145
56033,033,56,2020,31000,84,2,86,75,76
56033,033,56,2021,31653,716,14,730,316,371
56033,033,56,2022,32035,468,11,479,301,405
56033,033,56,2023,32519,533,9,542,296,353
56035,035,56,2020,8736,-3,1,-2,29,18
56035,035,56,2021,8722,-36,-1,-37,89,71
56035,035,56,2022,8752,32,-3,29,82,78
56035,035,56,2023,8969,220,-3,217,75,73
56037,037,56,2020,42197,-92,1,-91,113,95
56037,037,56,2021,41626,-642,17,-625,456,387
56037,037,56,2022,41374,-307,55,-252,441,438
56037,037,56,2023,41249,-180,-12,-192,430,366
56039,039,56,2020,23379,6,2,8,62,17
56039,039,56,2021,23605,106,6,112,208,98
56039,039,56,2022,23297,-479,69,-410,196,101
56039,039,56,2023,23232,-221,55,-166,190,90
56041,041,56,2020,20457,-9,0,-9,58,43
56041,041,56,2021,20681,148,0,148,234,168
56041,041,56,2022,20727,32,-6,26,232,203
56041,041,56,2023,20745,-23,-6,-29,229,182
56043,043,56,2020,7657,-10,0,-10,19,31
56043,043,56,2021,7719,92,0,92,69,97
56043,043,56,2022,7724,51,-1,50,73,115
56043,043,56,2023,7710,25,-1,24,72,109
56045,045,56,2020,6816,-24,0,-24,18,13
56045,045,56,2021,6746,-25,1,-24,49,99
56045,045,56,2022,6858,156,-4,152,53,101
56045,045,56,2023,6808,-3,-4,-7,50,92
